"TOTAL_CUENTAS","CUENTAS_ABIERTAS","CUENTAS_CERRADAS","CUENTAS_CON_ATRASO","AÃ‘OS_DE_CREDITO","SALDO_ACTUAL","SALDO_VENCIDO","NUMERO_PAGOS_VENCIDOS","SALDO_VENCIDO_PEOR_ATRASO","VALOR"
13,4,9,1,15,2664,2125,45,6125,506
13,7,6,1,6,23740,13408,219,12995,514
18,5,13,5,7,82954,28803,25,991,451
13,7,6,5,8,134634,16113,14,774,433
22,6,16,1,17,185431,6072,41,6072,585
8,4,4,2,10,349359,30538,41,22350,575
20,7,13,0,13,332235,0,18,0,529
21,6,15,4,9,30749,8262,24,2160,478
13,6,7,2,14,26824,11990,26,7857,590
10,4,6,3,12,26011,6116,44,4086,567
16,11,5,9,12,66301,28036,43,2315,443
20,3,17,2,8,11702,18772,125,11702,648
19,1,18,1,13,3469,3469,0,2210,645
7,3,4,3,7,46027,5578,14,1409,526
12,7,5,5,10,449063,53779,64,10007,518
19,5,14,4,7,24490,32474,51,26904,451
13,3,10,1,7,22782,12406,5,12406,508
25,9,16,7,12,122415,54892,358,8118,443
15,10,5,2,20,1867010,102718,0,0,469
19,6,13,0,21,429627,0,19,3154,646
41,14,27,1,17,61472,506,136,1308,470
7,2,5,2,5,76768,74342,0,0,570
17,3,14,1,12,7874,4106,34,4106,646
13,10,3,2,12,393913,12236,30,5248,425
23,13,10,2,11,360616,4274,64,919,443
17,7,10,0,21,93100,0,52,4792,448
31,7,24,2,16,25899,25055,25,16486,495
10,6,4,3,6,59085,9413,13,0,517
6,4,2,1,13,449593,1689,0,0,621
9,3,6,4,7,11239,27703,52,16464,517
7,4,3,3,10,95917,92882,0,2806,520
38,11,27,4,8,140981,9292,177,5125,446
33,17,16,3,6,597169,1083,20,631,511
11,3,8,3,14,43997,43997,166,26475,448
11,8,3,7,10,40548,22908,55,4826,442
5,2,3,2,11,7485,7485,15,6655,538
15,9,6,0,21,197982,0,0,0,715
19,7,12,6,9,46488,99515,198,14398,451
8,5,3,1,6,25018,11415,14,0,557
20,9,11,0,18,313208,0,25,0,548
21,17,4,3,13,406381,75404,36,4280,418
44,6,38,2,8,504837,4294,18,764,457
10,8,2,8,7,304236,492565,2,2117,467
5,2,3,1,7,9143,9143,116,9143,562
21,7,14,2,69,71195,2113,111,3928,591
12,3,9,1,9,27641,23590,62,23590,516
38,5,33,0,9,76105,0,69,3103,646
18,6,12,4,12,26758,26758,109,15161,408
99,12,87,4,8,258393,4392,46,72547,477
4,2,2,0,12,198821,0,0,4892,673
13,7,6,4,6,39017,2139,288,2554,534
9,7,2,2,6,46550,2351,28,1892,593
15,10,5,0,16,307193,0,13,2269,520
12,5,7,4,16,197718,49967,2,21418,554
4,2,2,1,4,23656,2349,24,2361,548
12,7,5,2,11,99241,3401,20,0,513
6,1,5,0,17,0,0,15,0,703
19,6,13,3,8,7759,7759,83,2775,520
9,4,5,3,14,16928,17648,28,9918,458
23,8,15,0,10,40212,0,0,0,668
24,7,17,5,15,107592,47934,156,23494,558
26,4,22,2,12,4931,4204,32,6121,489
20,8,12,12,9,181482,218559,170,4566,445
13,5,8,4,11,52580,47276,77,32635,405
8,0,8,1,5,0,2901,0,0,521
56,6,50,3,15,12270,7349,56,4144,469
20,6,14,2,8,67081,242,40,448,569
18,8,10,2,13,72635,5267,6,12221,469
13,9,4,8,12,1123473,341133,82,28200,462
7,1,6,0,11,19225,0,25,0,489
117,21,96,12,9,249380,312170,295,130753,395
5,3,2,3,9,10441,10441,36,7509,525
46,13,33,3,17,247070,37971,97,28443,489
58,9,49,12,8,78652,39019,170,20712,460
10,5,5,6,16,15992,343746,127,7275,578
18,9,9,3,16,319681,21775,21,10425,449
8,5,3,0,10,181630,0,0,0,690
8,5,3,1,14,53209,7551,50,7551,410
8,0,8,0,7,0,0,121,6087,466
22,16,6,1,69,611593,3379,4,768,555
59,21,38,6,19,491205,13118,72,4900,491
29,9,20,13,13,247284,362542,251,21868,475
18,5,13,0,4,34323,0,7,3969,660
21,6,15,5,17,29025,27240,192,6598,529
10,7,3,5,11,209911,18423,57,1850,483
11,2,9,2,6,150347,25545,28,0,472
12,5,7,0,11,1093616,0,24,2200,500
70,7,63,5,10,75183,52225,10,13507,426
6,1,5,1,9,422,5547,0,0,537
36,7,29,2,12,350552,111766,0,0,492
8,6,2,5,20,7352087,6021824,148,5992181,488
10,2,8,4,13,310297,403870,69,160306,528
19,13,6,0,6,141192,0,9,350,555
5,3,2,2,4,40874,1648,55,1250,514
5,1,4,0,6,3329,0,220,5387,512
20,13,7,10,19,592373,827409,131,89152,392
44,6,38,8,18,117498,165795,52,7757,561
8,2,6,0,10,5900,0,7,11035,559
26,11,15,8,13,330997,71834,193,12388,406
7,3,4,3,13,556216,64114,25,30853,524
29,19,10,1,11,172077,1603,111,471,580
9,5,4,5,8,22010,21835,20,2310,436
3,1,2,0,3,4208,0,9,6823,524
8,5,3,1,16,20004,3706,24,3706,575
10,6,4,7,9,66862,91184,119,26205,401
18,12,6,8,13,56998,19740,69,2480,490
19,6,13,4,22,52429,118282,54,0,554
16,14,2,2,15,236768,3780,18,0,498
12,6,6,2,13,241257,52669,24,49048,601
7,5,2,4,32,124663,118569,110,3151,483
18,0,18,0,10,0,0,28,4613,594
82,4,78,2,17,10640,21215,23,9890,691
3,1,2,0,11,3860,0,0,1250,657
16,4,12,1,17,41175,4208,6,1805,600
7,4,3,5,9,71693,52746,107,4357,506
29,2,27,1,13,23898,6589,27,6589,524
23,6,17,5,18,530868,120399,16,1493,466
61,10,51,3,13,170951,48926,304,35496,556
20,11,9,5,34,171074,21351,79,0,453
10,8,2,6,6,181002,64404,79,4541,527
11,4,7,1,5,1706,71,201,2441,540
33,5,28,2,12,77504,7575,12,6730,452
14,2,12,2,14,37463,37463,29,37100,584
6,4,2,4,15,390063,72983,20,4517,462
26,4,22,6,13,63395,62869,196,1911000,489
3,1,2,2,7,11237,22568,47,0,490
11,4,7,4,10,18383,18383,23,6314,450
13,3,10,0,7,31314,0,23,1827,504
11,6,5,3,6,7740,33882,110,3929,487
9,3,6,2,12,57165,19778,24,13086,477
3,1,2,1,6,0,6365,10,0,620
7,3,4,3,6,28790,28790,34,27440,452
14,11,3,0,7,61310,0,6,0,617
14,12,2,2,25,1071493,33298,60,17040,445
26,5,21,7,7,122216,122216,227,2542295,461
10,4,6,3,7,12338,7734,64,2480,478
41,14,27,5,13,597045,67929,75,0,446
26,7,19,2,10,400205,67161,68,67160,516
19,7,12,5,12,21034,19906,119,10491,636
15,12,3,12,8,146950,138836,160,7485,406
10,4,6,1,8,20399,4758,44,4758,673
14,11,3,3,19,204520,9115,61,4940,368
29,6,23,3,9,150764,109799,64,2520,494
7,4,3,4,19,14551,99401,99,5734,491
11,0,11,1,7,0,1599,46,2904,572
414,7,407,4,14,73241,62308,61,47385,423
6,3,3,0,4,56543,0,0,0,659
6,3,3,2,9,102920,25269,0,0,620
7,3,4,2,13,217123,3721,43,6177,552
16,10,6,6,6,361044,134551,84,3171,435
16,7,9,6,12,368832,180473,161,97159,473
37,4,33,5,8,150932,117876,43,3896,455
42,9,33,7,19,728821,61922,128,31035,479
8,6,2,3,8,10575,10575,286,6906,525
36,8,28,8,32,33406,47598,145,8773,453
16,6,10,0,14,65610,0,0,0,691
10,8,2,0,5,148745,0,0,0,613
17,10,7,6,8,126056,6572,14,847,400
54,8,46,7,19,55766,60610,170,18980,397
10,4,6,3,10,215872,6968,110,3561,558
14,11,3,7,6,259131,26980,65,5387,418
37,11,26,6,13,259525,19464,91,18445,460
30,7,23,5,8,58360,32684,48,19788,506
21,6,15,6,13,50393,47262,169,19327,473
25,6,19,0,14,287268,0,19,47525,643
12,6,6,2,13,1746974,232586,64,0,465
10,7,3,4,7,23552,16652,85,5254,470
33,15,18,4,18,386898,26497,17,5939,479
5,2,3,1,6,5243,5243,214,5243,610
8,3,5,2,14,23870,19862,20,46377,555
19,16,3,12,11,765075,603385,133,7351,492
6,4,2,3,13,33547,17142,44,4366,462
9,6,3,1,18,755055,380,35,601,436
17,9,8,6,4,77061,59724,0,0,446
28,14,14,2,10,706550,18879,20,0,556
49,14,35,8,10,172088,54017,146,12434,430
7,5,2,1,11,22555,8455,36,1545,484
8,2,6,0,45,0,0,7,6738,468
35,3,32,2,11,14008,14008,34,11428,568
6,2,4,0,7,9635,0,3,0,490
27,10,17,9,13,109584,95113,163,56414,463
15,5,10,2,12,88262,10371,77,3489,454
26,5,21,3,26,14660,12141,51,4361,470
23,10,13,2,10,45229,21301,102,15896,569
24,9,15,2,19,42954,1918,39,1083,448
10,3,7,2,12,18557,30928,52,18557,489
25,3,22,1,16,7177,985,2,770,445
23,5,18,2,9,135016,3000,13,2471,586
3,1,2,2,7,0,14091,0,0,640
9,7,2,6,25,31903,31131,80,10933,456
32,16,16,0,22,4380241,0,7,0,586
8,6,2,2,7,49223,15515,15,13800,604
5,3,2,3,9,17589,679,58,357,614
31,12,19,17,15,421222,716393,385,155250,454
28,15,13,2,8,158472,573,11,1154,520
7,4,3,3,14,277883,11497,53,0,488
13,7,6,0,20,155926,0,0,0,716
6,1,5,0,12,0,0,0,1475,756
10,7,3,6,10,50015,45493,74,12797,397
17,7,10,5,9,25412,67900,0,0,483
30,5,25,1,13,283956,984,8,13203,508
3,0,3,0,7,0,0,38,0,610
36,2,34,2,15,29307,28582,32,20858,652
8,1,7,1,16,2274,2274,3,14227,505
6,4,2,5,7,42200,46236,44,14491,446
16,5,11,2,12,35267,9811,4,8633,438
53,22,31,8,17,938936,243358,191,2794,453
4,0,4,0,7,0,0,21,713,532
16,10,6,10,9,447642,873066,238,135707,437
14,7,7,4,13,42734,36116,70,250,458
51,6,45,4,9,26411,26411,191,8198,490
13,8,5,7,14,69964,69963,148,24018,476
23,1,22,1,14,62357,7015,26,0,640
6,3,3,2,8,158237,96390,48,2788,493
6,2,4,1,15,15000,15000,23,26837,650
37,15,22,14,8,130700,131277,88,13508,410
5,3,2,2,4,66608,3149,0,0,609
16,10,6,0,8,1442358,0,12,157,580
13,5,8,3,7,29700,5400,37,3600,414
67,12,55,1,18,586261,596,101,2046,615
5,2,3,2,15,73996,10233,0,0,482
11,6,5,2,12,27837,643,75,5705,513
10,4,6,4,8,15021,14507,20,5995,479
7,3,4,2,14,242716,12324,45,0,459
27,4,23,1,14,1017493,6313,20,41751,578
11,3,8,3,9,31756,23193,55,16567,529
11,1,10,0,7,5059,0,0,0,704
4,2,2,0,13,6712,0,4,0,616
10,6,4,0,5,158004,0,0,0,621
16,5,11,5,21,77152,77152,82,6860,433
9,7,2,1,13,114245,5519,23,5519,683
26,4,22,0,12,489,0,51,4978,649
26,16,10,0,18,1196957,0,22,0,610
16,7,9,0,12,129771,0,8,0,553
13,6,7,5,7,57653,56253,18,13231,519
21,8,13,1,9,65686,4362,36,4362,562
23,8,15,6,11,85569,84149,60,28605,434
37,5,32,7,10,76373,73406,164,17498,489
17,14,3,0,15,616332,0,1,18325,648
29,9,20,4,13,222687,87059,188,13503,518
4,2,2,2,6,4372,4372,41,4176,478
26,6,20,4,16,398688,45908,67,5959,463
26,7,19,6,17,75029,33666,109,16113,381
13,5,8,2,13,33575,8415,30,386,474
8,3,5,4,13,96465,68630,57,12600,464
12,4,8,1,6,56518,50830,23,0,545
18,8,10,1,17,70205,24528,40,349,533
23,16,7,2,8,341112,342,18,1290,482
9,4,5,3,4,157867,139498,22,1012,490
9,5,4,0,7,31365,0,0,0,632
17,8,9,6,18,216219,176965,124,0,510
8,5,3,3,8,34433,34433,46,30477,431
16,7,9,3,12,200004,33749,86,5836,472
9,4,5,4,10,50243,53408,37,28400,550
16,12,4,12,10,31394,27377,257,12990,406
20,6,14,1,18,565924,10911,6,15684,674
10,7,3,3,7,477185,25627,25,0,466
23,13,10,8,19,1042445,179923,244,5332,456
17,9,8,3,20,88537,32833,124,13079,566
24,4,20,2,10,29489,22739,38,2219,422
96,6,90,1,14,27063,3721,25,3147,640
15,8,7,5,12,342529,23312,48,1119,455
12,5,7,3,2,132964,40671,11,36122,449
9,6,3,4,22,236498,58871,24,2938,484
18,4,14,4,18,53937,53937,97,22548,429
93,6,87,6,16,22480,49733,178,8507,489
6,4,2,3,8,12608,12359,94,9448,476
9,4,5,3,5,81830,10268,26,0,523
22,8,14,1,18,420444,1763,0,3406,418
10,8,2,0,3,81782,0,0,0,641
18,2,16,2,15,24700,24700,51,18508,568
28,11,17,0,7,73136,0,30,4392,543
11,8,3,3,11,371755,21972,60,0,525
15,8,7,3,12,33275,33275,156,25571,395
18,4,14,3,7,12537,6070,19,5741,502
5,1,4,2,10,2527,10212,50,2527,456
8,6,2,3,17,41139,10511,53,1115,545
14,4,10,2,7,53983,10582,91,9344,576
93,12,81,9,13,78923,74441,520,26158,440
5,3,2,1,10,10051,5807,27,0,539
10,5,5,1,69,10002,5250,25,6017,504
41,4,37,2,18,14057,6889,29,3514,648
28,8,20,4,17,267587,41934,38,25631,546
18,5,13,7,21,341237,433664,83,143668,412
18,13,5,6,7,38436,6284,96,2407,391
4,2,2,2,6,19316,19316,0,0,563
24,7,17,2,16,127602,22930,390,2578,512
5,2,3,1,5,3152,179,1,179,592
30,8,22,4,9,22203,4935,21,2056,400
2,0,2,0,5,0,0,0,0,570
7,3,4,1,9,1697568,41225,17,0,684
12,5,7,9,9,45584,56536,0,0,465
5,3,2,1,9,117437,2446,24,6823,444
36,9,27,1,14,117377,321,86,3562,518
14,11,3,6,11,302709,38625,114,15186,495
19,13,6,1,23,850956,18455,35,2220,543
13,7,6,0,9,140447,0,3,0,635
10,2,8,4,13,12659,317320,84,7680,432
17,14,3,10,8,307020,64855,112,21793,407
8,6,2,0,9,314415,0,5,1,660
9,1,8,1,13,213711,5300,0,0,585
116,13,103,2,27,970493,14786,17,14500,611
28,7,21,2,8,159451,45479,50,10850,442
8,5,3,4,11,17768,17768,20,12943,422
11,9,2,1,19,487718,916,0,0,565
4,2,2,1,16,269333,11465,0,0,543
11,7,4,4,8,65564,18346,73,0,454
42,17,25,16,17,1506879,325578,299,43471,453
20,7,13,0,19,228563,0,0,0,518
5,1,4,2,9,7645,7645,17,1425,612
39,9,30,7,13,634029,32209,140,5715,432
9,6,3,2,16,37975,16815,25,4007,516
9,4,5,1,18,276542,1715,0,0,635
7,3,4,0,6,66315,0,3,0,590
14,4,10,2,8,5636,5314,118,4057,588
13,3,10,5,13,14509,23671,67,3188,525
24,5,19,3,6,21173,16504,61,9580,451
29,9,20,9,16,388555,203183,144,76214,423
9,5,4,6,5,387205,569160,130,0,483
26,16,10,11,16,148877,84853,81,13956,475
8,5,3,5,19,30663,28842,151,9697,393
19,5,14,8,7,87362,103200,198,46802,516
9,3,6,2,14,35157,23612,92,4981,454
6,2,4,1,12,137438,71214,26,71214,586
4,2,2,0,15,0,0,31,1323,571
51,13,38,3,15,366206,7004,109,3611,577
27,11,16,10,7,253552,48819,142,6977,411
31,13,18,5,7,277475,47880,24,0,470
7,2,5,1,9,5627,2938,4,2938,641
9,7,2,0,8,57521,0,0,92,599
4,2,2,3,7,3138,3138,55,1579,464
7,1,6,1,7,203535,2329,13,606,644
8,4,4,4,4,1091692,464565,41,0,531
103,5,98,3,10,28534,15102,25,8949,527
5,3,2,3,8,37121,16394,32,0,474
10,2,8,0,22,97957,0,0,0,649
16,5,11,0,15,422171,0,0,0,655
3,1,2,1,14,13363,13363,3,13363,464
23,6,17,5,15,314923,40226,76,16428,493
11,4,7,4,12,14265,12419,79,10532,471
24,11,13,1,21,832278,1467,39,1467,497
10,1,9,0,11,1671,0,0,0,607
29,7,22,1,19,567793,10427,74,10427,485
74,10,64,7,21,480823,92251,113,7504,449
6,4,2,0,2,31240,0,2,219,641
5,2,3,0,14,202417,0,0,0,567
44,13,31,11,14,159233,130655,403,43691,381
11,4,7,0,10,149266,0,4,1380,626
13,6,7,0,9,60688,0,1,0,649
5,3,2,3,10,33333,12354,51,2999,488
6,3,3,4,7,55672,34527,55,755,456
257,0,257,0,6,0,0,0,0,587
8,3,5,0,10,340225,0,0,0,669
22,15,7,5,25,719730,347294,36,221119,534
15,5,10,0,14,438363,0,10,0,640
7,4,3,4,4,29150,27361,173,22490,480
26,9,17,8,8,56040,56040,118,31604,518
15,10,5,3,7,149486,9272,21,0,449
4,2,2,1,14,3573,1815,6,1815,535
3,1,2,1,12,12596,12596,95,19319,515
7,4,3,0,5,1808121,0,0,0,620
14,7,7,3,16,16253,12928,62,10530,528
9,7,2,0,8,380617,0,0,0,592
18,8,10,3,11,34053,6274,38,4444,452
25,11,14,11,11,107033,115634,44,11187,343
31,1,30,1,11,1350,1082,30,12003,670
86,7,79,8,8,70464,77977,421,28034,490
61,12,49,7,22,80162,22569,63,89746,444
83,8,75,1,8,199861,9611,35,9611,496
7,3,4,1,13,971,971,2,971,550
13,7,6,7,21,461287,72129,113,36004,435
43,10,33,1,13,67682,3423,215,9020,493
10,8,2,7,16,42391,27517,117,2112,464
9,5,4,2,10,39748,21877,0,0,573
10,2,8,0,12,24551,0,2,2536,599
120,21,99,11,25,504636,216059,123,51164,417
10,8,2,0,19,37004,0,48,2857,538
21,6,15,0,17,155635,0,26,6445,534
10,7,3,2,4,41039,24612,33,0,493
21,11,10,1,11,69888,247,12,4883,395
12,3,9,2,10,33599,14167,112,9007,458
24,7,17,10,12,178084,173405,118,0,552
53,5,48,5,14,53985,215428,0,0,508
11,8,3,2,11,103186,3028,0,1986,510
28,14,14,8,25,523785,127436,178,1374,457
41,8,33,9,14,26834,26179,174,26784,467
23,6,17,2,8,365655,2889,150,2838,525
10,4,6,4,11,31492,34042,74,468500,513
28,21,7,16,12,459986,44746,66,7502,336
11,9,2,0,2,107976,0,1,0,535
23,5,18,7,10,95504,115107,5,5306,456
19,13,6,10,14,150021,127095,226,6800,451
28,9,19,4,20,79469,16100,83,330,495
10,7,3,7,11,216676,416677,78,251865,528
7,5,2,1,12,43806,4458,0,0,514
25,15,10,12,20,918628,769247,235,0,499
6,2,4,3,12,182723,110828,40,0,452
37,8,29,9,13,50162,56877,150,13033,423
27,5,22,0,18,35317,0,0,1130,635
15,7,8,5,19,214311,78532,43,0,476
24,12,12,6,20,905624,74761,94,5944,505
9,6,3,2,5,63287,61754,19,959,526
3,1,2,0,8,506008,0,1,0,721
15,8,7,1,14,503815,2030,13,0,677
12,8,4,6,13,467153,28942,107,26866,470
13,11,2,1,6,240246,2266,9,2266,503
12,5,7,4,6,24237,8964,49,4120,476
25,8,17,6,11,56665,56665,46,20143,458
27,8,19,7,13,364867,88232,129,25842,487
23,11,12,0,13,305692,0,10,378,626
5,2,3,2,3,6792,5582,26,4229,445
12,2,10,2,10,9472,9472,20,3846,484
16,13,3,1,12,763064,998,5,8616,594
9,4,5,3,17,45126,25371,41,15179,540
40,37,3,30,8,568293,263636,450,20002,390
3,1,2,0,10,8572,0,1,1080,559
3,1,2,1,6,7321,7321,23,7321,575
8,6,2,3,13,60913,10844,120,9932,532
12,3,9,5,11,582328,225806,4,15050,492
36,12,24,4,10,704203,14018,58,900,520
8,2,6,1,10,1096,1096,22,1971,599
13,4,9,3,13,362671,22136,44,8147,463
10,6,4,5,7,57015,57015,177,19735,451
81,8,73,8,19,654557,1143939,222,324755,454
7,3,4,4,18,471623,30447,50,0,535
18,15,3,1,8,1677297,3041,5,3654,568
16,4,12,4,8,14319,14319,148,11500,413
10,5,5,5,9,15724,21614,17,4004,481
10,5,5,4,11,80011,28035,209,1571,478
9,5,4,5,5,50023,87457,44,12545,491
8,6,2,5,11,380206,29832,51,12185,461
5,3,2,2,12,9346,8346,42,6666,530
15,8,7,6,69,22752,22752,241,10594,473
12,6,6,2,15,323720,4449,44,1800,667
16,8,8,2,9,80067,23811,102,2174,484
24,9,15,2,14,80173,3596,25,7715,519
29,4,25,1,8,372303,12027,9,6552,439
12,6,6,8,8,87170,165466,121,67272,460
44,5,39,4,10,151553,8055,137,10950,517
18,13,5,6,14,503133,9235,82,1176,453
6,4,2,4,8,19443,19443,47,8755,521
38,16,22,8,23,402808,195803,114,2756,524
13,10,3,1,11,572291,890,4,1463,568
47,7,40,6,9,531939,153410,106,121366,472
18,7,11,2,14,198427,2908,15,0,531
35,12,23,4,25,118572,32073,206,17840,537
14,3,11,3,14,65164,65164,3,50559,460
29,4,25,6,69,25135,37367,164,10183,427
30,9,21,5,9,322006,25316,67,2906,491
7,4,3,4,7,125825,38718,73,3397,444
12,6,6,6,16,60766,10778,0,0,479
10,5,5,3,11,41221,25743,23,8450,386
206,9,197,7,17,25253,14313,100,6820,435
11,5,6,1,13,300628,3320,16,2185,542
20,5,15,7,14,150032,20571,35,4146,474
24,3,21,2,8,10156,998,2,508,532
15,4,11,3,8,8062,4201,37,3857,450
19,6,13,0,6,29185,0,0,0,606
42,11,31,7,13,336344,106002,293,23940,396
8,2,6,1,13,3828,69,13,0,617
18,7,11,0,7,49377,0,18,0,620
11,7,4,4,14,24277,15152,55,4967,424
51,15,36,10,18,224398,193519,303,11375,453
6,4,2,1,18,455566,3168,18,3168,519
17,12,5,6,4,78786,45397,73,13480,441
32,8,24,6,13,36276,18486,144,1297,519
10,8,2,7,7,26782,23584,41,4747,500
49,27,22,5,13,923155,4520,40,5177,528
4,2,2,1,7,170,170,28,594,571
14,3,11,0,7,28888,0,62,3342,679
13,3,10,3,10,23669,21949,64,7580,556
6,3,3,1,9,8857,2199,32,0,458
11,7,4,3,6,168317,46640,0,0,513
31,12,19,5,7,114137,22589,66,1940,416
4,2,2,3,10,25584,36345,44,0,546
5,3,2,1,8,12497,12497,94,24994,531
20,16,4,6,25,547682,115267,47,60338,488
10,6,4,1,11,104674,372,7,0,419
152,3,149,1,7,1913,1913,0,0,459
19,9,10,3,12,53543,9076,108,24864,505
19,6,13,7,20,364529,78946,216,15976,478
8,2,6,1,12,5100,5100,26,10200,595
28,9,19,4,7,180499,26373,74,2300,495
12,3,9,1,7,33162,1697,16,867,625
9,4,5,2,9,365718,14896,206,13376,539
21,5,16,0,69,155326,0,43,8450,501
12,8,4,2,10,365438,165836,33,158546,406
31,11,20,5,16,240951,80552,34,64207,494
62,17,45,3,9,530820,1152,142,3638,601
28,4,24,2,13,43311,7241,336,9636,482
13,6,7,4,7,312217,312217,49,14626,425
3,1,2,0,1,2500,0,1,2000,543
18,8,10,1,11,506356,17683,21,17683,639
20,8,12,8,10,42835,28345,99,8441,479
25,8,17,7,19,199309,164848,110,103000,468
13,5,8,0,9,14389,0,0,647,693
11,8,3,1,9,559378,5089,8,5089,513
18,15,3,3,6,453374,25244,7,0,547
60,11,49,0,14,95713,0,21,0,628
13,4,9,0,8,50031,0,17,647,515
18,7,11,7,7,346037,45033,33,4220,421
23,14,9,5,10,271024,16860,59,11266,442
7,2,5,2,12,7482,7482,46,5901,597
8,4,4,4,12,57121,42814,44,31657,483
32,12,20,10,15,197720,94038,108,36059,449
29,7,22,4,8,40523,27199,79,856,478
39,10,29,5,14,46016,28318,169,13000,461
4,2,2,1,8,275142,1200,5,1250,657
16,13,3,6,7,362538,33613,60,5582,382
4,2,2,1,11,99029,138,2,361,612
26,4,22,4,9,77064,32477,106,0,532
3,0,3,1,11,4692,4692,0,0,558
16,6,10,3,10,60999,42033,55,12470,601
6,4,2,2,14,36178,25417,0,638,526
13,4,9,0,11,304809,0,0,0,639
16,5,11,2,18,1102,1101,81,11548,546
31,5,26,3,13,84484,69642,43,23933,370
15,5,10,0,6,431812,0,0,0,567
12,6,6,6,10,265924,416282,16,107468,500
15,6,9,5,12,82654,40389,110,9280,448
19,11,8,10,26,122977,139746,146,16769,509
22,7,15,4,12,42034,37053,381,20805,532
8,6,2,5,12,9891,9891,52,2855,387
35,13,22,6,7,47787,35997,381,29081,475
18,7,11,5,6,29978,12796,230,4349,405
9,4,5,1,17,233644,51,62,51,500
25,5,20,8,10,15244,26790,65,4500,494
12,8,4,0,7,109605,0,1,502,631
59,9,50,1,12,186662,1799,25,0,506
8,2,6,3,18,199962,338075,43,171531,526
24,2,22,0,16,58092,0,163,1960,652
65,13,52,5,13,87752,23766,81,8900,469
7,3,4,1,7,156718,241,23,0,620
10,4,6,3,6,804882,309305,57,48847,486
5,2,3,1,4,1762,508,104,1532,509
19,8,11,1,9,72005,675,1,675,550
11,7,4,4,9,64422,40716,130,13594,503
13,10,3,5,7,297908,22749,62,111,498
33,11,22,5,18,84671,31011,328,17208,445
40,9,31,1,5,164291,3201,0,0,545
36,5,31,4,14,523460,120361,114,89470,465
11,5,6,4,14,28127,31284,62,481,461
13,6,7,8,8,419282,327102,108,0,472
28,10,18,3,18,3632328,59296,25,5667,492
95,11,84,8,11,93581,41235,219,19405,410
28,17,11,7,21,388842,46071,38,0,476
9,7,2,1,4,33802,1036,18,225,410
22,6,16,1,9,178990,724,39,1754,528
7,4,3,0,6,80215,0,11,0,667
21,8,13,2,3,193604,18062,22,13801,488
5,0,5,2,9,0,90911,37,0,592
96,4,92,0,13,16889,0,0,800,689
26,9,17,0,10,584511,0,18,0,595
10,2,8,4,8,31932,71503,90,0,432
14,7,7,0,17,786374,0,0,1620,619
10,5,5,7,8,31907,42744,103,12127,404
22,8,14,6,7,46327,33928,217,21130,429
11,6,5,3,6,25685,3705,11,2421,494
7,5,2,0,6,177811,0,1,0,512
16,7,9,1,18,211394,17200,22,17200,561
22,4,18,2,7,16251,12507,117,7388,568
25,13,12,0,8,770022,0,77,2218,510
33,14,19,0,4,303606,0,16,366,595
24,6,18,4,8,37632,24667,78,4500,439
20,10,10,10,4,47184,47734,97,9428,425
13,7,6,4,16,399350,60358,63,17246,434
11,6,5,3,7,136180,14314,55,8942,421
10,7,3,1,6,272287,1564,12,1564,434
24,12,12,1,16,44492,6780,15,6780,468
8,4,4,3,12,303824,14436,61,4949,446
15,11,4,0,9,170784,0,9,0,548
25,13,12,9,8,418784,42332,155,13400,449
28,14,14,12,17,636199,267326,144,4654,505
9,3,6,4,10,72019,72669,50,3820,487
11,8,3,1,6,294080,934,37,3241,464
13,4,9,3,10,11718,11718,64,7090,466
7,3,4,1,4,67236,502,18,512,518
14,9,5,4,9,650456,16261,86,0,519
88,17,71,3,30,782360,149622,0,0,494
35,8,27,4,11,94473,17102,239,13709,492
32,4,28,4,8,10716,2653,184,1343,514
17,6,11,4,11,207673,43662,0,0,535
22,1,21,2,15,24838,24838,8,24608,649
15,10,5,0,7,176689,0,0,0,642
9,6,3,5,15,361338,228461,67,191101,450
15,5,10,3,13,116532,174684,56,0,507
17,9,8,1,5,809733,7325,7,3439,593
7,2,5,1,6,6076,3826,24,3826,608
9,4,5,1,69,627765,76044,26,1787,540
7,5,2,3,13,116375,5248,38,0,528
27,14,13,3,12,523258,15318,119,18412,423
13,8,5,5,12,48958,28594,89,19196,446
9,3,6,0,8,37110,0,9,1659,632
7,4,3,4,5,18688,2483,26,1155,497
5,1,4,0,9,6521,0,0,0,621
34,7,27,3,8,45661,4387,48,4126,536
8,3,5,3,12,28780,18001,120,8479,543
23,4,19,1,38,13592,9705,10,1539,514
10,8,2,4,11,70351,25972,30,822,454
15,12,3,5,14,1679062,431654,114,298918,513
28,13,15,0,12,355002,0,15,831,616
31,22,9,14,9,418962,81443,110,5841,439
12,5,7,5,4,11662,166724,102,631211,461
5,3,2,1,11,12252,5766,3,569,506
9,6,3,3,12,49116,13862,19,6919,444
11,2,9,0,16,12988,0,0,358,587
5,3,2,3,5,20585,20456,56,15700,580
17,8,9,12,13,380529,587804,14,144167,449
11,7,4,2,11,112746,4958,49,765,529
9,5,4,5,8,19891,15715,0,0,429
7,2,5,2,4,24854,8752,36,7951,518
3,1,2,0,6,0,0,24,927,649
13,7,6,0,6,112143,0,12,0,658
25,14,11,6,14,509945,77610,6,1884,492
10,5,5,7,6,162744,290052,66,83703,462
18,6,12,2,9,41866,9777,15,4366,481
8,3,5,3,19,259687,12034,33,6500,567
13,6,7,9,10,227161,296000,173,44168,470
19,15,4,0,11,939119,0,9,0,528
29,7,22,7,5,18522,17849,144,4188,413
14,7,7,7,17,247063,79002,113,29095,434
7,5,2,5,7,61792,55955,102,0,490
42,16,26,0,13,216804,0,112,3738,452
14,9,5,7,25,171979,97971,19,37432,487
8,6,2,6,9,15431,15431,163,7236,449
7,4,3,4,14,179773,41627,21,25636,474
31,10,21,0,7,215178,0,12,1163,494
17,5,12,2,8,52294,11516,61,14733,523
20,8,12,4,17,732192,670794,4,12488,443
12,3,9,4,9,112187,90952,0,0,557
5,3,2,2,12,11394,10602,11,8081,461
27,5,22,5,11,78377,16883,69,9938,419
19,9,10,4,10,77424,23918,43,2979,491
9,5,4,1,12,8917,2346,5,4054,452
14,6,8,7,29,93604,139480,45,0,511
17,4,13,6,20,150712,199935,152,20250,418
14,8,6,7,8,57570,57570,179,12048,520
5,2,3,0,6,72799,0,6,0,545
27,17,10,13,14,493799,223652,229,79800,476
12,8,4,9,8,84074,92920,214,13051,444
19,14,5,8,8,165481,41133,107,11017,439
8,3,5,6,12,413841,594061,123,208253,421
8,5,3,4,9,81822,47865,25,41912,480
9,7,2,0,9,161606,0,38,0,591
22,3,19,2,11,26642,24515,54,22508,591
10,7,3,4,7,32943,31768,81,17907,479
12,5,7,2,9,753389,19328,9,7244,478
10,4,6,1,6,7798,707,25,1855,566
9,7,2,4,4,48471,16865,20,2876,437
27,10,17,7,17,611087,143160,99,20942,434
51,10,41,5,14,395512,71794,99,15662,486
15,8,7,9,11,161137,124359,127,43914,476
5,3,2,0,4,2702,0,0,0,673
8,6,2,1,4,82623,353,6,0,588
17,5,12,4,15,206897,44800,36,21214,477
14,11,3,9,17,787037,165751,122,57468,430
9,7,2,4,7,24001,3253,330,2218,449
11,3,8,1,12,40893,31910,16,241,543
19,9,10,9,17,60492,98851,46,33119,440
9,5,4,3,8,511556,982,57,837,427
27,12,15,11,18,739037,114300,24,37421,511
9,7,2,0,13,605098,0,9,3903,594
13,7,6,0,16,47124,0,0,0,555
11,6,5,1,9,14340,405,1,482,504
13,7,6,0,2,42633,0,25,1926,540
12,10,2,8,14,54754,50456,131,8086,395
7,3,4,3,18,22977,21558,12,4494,492
29,8,21,2,10,139061,5812,8,3791,489
43,4,39,4,14,263209,32047,37,6820,531
23,5,18,2,8,18481,5254,31,4536,504
37,3,34,0,8,21535,0,14,214,600
27,10,17,7,14,134152,76460,319,13025,444
15,3,12,2,13,14775,10819,53,19334,455
20,2,18,1,13,273756,32597,21,4920,489
15,7,8,5,5,64736,16354,389,3418,475
4,2,2,1,9,354583,8160,9,0,680
23,4,19,7,7,34288,71658,297,802,472
57,13,44,3,14,83280,16338,118,19554,524
10,6,4,3,13,1155164,149648,19,134983,516
7,4,3,0,5,31078,0,2,3536,645
60,18,42,14,12,736823,491104,296,12182,442
5,2,3,4,8,51650,81286,17,19495,496
9,6,3,5,8,410310,85460,24,9656,458
7,5,2,0,8,10004,0,1,0,668
17,3,14,1,10,0,71782,63,91,616
26,7,19,3,22,33323,22523,37,14722,514
14,9,5,10,12,170768,201477,205,51764,380
8,3,5,2,11,47332,28395,18,23027,495
106,21,85,8,10,270251,17803,177,7510,465
10,5,5,2,69,364386,3139,49,47,512
20,13,7,0,6,199382,0,3,0,579
11,5,6,1,13,171653,10228,29,0,532
25,6,19,6,13,16246,48506,67,4202,579
7,3,4,2,14,21867,11989,25,11821,549
14,7,7,2,24,242881,155741,25,0,610
15,5,10,2,6,19631,5093,48,7380,483
11,7,4,0,9,100327,0,17,0,506
25,9,16,1,12,608771,1699,15,1699,567
23,3,20,2,10,11635,11635,128,6534,477
5,2,3,0,5,15400,0,4,1941,525
62,16,46,3,29,286360,1454,418,11240,462
8,4,4,2,16,219049,204582,26,180510,545
10,6,4,0,7,244989,0,0,0,648
7,5,2,4,6,292485,15338,316,7525,471
3,1,2,2,6,27225,20954,3,555,591
6,4,2,1,8,209912,2363,27,512,512
8,5,3,0,26,50782,0,3,1521,604
13,7,6,5,15,434416,40606,44,14415,463
5,3,2,2,12,14405,14405,20,26612,486
3,1,2,2,4,10311,10311,15,5805,513
10,7,3,0,9,31484,0,13,0,669
17,10,7,5,13,97851,129883,103,0,575
8,6,2,7,7,54840,53903,127,10017,485
13,7,6,0,13,43431,0,1,3165,522
69,20,49,9,15,1142683,353793,70,74564,472
13,8,5,5,8,49619,4232,124,2885,480
10,8,2,2,12,248311,10016,8,0,543
23,6,17,2,18,46210,29507,37,18098,578
15,7,8,7,4,208021,201060,26,84178,425
8,4,4,1,5,25669,54,5,54,574
9,6,3,1,9,26550,1171,55,863,508
9,3,6,4,8,31366,47106,32,24596,602
20,5,15,4,7,30754,16312,123,7094,510
27,5,22,3,15,265075,8079,55,10767,498
14,9,5,0,28,348270,0,48,0,690
45,5,40,2,14,15591,3483,7,2848,499
18,3,15,3,14,282653,39101,65,4193,527
18,13,5,0,10,496176,0,18,2991,566
14,7,7,3,12,1900571,133104,23,0,520
18,11,7,0,9,93284,0,7,0,616
18,5,13,2,14,20648,10505,97,11219,532
9,5,4,5,14,33867,33867,135,12387,474
8,5,3,1,6,1,9882,22,0,612
27,12,15,8,28,106323,63228,184,15911,480
11,3,8,4,10,18816,29275,63,4659,546
24,8,16,0,9,476804,0,0,0,565
49,18,31,2,20,237037,8333,69,12500,418
14,10,4,10,14,939705,103547,148,11654,427
16,14,2,0,14,291553,0,92,576,547
8,5,3,5,12,251150,53551,82,43197,456
9,7,2,1,11,34293,416,0,0,494
11,1,10,0,14,5648,0,2,0,612
9,1,8,2,14,2990,6515,35,3525,604
6,1,5,2,6,1408,14748,19,13340,547
11,3,8,4,10,201357,316722,82,11044,504
8,2,6,0,8,835,0,7,0,655
9,3,6,2,5,4475,4475,46,3075,447
12,10,2,4,13,384114,6580,16,1953,555
16,9,7,0,8,33811,0,13,1117,572
11,6,5,3,23,242202,120729,36,62401,531
11,4,7,7,8,280121,103399,104,512,470
97,15,82,11,17,170583,111338,464,24056,478
6,3,3,4,8,24987,26532,21,9616,443
46,18,28,3,18,475806,48638,27,21493,511
6,3,3,1,5,22633,2220,44,2220,539
22,12,10,4,44,141013,20736,245,18951,452
20,7,13,2,9,56111,14827,4,6226,454
10,3,7,1,20,479531,13066,75,13066,502
13,4,9,0,16,67162,0,27,2119,647
5,3,2,4,7,1928,1927,36,712,477
7,5,2,3,7,11527,469,94,603,579
13,2,11,1,2,9392,7130,9,7130,454
33,10,23,4,9,105653,26646,110,11030,483
5,2,3,1,10,0,12928,30,0,516
14,6,8,5,10,42698,16335,37,6998,434
7,3,4,3,8,9626,9626,334,7700,489
50,10,40,0,14,259465,0,3,165,651
14,9,5,3,18,51671,27560,56,0,453
9,4,5,2,8,42046,31655,25,21368,603
20,8,12,5,13,40670,33740,81,3529,443
37,17,20,0,23,1179435,0,32,5736,449
18,8,10,8,7,37725,38466,417,13983,423
29,7,22,3,8,13362,12580,101,12750,501
8,6,2,0,11,1011244,0,0,0,642
10,6,4,5,10,34759,32823,186,26252,449
12,7,5,2,6,1250125,2690,24,596,552
8,4,4,0,15,373923,0,4,1011,614
16,6,10,2,24,1323,10591,5,2685,468
1786,15,1771,3,23,363910,196495,156,114149,443
8,5,3,0,17,170357,0,0,0,582
12,6,6,3,7,35059,2041,94,1811,475
5,0,5,0,13,0,0,0,0,552
11,7,4,8,8,39573,39500,126,0,512
6,1,5,1,15,0,15011,5,6111,641
10,3,7,4,7,101073,151687,91,22135,469
23,13,10,0,14,60910,0,0,1832,679
13,10,3,2,5,126405,1901,53,1708,624
9,5,4,4,5,22433,20711,215,4291,462
13,3,10,4,7,28004,59386,70,7155,628
4,1,3,2,14,71412,71412,2,2535,541
18,7,11,0,13,100751,0,3,56,454
52,1,51,2,11,9533,27602,3,1495,600
15,9,6,3,7,302280,5322,22,3989,425
5,2,3,1,7,637,13246,40,0,601
7,3,4,3,8,702647,48546,42,0,511
8,6,2,5,19,397969,30509,82,22763,487
2,0,2,1,7,0,17630,25,0,610
8,6,2,4,18,262411,46016,52,4016,478
20,9,11,1,7,344880,6709,37,5018,497
25,8,17,4,14,55476,17921,234,10385,414
29,8,21,9,16,40838,39212,113,5898,438
8,4,4,2,8,68266,19497,45,25668,446
11,4,7,1,9,24227,5875,97,5875,633
10,6,4,5,27,4712516,4480110,73,327939,481
52,15,37,15,19,100825,100825,269,36853,429
11,9,2,7,8,164287,89350,152,10314,481
6,4,2,0,16,46275,0,0,0,640
45,15,30,11,11,428544,234759,171,2892,423
23,9,14,6,14,21974,20737,98,12060,447
13,9,4,0,12,1597700,0,16,15958,474
30,11,19,7,21,667492,48330,85,16908,388
43,18,25,7,17,244236,55510,79,4979,474
33,15,18,1,21,312204,1293,39,976,598
7,5,2,1,7,25132,5472,80,5472,470
4,1,3,0,9,0,0,11,0,655
17,10,7,0,69,841154,0,66,283,469
10,8,2,0,14,35556,0,2,5187,603
8,5,3,3,10,214011,17630,43,8793,462
25,8,17,7,8,69876,26839,154,4429,463
66,8,58,4,5,351806,261440,98,70975,460
35,5,30,1,13,232747,32298,44,7720,482
23,11,12,4,8,500807,282102,0,0,491
9,6,3,2,11,536709,61170,57,247,522
24,7,17,1,18,635315,2875,50,19485,447
13,6,7,0,69,86236,0,0,15000,535
12,8,4,2,15,227369,6303,31,5326,548
6,4,2,1,9,256,533,26,3817,627
15,8,7,0,7,12435,0,1,428,630
13,11,2,8,9,46118,46198,131,11402,485
12,3,9,1,10,101245,4966,36,4966,563
30,16,14,15,4,124452,50317,365,7012,449
13,4,9,2,19,47384,29237,26,0,545
104,6,98,1,14,65985,363,116,6955,568
17,12,5,5,6,1082367,108673,115,28600,430
40,9,31,12,14,750987,198924,406,77778,378
19,11,8,0,11,321450,0,19,1813,624
19,7,12,1,11,234328,1795,2,1795,516
20,7,13,7,9,210885,139323,135,28681,497
32,19,13,16,14,741258,285105,414,100121,439
11,5,6,1,14,324648,15714,58,4900,586
4,2,2,2,10,12210,12210,25,9056,508
3,1,2,1,10,431,329,0,0,721
14,2,12,0,7,24190,0,30,1478,545
22,10,12,8,17,81897,36859,98,9326,439
21,7,14,2,6,130405,4108,42,3505,504
15,9,6,0,14,400873,0,0,0,537
39,4,35,3,8,44390,8528,39,739,581
4,2,2,1,23,10681,501,0,0,450
5,2,3,0,3,658,0,0,0,618
26,14,12,11,7,269490,54968,235,8691,416
2,0,2,0,5,0,0,0,0,623
28,10,18,0,13,754415,0,123,716,525
9,7,2,8,8,80305,121035,97,12885,457
62,5,57,3,13,353957,5489,8,1918,478
82,13,69,5,17,221437,21444,125,8393,439
8,3,5,2,13,44954,11186,34,13359,536
19,3,16,3,18,74941,74941,12,68874,459
28,3,25,3,11,54316,27957,44,1500,624
33,17,16,4,13,1137801,357110,147,63550,437
11,5,6,1,7,192802,75,2,0,601
14,6,8,4,8,242414,229802,71,0,447
10,3,7,2,9,33006,7948,21,7297,523
51,6,45,3,7,6227,1886,98,3173,468
21,7,14,1,8,170586,7187,169,3492,557
14,8,6,5,15,84208,94941,73,33907,454
22,5,17,0,24,261035,0,31,0,651
4,2,2,3,8,916,56313,32,0,525
5,3,2,2,4,34582,16708,0,0,451
18,11,7,0,12,546326,0,32,0,544
5,3,2,2,35,20725,3915,40,0,569
10,6,4,5,15,40269,39604,76,13525,401
14,5,9,4,6,28319,14619,27,5814,453
16,2,14,2,15,23358,19959,158,22478,430
223,7,216,2,4,18341,784,24,880,560
23,14,9,0,9,3879428,0,3,0,655
15,3,12,3,12,48226,36960,11,13309,488
13,3,10,1,12,29248,4054,3,4054,389
40,11,29,1,9,372281,11000,108,555,492
21,7,14,7,11,438923,40232,103,6423,457
12,3,9,4,15,40064,40064,71,13608,506
5,2,3,0,15,391,0,0,0,658
9,4,5,3,12,230215,110441,0,0,527
12,4,8,6,10,188733,271051,89,93180,530
33,10,23,7,18,330147,49188,96,8061,464
4,1,3,1,7,290439,290439,36,290439,551
14,6,8,7,16,17438,42170,124,9447,511
20,6,14,0,23,777446,0,3,0,632
23,9,14,3,7,472429,18514,29,4849,491
22,12,10,14,15,347383,313173,312,10908,446
11,2,9,2,9,22696,22696,63,1573,597
13,9,4,1,12,88160,3882,15,0,511
7,0,7,0,14,0,0,0,0,610
54,10,44,6,19,438949,271998,101,19422,505
12,3,9,5,3,13020,43938,38,8681,473
15,2,13,1,9,11818,670,159,1727,499
18,6,12,5,17,380653,132703,57,33962,457
27,3,24,2,15,9092,7333,50,16081,469
13,5,8,5,4,9011,10540,79,1000,437
17,5,12,3,6,4782,3922,32,0,451
6,3,3,3,6,7012,12139,0,0,480
6,4,2,1,12,86976,38540,19,0,569
12,4,8,3,14,45052,47654,64,26899,512
7,5,2,4,8,29777,9882,53,989,499
21,7,14,1,10,19762,11158,11,0,635
12,7,5,3,6,38348,223,44,200,509
7,3,4,5,8,20537,44952,6,16713,447
7,5,2,4,5,13441,13440,78,5134,501
6,2,4,2,10,28537,28537,89,16582,620
6,2,4,1,14,13328,7705,17,7705,659
6,2,4,2,6,6713,6713,29,2793,460
18,8,10,0,12,252025,0,8,0,564
22,9,13,5,16,435380,92633,181,12394,507
165,18,147,4,17,76490,17570,62,5072,435
19,11,8,3,14,122969,44854,9,1080,529
36,16,20,4,13,402214,48348,104,10462,505
10,7,3,0,5,55687,0,0,0,630
3,1,2,1,6,628,3944,0,0,566
9,6,3,5,7,28914,27441,61,15160,458
36,4,32,1,8,53890,270,31,270,556
87,4,83,1,12,27626,790,10,26646,519
19,2,17,4,14,20584,22467,77,15495,515
29,6,23,0,12,39999,0,11,194,547
4,2,2,0,3,11394,0,73,1542,513
12,3,9,5,15,63864,103505,76,32641,479
5,3,2,3,11,11046,11046,43,6757,602
6,4,2,1,19,29343,8926,21,8926,568
17,6,11,4,6,23648,13915,49,5026,519
8,1,7,0,6,0,0,0,0,720
7,4,3,4,15,155159,155159,54,62386,439
26,19,7,13,20,479817,274587,139,130149,476
76,12,64,14,17,152446,125588,144,2492,482
26,5,21,1,12,649633,5235,2,5235,464
10,7,3,0,3,40449,0,2,2688,543
18,4,14,4,16,366701,16438,126,7642,548
7,5,2,3,14,182565,155659,40,3975,474
15,4,11,4,13,33547,41884,112,28290,460
13,6,7,5,7,376856,10899,47,3721,451
7,2,5,1,9,13028,13028,98,13028,620
18,10,8,0,22,782875,0,1,0,707
11,5,6,4,7,416274,8689,41,753,460
14,9,5,2,9,278839,3017,40,0,524
75,9,66,0,10,1538499,0,0,0,552
38,10,28,0,8,270274,0,6,19,569
14,8,6,1,13,684997,811,40,6000,544
14,8,6,5,9,396891,88982,148,12626,477
24,4,20,6,19,76144,58847,88,0,477
46,30,16,4,25,7157677,4769,25,2185,532
13,3,10,3,14,11196,20284,20,13455,475
19,17,2,0,17,1349017,0,2,1028,606
14,7,7,5,7,24072,27956,95,7133,430
29,17,12,13,12,97837,20210,3,17145,475
8,3,5,2,6,37224,17270,61,729,520
154,11,143,7,12,136889,45937,268,14568,489
10,6,4,3,6,18651,932,39,1250,433
12,4,8,6,7,50655,29934,91,7852,450
26,10,16,4,10,24211,14972,100,5618,419
4,2,2,1,8,508,508,8,508,551
32,8,24,0,13,456553,0,25,6021,512
4,2,2,2,8,6728,10535,13,6728,611
14,10,4,0,7,378236,0,3,0,463
23,9,14,4,10,362642,41320,0,0,482
16,7,9,8,15,56556,60652,11,7814,470
9,5,4,3,9,38281,8761,15,2892,550
5,3,2,1,12,312503,8286,24,8286,582
3,1,2,0,10,0,0,28,5020,625
30,7,23,2,14,305026,9956,49,954,494
5,2,3,2,12,20486,20486,0,0,487
33,5,28,0,6,200640,0,37,0,561
39,19,20,15,15,334434,135742,183,59857,373
7,4,3,1,6,12050,1387,16,1317,606
3,1,2,1,11,4126,688,0,0,543
10,5,5,2,7,39019,24180,70,0,518
13,6,7,2,6,163870,407,37,0,529
8,4,4,3,7,84276,76661,25,34539,441
8,3,5,1,10,282791,282791,25,199,480
45,7,38,5,10,669238,63576,53,10245,454
11,5,6,3,9,32090,9299,42,6055,444
25,14,11,8,11,86188,53721,96,23094,433
7,2,5,2,7,17044,14586,33,12826,456
12,8,4,5,16,394516,11654,106,4580,445
8,4,4,2,5,89264,14046,21,4678,493
15,4,11,2,17,418864,36478,31,1518,431
18,8,10,6,14,33624,22351,65,10196,435
6,3,3,3,11,22375,16750,24,1875,530
8,5,3,0,8,60725,0,6,0,539
11,4,7,4,12,50717,50717,27,18922,482
13,6,7,0,10,152739,0,8,0,589
11,4,7,0,6,187454,0,3,0,663
10,4,6,0,15,12381,0,78,683,488
3,1,2,0,4,7338,0,0,0,636
15,4,11,5,9,25291,25291,52,6264,503
4,2,2,3,6,60861,60861,43,506,519
17,4,13,4,15,79161,104721,92,66309,484
52,10,42,5,8,87063,18771,51,10009,431
11,4,7,3,10,33027,28798,0,0,526
14,6,8,1,16,277416,21851,7,21851,489
8,3,5,0,8,75425,0,0,0,699
10,6,4,1,5,66642,560,7,909,512
25,11,14,0,17,895489,0,10,842,650
14,5,9,2,9,35762,13909,9,13721,489
11,9,2,0,12,294180,0,6,16141,618
18,8,10,0,14,106139,0,0,2535,677
8,5,3,4,7,9762,16988,57,8240,508
12,9,3,5,13,946826,56473,28,19731,427
7,3,4,3,8,203950,35753,24,11854,484
14,9,5,0,8,391824,0,42,627,574
24,2,22,0,7,86942,0,32,7454,546
8,6,2,5,3,383214,15151,17,0,481
19,13,6,6,8,200851,28429,70,2135,494
13,6,7,0,13,1363767,0,11,7682,573
14,11,3,10,10,225978,294678,128,85900,416
7,3,4,0,13,116426,0,4,1198,557
19,10,9,10,11,236546,63690,95,7638,446
16,8,8,4,7,61735,48501,75,1007,462
9,3,6,4,13,751110,346928,57,237425,467
11,7,4,1,8,123322,3177,8,1020,469
11,2,9,2,8,2485,2485,33,2952,625
5,3,2,2,14,49575,49575,13,43265,512
12,6,6,5,17,53391,53108,110,39811,438
9,5,4,4,8,24182,24182,336,16931,553
10,6,4,7,9,21596,28955,106,8944,507
37,6,31,0,12,94057,0,28,9918,601
25,5,20,0,6,240843,0,101,2252,546
46,13,33,5,16,322233,2575,99,7124,481
7,4,3,3,20,84804,21738,24,11426,545
77,9,68,3,18,230056,21005,28,0,515
21,7,14,4,7,41883,22945,5,3468,440
13,7,6,0,16,616911,0,1,0,657
6,3,3,2,6,54780,24414,119,11704,490
7,3,4,1,12,4702,1424,20,1424,521
18,5,13,6,8,129308,39334,76,6385,463
20,6,14,3,6,79524,45692,37,4378,528
6,2,4,1,8,210859,19300,25,19300,580
15,6,9,3,5,28177,3217,117,8646,475
17,7,10,5,7,20495,7496,92,1998,493
23,11,12,3,13,441727,27798,3,1657,526
7,5,2,5,9,97358,100354,81,44110,557
9,4,5,5,8,15608,19940,292,14007,514
5,3,2,2,11,249529,11647,18,0,501
87,11,76,5,10,216463,45793,7,1214,492
7,3,4,0,7,134046,0,23,0,587
10,2,8,1,8,4639,2139,24,2139,644
47,15,32,10,9,166071,51820,349,23046,404
14,6,8,9,21,657076,225310,22,51316,477
5,3,2,1,9,248073,1557,0,0,514
21,8,13,9,26,72744,66246,67,26717,468
18,6,12,3,7,113533,14671,55,10214,420
22,3,19,2,10,206850,6514,20,877,534
9,5,4,2,12,32116,3529,19,2050,488
10,6,4,5,8,12614,6919,173,4410,496
16,9,7,3,13,286362,2197,4,258,628
15,8,7,4,8,46622,36053,75,9499,409
12,4,8,3,11,24898,28075,152,9940,438
42,18,24,5,4,352545,46678,142,9517,409
21,14,7,0,20,472402,0,43,1712,588
8,4,4,4,14,130255,142950,67,6746,529
4,2,2,1,14,601,601,4,0,564
8,6,2,5,9,255843,23079,0,0,455
5,3,2,5,4,181469,47836,55,17223,483
12,5,7,3,13,462480,410878,55,1115,477
12,8,4,6,13,50400,30624,61,10039,413
22,7,15,4,8,305586,6601,183,5456,455
4,2,2,2,18,342752,17769,119,14098,531
64,13,51,3,22,337838,1589,163,2696,458
17,10,7,0,13,1059570,0,18,69019,427
7,3,4,4,11,17838,23587,66,7916,470
12,9,3,8,8,46666,6911,79,2263,373
13,4,9,2,5,25370,7575,28,7074,426
20,16,4,8,9,341327,156613,78,44304,439
7,5,2,7,7,85999,92835,78,37277,470
11,3,8,3,15,38439,38439,77,29768,492
13,8,5,1,29,391059,34057,47,0,440
7,4,3,1,10,657931,2265,6,2265,510
12,7,5,1,19,211536,9919,0,0,486
12,6,6,3,17,469792,14355,28,1326,462
3,0,3,0,7,0,0,0,0,646
14,4,10,2,7,30829,193,26,382,641
10,5,5,4,16,215966,36293,135,12098,528
29,11,18,1,12,532350,130,103,2855,581
7,1,6,0,26,0,0,0,0,771
5,2,3,3,11,504819,172951,0,0,563
12,6,6,9,8,123925,59134,155,10975,481
15,10,5,1,9,221633,4100,11,4100,527
6,4,2,2,15,255543,36813,42,116,474
31,10,21,7,18,236423,84955,572,38072,519
9,5,4,0,1,30157,0,0,0,544
15,4,11,0,8,61287,0,0,0,652
29,10,19,5,18,457904,307667,119,2872,479
16,13,3,8,12,452465,307949,149,0,506
19,5,14,1,17,31361,8548,0,609,528
15,8,7,10,9,77284,86062,125,24270,448
4,2,2,1,9,98536,98536,25,98536,574
4,2,2,1,23,41672,41672,31,0,656
11,6,5,1,14,225890,1899,14,2292,449
25,7,18,1,16,36833,10382,38,2731,494
23,11,12,3,6,355266,58992,58,21600,488
26,12,14,10,24,743642,373424,508,139199,501
14,8,6,1,7,109022,4746,4,5662,563
20,7,13,1,9,72095,1593,24,1593,480
10,6,4,4,15,31304,137872,1,2290,520
10,5,5,2,15,318297,4007,19,2000,422
21,4,17,3,5,38874,57797,28,23847,443
13,7,6,5,14,586225,60415,11,6842,454
12,9,3,0,10,76639,0,16,0,675
64,16,48,4,11,240463,13876,8,9855,497
26,18,8,12,13,180880,221721,299,36137,469
12,7,5,4,12,325588,18792,26,9315,430
31,13,18,0,13,86357,0,14,6831,573
7,3,4,2,8,66926,66311,20,0,466
24,19,5,12,17,983027,305535,165,22127,420
15,10,5,5,8,84764,8432,29,728,537
87,10,77,3,16,126724,43927,354,21005,516
26,7,19,5,9,170956,51260,62,988,427
21,6,15,1,15,50298,5423,63,2824,527
12,5,7,1,6,9634,578,150,2001,504
20,8,12,5,17,314003,19645,35,28142,435
29,16,13,7,9,206772,44428,37,6004,466
6,3,3,0,14,520,0,0,3678,658
14,7,7,5,7,27551,26420,46,2447,420
4,2,2,0,9,0,0,35,0,661
16,12,4,6,5,74894,13637,384,6946,449
421,14,407,2,13,276924,62545,38,32555,503
22,9,13,9,10,130662,120443,357,98509,401
11,3,8,1,8,627,213,9,2861,509
15,12,3,1,6,146241,4135,8,4135,474
30,9,21,9,26,198668,114962,161,11989,425
9,5,4,0,3,45243,0,13,0,646
11,4,7,0,8,94305,0,14,693,653
13,3,10,1,12,360634,2464,7,2464,603
30,3,27,1,9,13058,12488,203,12488,634
10,4,6,4,8,11377,17268,64,596,488
14,9,5,0,18,96137,0,25,3190,535
28,9,19,2,16,484038,4973,257,2022,488
8,6,2,0,7,49121,0,0,0,509
7,5,2,2,8,89050,52746,53,31378,443
15,3,12,4,6,297234,126501,30,0,472
18,9,9,8,13,560000,130550,82,34722,409
31,5,26,3,16,32199,15549,3,6473,453
18,8,10,0,7,14076,0,34,1389,590
50,4,46,1,8,20354,2144,160,2704,541
10,8,2,7,7,7707,2277,169,1552,488
46,15,31,5,12,264532,52695,107,19208,439
7,3,4,2,15,22592,22592,8,48890,461
22,12,10,1,8,365837,198,48,404,439
12,4,8,1,22,247558,36155,12,36155,453
26,11,15,0,6,384699,0,13,834,602
32,9,23,3,11,373360,2632,32,14109,397
10,5,5,3,5,223772,100106,21,15370,493
17,3,14,0,4,46673,0,5,270,613
13,4,9,8,12,33887,50860,143,1836,603
6,4,2,4,16,688962,28331,22,340,486
11,4,7,1,26,2841,888,39,1010,462
24,7,17,1,18,64719,570,21,570,683
10,5,5,4,5,250242,43424,91,14596,444
43,6,37,3,8,236095,26348,79,0,517
9,6,3,5,7,87857,87857,6,1511,424
2,0,2,0,2,0,0,6,8393,590
6,4,2,3,11,22676,21457,30,5489,531
16,5,11,5,11,178869,56317,29,8293,454
25,12,13,13,16,113831,98621,285,10100,448
14,3,11,0,6,269319,0,35,8343,618
11,7,4,0,5,48245,0,0,0,654
23,9,14,9,16,121081,142425,65,10304,459
15,6,9,4,6,881214,58541,47,968,437
9,5,4,3,11,310700,15239,18,9049,521
16,8,8,3,19,349719,6004,29,3172,489
10,4,6,0,11,306513,0,0,0,609
10,3,7,4,6,51035,31749,5,19917,507
27,12,15,7,11,184539,32197,69,5548,404
25,14,11,9,12,1292239,2356343,132,3023,450
7,4,3,4,11,60205,67287,3,15423,491
8,6,2,5,8,112027,102869,93,63717,449
11,5,6,9,9,206960,168429,176,0,514
85,11,74,4,10,210721,34674,117,19664,481
20,7,13,2,8,39893,1587,19,922,454
8,3,5,0,23,17327,0,1,0,707
9,4,5,5,19,709882,163518,69,23436,487
9,2,7,0,10,17432,0,11,243,567
13,11,2,11,13,20802,20802,126,3168,420
22,5,17,1,10,22349,10648,17,10648,605
54,19,35,5,13,306484,104769,29,21781,505
69,12,57,9,25,635611,216756,184,18346,480
34,6,28,6,12,42342,64486,73,24532,391
9,5,4,0,3,28170,0,22,805,567
10,3,7,5,5,24451,24451,49,5612,525
13,8,5,0,7,1072366,0,2,0,551
19,7,12,7,16,408183,148185,183,0,515
20,6,14,4,10,44584,4073,79,19667,494
4,2,2,2,5,474,3768,16,0,488
18,9,9,9,32,959364,814367,156,7774,441
13,4,9,0,12,32637,0,0,0,607
19,7,12,3,12,564657,25512,71,6622,554
7,4,3,0,13,321228,0,0,0,582
13,4,9,5,12,196494,48284,38,12787,577
3,1,2,0,6,0,0,5,0,629
3,1,2,1,8,0,17681,10,17681,603
11,8,3,4,25,57704,41867,75,37630,447
5,2,3,0,7,13781,0,0,0,557
28,14,14,3,13,254043,19762,66,1368,496
19,12,7,5,6,807583,28817,30,3739,436
10,7,3,4,5,321580,4861,48,2621,476
5,3,2,2,7,31286,8684,26,6898,447
11,3,8,5,7,842534,1374853,37,428518,492
15,11,4,3,3,237691,14795,6,11400,449
3,1,2,1,8,89845,89845,30,0,485
28,6,22,7,8,34214,62178,132,7596,411
4,1,3,1,7,0,6504,14,13457,632
209,17,192,4,19,777453,194495,288,104097,466
18,7,11,5,18,76309,40534,71,7931,446
5,3,2,2,12,1540,91124,40,0,542
3,1,2,1,6,6949,6949,25,6949,583
6,1,5,2,7,535,9035,19,535,633
19,9,10,1,7,57307,118176,21,2756,495
15,11,4,3,9,212878,20147,38,10951,551
21,7,14,0,12,257063,0,0,0,631
15,5,10,3,9,18018,10221,130,7842,449
6,3,3,0,5,976536,0,1,0,557
3,1,2,1,3,2734,50,0,0,585
14,9,5,0,5,96707,0,24,248,532
18,6,12,1,8,64777,4723,25,2585,528
5,3,2,4,8,2831,17153,32,1962,505
15,6,9,0,11,245979,0,0,0,673
19,11,8,0,19,42815,0,5,739,615
18,11,7,6,8,463007,381220,86,15577,452
15,7,8,6,10,448323,77208,63,31588,456
5,1,4,0,13,0,0,0,1041,769
10,2,8,1,8,10264,1380,7,1380,461
70,19,51,0,15,442230,0,84,1893,650
13,3,10,5,12,93642,93642,36,3771,612
13,8,5,3,8,33997,2721,5,3338,475
26,6,20,0,12,398700,0,0,0,584
10,5,5,0,8,1547,0,90,0,511
7,2,5,3,15,48254,51092,52,3268,542
20,11,9,0,15,185011,0,20,488,523
35,3,32,1,8,29600,13773,179,13773,625
7,2,5,3,18,925606,606763,63,408695,555
8,5,3,5,6,31285,29711,116,3578,486
37,8,29,8,10,312856,52659,101,888,466
7,1,6,1,4,9653,9653,37,3094,449
16,6,10,7,9,39560,59980,260,7087,439
17,3,14,0,13,389971,0,26,711,639
31,13,18,1,12,182812,495,9,1936,542
42,14,28,6,15,204343,16042,66,9471,419
12,2,10,1,9,1967,1967,8,1967,395
17,7,10,4,7,43067,29136,26,124,514
20,7,13,1,10,268815,8910,101,1057,646
8,4,4,4,14,24709,24709,30,22779,581
17,8,9,0,14,187003,0,24,2422,574
12,8,4,6,12,386021,76519,106,25751,482
23,15,8,12,9,598815,36161,109,7697,375
6,3,3,2,4,12638,3898,1,669,504
6,4,2,1,11,2296,1510,4,1510,525
24,5,19,0,9,61318,0,208,7480,477
8,2,6,0,14,6687,0,31,1141,608
20,10,10,0,11,1136365,0,0,0,632
16,4,12,4,8,55654,55654,64,1928174,521
10,5,5,0,13,89510,0,4,0,617
8,5,3,4,8,245842,46470,81,6364,451
122,17,105,2,10,94720,10056,34,4601,528
9,7,2,6,41,1401691,1711673,88,648886,472
9,6,3,3,19,42031,25479,85,16086,480
10,7,3,4,8,384337,98487,64,0,517
11,8,3,11,4,76088,68789,231,13903,443
29,17,12,12,22,884611,531409,143,5181,418
10,8,2,0,13,562864,0,0,0,678
4,2,2,2,8,10470,1449,0,0,567
68,11,57,4,10,121991,47773,9,4348,538
20,6,14,1,18,393628,2861,21,4764,635
12,7,5,1,9,94936,3650,0,0,562
33,10,23,12,15,384139,170622,351,28186,407
40,29,11,30,4,48300,56464,439,8156,449
5,3,2,0,12,189449,0,0,0,703
10,1,9,0,11,0,0,18,398,626
19,11,8,0,13,743291,0,1,10412,570
7,4,3,0,13,4580,0,2,0,605
9,4,5,1,6,38213,6370,27,6370,597
3,1,2,1,14,40862,16488,12,0,482
9,5,4,1,9,132450,23228,38,4088,589
6,3,3,3,9,2844,10364,7,15886,500
9,5,4,4,7,18324,22469,103,11865,587
6,3,3,2,9,30699,30699,0,0,458
40,18,22,6,19,408663,246502,135,161291,469
101,14,87,11,8,245700,44069,303,7817,411
5,3,2,3,6,686,2754,40,602,529
15,7,8,0,20,159470,0,19,172,465
10,5,5,6,16,347916,144988,36,33300,415
9,6,3,4,11,96679,93406,70,78107,453
17,8,9,3,12,283816,1661,144,342,543
14,10,4,10,11,1063906,120593,56,12881,414
3,0,3,0,4,0,0,8,0,652
28,12,16,0,9,309635,0,335,8130,488
14,8,6,1,19,237155,135334,35,1299,456
24,12,12,8,11,152710,130077,0,1318,493
8,6,2,4,19,45944,36010,71,13795,480
18,11,7,2,12,114815,20100,77,16983,473
14,7,7,8,16,386303,258093,142,58153,546
15,9,6,8,9,93923,93923,289,29836,443
12,4,8,2,7,126632,7694,9,438,474
143,15,128,8,13,240050,25932,363,33001,406
66,9,57,5,8,86434,39109,56,19528,420
24,10,14,0,11,244232,0,1,0,579
131,12,119,7,19,171670,153586,323,620,453
27,10,17,7,15,149112,140206,61,9066,440
16,8,8,6,6,22102,12643,103,4995,446
21,6,15,4,7,27580,23082,58,4320,486
18,13,5,4,33,358801,7865,81,1068,534
16,8,8,4,11,88924,91284,16,850,528
11,7,4,0,8,359003,0,0,0,670
15,5,10,1,6,4268,1137,154,6489,481
16,8,8,1,7,409427,1700,115,6701,462
17,8,9,4,15,117456,2439,47,2192,500
13,4,9,0,18,788,0,3,267,688
4,1,3,0,7,2441,0,7,0,592
10,7,3,3,13,265347,41212,15,25840,427
13,7,6,3,26,33839,18392,50,16899,560
8,4,4,1,4,257098,22764,19,0,453
7,1,6,0,6,59326,0,0,0,653
10,6,4,2,9,159248,6026,14,0,505
9,1,8,2,9,18189,18189,58,0,532
9,5,4,4,7,196284,53051,110,28470,439
9,5,4,4,6,246222,28394,21,18105,449
7,2,5,2,16,16170,16170,37,8361,491
4,2,2,1,9,69020,20960,23,0,522
22,9,13,2,17,92611,37069,13,2372,569
15,5,10,3,12,22924,13001,55,6872,459
24,10,14,0,7,108058,0,0,0,627
14,3,11,3,15,1544568,391528,0,0,525
74,9,65,9,13,164530,181789,257,58909,496
10,2,8,2,7,7573,7573,27,6170,560
20,7,13,4,10,34464,4678,0,0,514
27,3,24,3,11,13232,13232,286,10608,494
6,4,2,5,8,24598,34019,54,12379,512
5,0,5,1,8,0,8914,0,1947,666
24,11,13,10,7,55343,60535,394,11590,423
8,3,5,4,13,95509,55457,0,0,528
3,0,3,1,7,0,3763,11,0,603
19,3,16,0,2,20835,0,0,0,609
43,11,32,5,45,95339,22004,0,0,453
11,6,5,1,14,495347,18913,49,93400,492
15,12,3,11,11,369987,278960,151,13982,447
13,2,11,3,6,13891,13891,46,4489,478
11,4,7,0,13,426212,0,20,4200,668
13,3,10,0,12,30119,0,17,0,572
14,4,10,4,19,6550,18084,76,2996,544
11,6,5,0,8,275687,0,0,0,651
25,7,18,0,19,29013,0,4,300,678
16,4,12,1,30,11455,4816,21,10295,439
14,8,6,5,10,376280,125335,74,32291,440
24,8,16,3,15,51395,6771,72,14047,462
27,12,15,5,9,220996,226401,143,83589,505
11,9,2,0,9,1334974,0,0,0,560
61,16,45,4,13,53916,38243,139,12920,510
11,9,2,6,4,76298,54392,20,18414,417
13,9,4,1,19,686894,7347,39,870,574
20,11,9,8,18,192475,111299,94,7968,359
21,9,12,0,12,190072,0,4,833,626
41,13,28,9,13,366857,71011,102,21734,459
2,0,2,0,5,0,0,3,1507,607
16,8,8,2,19,112412,71589,23,71109,466
3,1,2,1,14,49297,25030,25,0,563
5,2,3,2,4,6070,3139,15,1636,506
22,6,16,5,8,68686,32745,44,2401,452
9,7,2,3,7,43258,14816,25,0,464
21,6,15,5,11,28366,17884,112,7099,466
34,2,32,1,9,13421,13421,119,13421,458
24,14,10,2,15,2729485,1431,14,0,499
33,14,19,5,18,611738,9958,330,5494,414
13,4,9,1,9,7626,9159,0,0,628
14,5,9,0,8,119809,0,0,0,655
18,10,8,2,16,87537,4118,8,2905,489
3,0,3,0,14,0,0,0,0,548
27,15,12,8,15,394389,82851,86,25163,414
29,14,15,2,15,1131106,26352,35,0,578
19,9,10,12,24,225896,239009,230,149552,442
20,8,12,8,9,51042,29013,29,8213,450
6,2,4,1,11,1041,1041,21,1298,529
6,2,4,2,8,12243,11064,0,0,482
44,13,31,9,10,52263,44185,258,11300,412
20,8,12,4,11,36746,34397,43,24069,462
12,7,5,3,14,22338,21356,57,13579,442
21,6,15,6,5,20240,10091,14,2942,475
14,4,10,4,15,20342,31780,58,6387,578
33,8,25,3,14,192792,6543,439,4629,455
8,6,2,3,9,386938,27339,49,11721,524
7,4,3,0,6,10618,0,30,2957,563
13,8,5,5,14,350045,40661,18,1563,528
9,5,4,0,12,78089,0,16,0,539
9,6,3,4,14,226426,22413,23,8090,447
4,2,2,2,6,25796,11474,16,7150,456
7,4,3,2,10,6098,6098,49,4320,450
9,4,5,0,8,251686,0,6,0,620
18,11,7,7,9,239449,204851,145,8272,427
33,6,27,4,6,122139,8973,76,4589,408
14,3,11,0,9,270411,0,15,885,600
24,10,14,1,11,250142,4651,8,658,583
15,7,8,2,7,149016,111339,29,17200,574
19,12,7,11,13,155326,87520,109,5408,384
82,6,76,3,10,5054,7871,49,1083,432
5,0,5,0,3,0,0,7,7195,643
135,14,121,12,10,203922,34176,152,18678,411
34,7,27,3,13,976690,29005,42,0,474
14,6,8,5,9,85041,25004,70,8079,452
6,4,2,3,17,596137,245059,51,164436,556
10,5,5,5,13,171139,89965,75,5668,472
50,10,40,7,25,88007,69670,232,891,481
48,13,35,5,15,166458,16411,144,6629,463
43,4,39,2,12,17996,5854,93,5267,486
29,18,11,15,12,995138,269613,22,16349,414
23,9,14,4,10,260978,70584,20,0,439
15,5,10,0,5,27458,0,16,798,626
19,10,9,0,27,607767,0,1,0,657
8,3,5,0,4,7282,0,1,1094,512
12,8,4,10,7,346883,606565,0,2137,492
3,1,2,1,10,8775,2795,25,473,510
28,13,15,0,16,442155,0,0,198,627
20,5,15,0,13,46294,0,49,2133,544
30,14,16,0,5,418122,0,202,865,497
4,2,2,2,8,8413,22528,42,3700,536
21,6,15,4,11,381433,57655,76,0,513
12,9,3,6,16,67420,8596,12,3174,390
24,8,16,5,8,50523,16532,140,11358,451
46,14,32,9,13,55712,30172,207,585,466
22,8,14,2,11,40379,20079,114,15729,579
17,5,12,3,15,55268,46525,3,1206,494
35,3,32,1,14,122399,513,67,5791,545
30,10,20,1,12,379044,11943,19,11943,583
5,2,3,0,6,16489,0,7,419,602
7,5,2,6,9,283978,119218,9,30681,443
9,7,2,1,6,67675,1200,14,1200,550
8,1,7,2,9,8696,12585,52,8696,528
53,6,47,4,10,100125,12840,32,0,432
6,1,5,1,8,240,5324,24,0,650
25,11,14,1,11,259948,478,34,9672,482
8,3,5,4,8,43050,51145,28,15170,499
8,5,3,1,15,419109,13232,24,13232,474
20,7,13,3,15,277770,18969,116,3017,496
6,3,3,4,5,22776,29041,203,19336,443
13,9,4,6,10,838764,17031,0,0,476
8,5,3,3,10,6138,8337,0,0,560
12,5,7,2,3,41901,4550,10,3597,386
10,5,5,4,9,20130,13280,34,6883,474
18,3,15,2,17,6388,2728,82,26539,441
10,5,5,0,12,16497,0,2,0,615
22,11,11,6,12,557598,138340,0,0,519
17,7,10,0,17,228896,0,0,0,673
22,9,13,1,17,89709,149,11,2311,565
7,4,3,2,16,2923,1234836,39,899,499
54,8,46,4,17,44841,24753,133,22598,454
9,7,2,7,4,69228,67001,22,9818,449
20,6,14,2,12,180845,30579,41,26404,423
37,16,21,3,18,963612,100483,72,65956,469
39,33,6,11,6,44193,53457,81,11683,430
11,3,8,1,12,27113,2863,20,3204,432
19,9,10,10,9,113273,106145,0,0,508
14,4,10,3,10,23825,21733,17,11567,464
26,9,17,7,14,149471,33633,98,14078,424
7,2,5,4,8,49220,39791,0,0,541
10,5,5,2,7,101960,88684,39,86358,453
19,8,11,3,9,48697,2153,27,9736,426
11,6,5,2,13,267168,4067,41,1736,466
74,17,57,18,17,788365,552557,288,56668,421
9,6,3,6,9,36589,36589,313,20394,439
3,1,2,0,17,0,0,0,0,664
25,16,9,11,5,108872,80458,259,19601,431
20,13,7,6,10,34070,45972,71,4377,418
28,8,20,2,12,494642,89119,0,0,451
2,0,2,0,4,0,0,0,0,595
18,8,10,3,13,394199,19696,38,9940,420
44,9,35,8,14,298469,296274,193,103467,391
20,10,10,8,16,206520,187739,130,78952,365
20,6,14,2,13,89036,5848,108,952,444
11,1,10,0,10,837,0,1,0,695
10,4,6,2,12,37666,19186,40,12682,405
17,9,8,0,6,2852807,0,7,0,454
18,3,15,4,4,50655,36289,121,16849,452
35,13,22,10,11,449213,117120,170,10536,424
20,0,20,1,9,1590,1590,0,0,657
18,4,14,1,14,41923,30513,62,30513,477
15,4,11,1,7,12116,773,22,664,605
11,2,9,2,8,987082,44470,13,0,493
34,11,23,10,13,398775,21699,81,8745,361
5,3,2,3,10,8423,8423,27,3021,458
17,7,10,6,12,269263,42167,1,3565,459
32,13,19,1,17,3273246,34259,2,0,549
6,1,5,2,11,10484,12453,48,4170,515
8,2,6,2,11,498015,498015,38,482437,496
13,8,5,1,19,338674,7882,40,1760,489
10,3,7,2,9,128751,128751,62,6309,535
13,6,7,0,12,663520,0,41,3521,466
19,4,15,2,14,4906,4906,98,6264,458
8,5,3,3,13,449192,788850,40,429053,527
10,7,3,8,13,318145,315620,147,147706,443
10,6,4,0,14,366130,0,8,0,517
32,23,9,14,11,782106,100119,216,33762,433
5,1,4,1,8,1527,1527,27,1527,644
12,8,4,2,5,65643,656,16,709,541
33,3,30,1,9,285036,8171,25,0,608
10,8,2,2,7,519312,87385,38,60797,548
13,8,5,0,12,735716,0,18,0,548
28,11,17,8,10,67550,32615,407,18098,455
14,7,7,7,9,50374,50374,92,12556,503
19,8,11,2,29,169777,9198,39,292,527
8,3,5,3,8,29434,16523,53,0,503
11,6,5,0,12,322542,0,39,140166,511
15,9,6,11,7,93099,108039,187,25192,410
6,3,3,1,14,17986,1418,3,1355,530
15,5,10,6,7,54742,75102,132,11632,520
27,12,15,7,14,37501,30724,95,10791,407
18,8,10,2,7,248110,809,8,0,549
7,3,4,2,16,107533,28909,11,0,453
3,1,2,0,7,34126,0,2,0,572
36,18,18,9,16,695959,69817,133,6030,430
4,2,2,0,14,1,0,2,3397,612
34,16,18,14,17,45818,53104,232,12497,485
15,5,10,3,15,18724,12874,24,6340,497
9,3,6,1,16,31188,29632,66,29632,473
12,6,6,3,8,50354,42703,58,12101,482
7,4,3,0,7,22226,0,0,0,676
17,6,11,2,12,242805,12353,52,4858,514
8,4,4,3,10,227171,40611,37,33744,616
32,8,24,7,15,135455,25664,687,15506,510
26,8,18,2,25,338756,73467,35,120,589
21,6,15,4,18,71479,50694,53,12300,488
7,5,2,5,6,16353,16353,75,6582,598
26,11,15,1,8,49027,1074,0,0,470
10,5,5,1,8,15875,13504,33,436,511
5,3,2,3,3,10381,7558,36,125,486
14,10,4,0,11,286864,0,0,0,629
8,3,5,1,6,46785,7,2,900,491
5,3,2,1,19,3581,3581,30,3497,630
17,7,10,4,11,204801,8107,78,951,460
11,5,6,2,8,58692,54400,69,876,466
8,3,5,1,9,40467,1496,24,3007,480
8,6,2,5,9,54980,29138,251,13103,557
9,3,6,2,9,428910,24686,25,14124,479
27,5,22,3,21,393414,27867,32,817,488
24,9,15,3,12,325254,10929,23,6169,478
24,9,15,2,9,211592,22370,26,225,473
21,16,5,2,69,326024,38870,21,1166,512
27,11,16,2,12,166063,1800,8,1298,475
69,14,55,0,12,568454,0,6,140,668
7,3,4,2,8,16117,13331,100,11731,525
12,8,4,0,37,669875,0,0,0,712
6,2,4,2,6,818,818,40,430,603
16,6,10,0,24,19860,0,1,0,698
8,6,2,0,17,857252,0,4,7545,488
7,5,2,0,13,16193,0,0,0,643
13,4,9,0,10,65425,0,3,162,680
22,8,14,4,9,63145,39104,340,25892,442
16,13,3,6,11,214658,43272,2,5560,470
20,14,6,7,10,168329,36725,49,987,396
15,10,5,6,9,393569,43268,70,5635,451
7,1,6,1,13,11304,938,0,3112,469
23,9,14,0,6,343968,0,35,2335,566
4,2,2,3,5,22898,22898,52,910,507
30,7,23,2,18,31043,3630,123,5000,537
20,8,12,7,13,32809,33586,378,10598,452
10,3,7,3,6,28514,25902,28,23435,411
9,4,5,0,11,9969,0,1,389,710
37,5,32,6,9,16287,15703,79,4463,437
11,9,2,0,8,369428,0,1,0,594
6,3,3,1,8,14349,14028,25,91,534
20,15,5,2,11,340119,698,26,2236,609
14,11,3,1,40,79018,9685,21,9685,602
5,3,2,3,6,89175,6245,32,0,479
22,5,17,0,7,96965,0,47,2553,608
37,8,29,1,14,114594,540,14,5061,474
15,4,11,2,18,89086,80149,115,67694,472
4,2,2,3,9,13922,24990,64,0,579
15,8,7,2,16,1537215,24116,73,4146,480
26,11,15,4,8,146852,3241,24,1399,487
34,12,22,13,9,92074,85680,232,29716,417
11,5,6,1,6,11594,11594,130,11594,395
16,10,6,8,11,83525,31173,127,4947,457
18,9,9,6,7,435054,23967,60,13926,460
9,5,4,6,7,124902,154157,131,31096,447
8,4,4,5,7,1132211,138561,94,1350,477
27,8,19,1,12,145561,4753,1,1504,532
29,10,19,9,13,265808,54231,135,19481,388
6,4,2,1,7,10424,2701,28,216,677
12,7,5,5,12,466205,22525,72,1025,500
7,5,2,2,14,190917,604,6,3192,589
14,9,5,7,9,97703,80679,79,4004,442
6,4,2,2,9,838,838,11,633,504
19,8,11,4,8,22746,11222,108,9312,522
14,11,3,10,6,100793,68332,294,28390,435
8,4,4,4,10,296476,21626,51,1700,478
27,16,11,0,16,1407505,0,7,1111,546
4,2,2,1,4,3495,3070,0,0,471
12,6,6,8,17,25313,201972,134,2037,518
6,4,2,3,11,59105,23810,214,15155,514
18,5,13,2,6,250868,1594,148,1434,548
5,3,2,4,8,23392,23839,39,9792,491
16,4,12,3,14,127446,127445,119,111675,437
11,7,4,4,12,29403,25328,39,11891,412
9,5,4,3,12,254927,4055,30,4992,470
18,7,11,5,10,756420,503744,72,0,505
13,9,4,3,11,199663,89362,53,43488,455
9,5,4,7,8,279467,279467,28,114346,403
29,3,26,1,6,2129,183,7,751,583
26,7,19,9,17,319535,532690,215,2720,535
12,2,10,1,6,4888,1586,191,4459,511
23,13,10,1,33,1474601,582,23,1967,403
7,1,6,0,9,56169,0,0,0,626
7,3,4,2,10,231264,4777,18,2802,516
227,16,211,16,10,567534,279141,577,53766,407
14,7,7,4,14,91111,34760,48,6075,462
42,11,31,0,20,362202,0,36,1246,553
9,5,4,4,11,223829,36313,6,5965,433
34,16,18,1,8,82245,206,9,512,506
15,10,5,4,10,563496,75484,13,70914,469
19,8,11,1,6,94479,8273,15,8273,511
18,6,12,2,9,123424,23050,0,0,469
13,8,5,0,18,392333,0,6,2795,639
102,9,93,5,13,59779,8681,53,391,474
17,12,5,6,12,139964,71871,67,0,471
3,0,3,1,4,6825,6825,0,1800,506
18,9,9,1,9,88388,16268,34,16268,489
50,9,41,9,16,177820,177820,132,128000,435
16,9,7,5,8,81570,22894,81,6499,462
14,7,7,5,15,97778,74517,78,38866,413
11,9,2,3,14,401169,41978,39,10067,469
16,8,8,2,11,337767,12868,26,11757,488
14,2,12,0,9,1313,0,332,3885,571
12,7,5,7,12,115619,210925,157,46121,420
11,4,7,4,7,40322,40821,174,31079,493
17,9,8,6,17,641478,446998,58,227874,453
16,12,4,0,6,1588760,0,7,903,579
6,3,3,1,12,281910,9358,22,9358,575
29,5,24,0,9,148245,0,47,6815,485
12,7,5,3,12,83350,4899,22,3406,493
25,5,20,0,13,270222,0,5,15794,453
14,11,3,0,21,1569552,0,0,0,674
16,2,14,2,9,17941,294,96,1044,595
7,5,2,4,7,389122,224647,73,0,548
12,9,3,0,9,239457,0,26,597,559
20,11,9,8,17,1468127,360911,136,76108,436
6,4,2,2,7,25967,15485,190,10149,621
14,2,12,0,9,142547,0,1,0,696
24,4,20,0,11,27835,0,0,1137,628
14,5,9,4,9,34326,21429,31,2132,530
8,5,3,3,6,9813,3986,42,1666,480
15,8,7,5,15,767281,123528,156,9357,499
13,5,8,7,8,57223,63651,51,1551,514
17,3,14,3,8,4804,8906,78,4397,467
10,5,5,5,8,37476,35056,62,12332,486
23,13,10,1,17,3916118,3281586,9,1457,536
20,7,13,5,12,48430,18031,28,12957,469
20,6,14,6,10,56388,46118,88,21818,431
11,1,10,0,12,395686,0,0,0,659
14,7,7,1,24,437806,66020,19,66020,580
19,8,11,0,9,114672,0,2,0,504
6,3,3,1,26,666219,1184,1,2561,573
17,8,9,2,9,234933,12026,179,1193,425
24,15,9,0,14,2123304,0,8,965,640
20,9,11,2,14,275100,9645,199,11732,481
14,7,7,0,12,888126,0,4,0,590
9,7,2,7,8,29638,28763,215,9601,455
25,7,18,4,18,38237,37550,323,40028,479
29,4,25,2,38,82242,56742,52,2080,494
49,7,42,6,14,67292,8778,37,3018,439
19,8,11,7,14,132124,56649,96,25786,438
3,0,3,2,9,0,18959,44,0,621
21,5,16,3,9,38700,5084,254,4182,414
20,8,12,5,6,74309,26156,62,8710,417
11,7,4,1,16,175371,7333,35,0,486
28,18,10,14,10,392783,140746,214,54255,422
12,5,7,3,17,217509,38088,226,22413,562
18,15,3,12,13,646090,276730,21,34314,495
8,4,4,0,8,35458,0,0,0,629
5,2,3,0,8,130053,0,0,0,647
21,6,15,6,11,317679,65248,46,49436,457
13,6,7,7,8,107147,105952,148,17850,427
23,8,15,5,17,201881,38301,50,19106,477
24,9,15,2,11,392266,29880,13,164,441
7,3,4,4,20,39900,58493,69,24150,447
31,14,17,0,17,548218,0,0,0,683
12,5,7,2,9,418197,10427,32,10225,513
17,3,14,0,14,14467,0,0,13,703
19,7,12,3,19,71775,70805,67,0,519
12,7,5,7,15,236023,26723,82,3290,474
59,4,55,3,12,18818,17374,90,11796,452
4,2,2,0,1,5102,0,0,0,606
5,3,2,2,5,6943,217156,49,0,556
11,7,4,0,8,338896,0,27,146,404
28,14,14,7,16,312983,32539,384,11499,462
10,4,6,3,9,22828,22619,220,24339,459
3,1,2,0,13,0,0,2,918,562
12,8,4,1,11,281190,685,22,735,484
10,7,3,9,10,245192,440799,53,35984,418
5,3,2,0,8,35847,0,0,0,613
12,3,9,2,29,1492439,177080,40,0,495
10,4,6,4,21,115246,106581,7,57742,510
11,5,6,7,9,25393,43256,0,0,447
41,17,24,2,15,272099,2094,21,1047,435
13,6,7,0,8,545464,0,6,0,611
38,21,17,0,30,2658005,0,4,3864,629
14,7,7,4,12,70429,33676,78,739,502
15,5,10,5,8,20394,68339,67,4263,504
38,13,25,1,11,207650,1952,47,1033,500
2,0,2,2,7,0,6217,32,0,630
15,9,6,0,8,151557,0,0,0,634
14,7,7,3,9,133907,18264,31,10975,449
12,6,6,5,9,154567,70528,75,14640,430
9,4,5,2,21,31524,1560,14,14566,503
21,5,16,1,12,356939,60,39,2293,503
17,10,7,2,13,147330,22991,52,12477,683
5,2,3,0,6,106555,0,0,0,669
17,7,10,1,16,35870,628,2,7773,561
12,9,3,7,7,202847,13534,98,2292,466
19,9,10,1,10,351294,70,31,5468,644
13,2,11,2,6,7324,7324,0,0,456
18,9,9,0,21,225068,0,22,0,618
55,8,47,3,22,161293,130139,20,14618,472
5,3,2,3,4,28095,28095,0,0,420
20,4,16,2,6,98347,7662,9,1842,520
12,6,6,0,8,54278,0,1,0,579
6,4,2,0,11,10763,0,1,995,629
14,6,8,1,7,426911,6130,20,1113,484
7,4,3,3,12,235705,226489,51,0,514
7,3,4,0,8,25596,0,0,0,701
6,4,2,2,6,78562,24650,17,0,438
19,11,8,1,10,39993,606,46,1693,463
21,11,10,12,9,90286,91786,406,8730,372
11,3,8,1,9,268733,6171,57,1649,574
17,11,6,10,6,194640,194640,184,1384,490
24,5,19,0,10,5668,0,86,632,628
21,10,11,10,14,817942,575202,156,31210,436
11,2,9,2,8,250084,18912,26,15515,462
5,1,4,1,10,8617,8617,18,8617,679
20,10,10,0,21,688454,0,7,0,667
25,15,10,10,13,371448,32719,101,8505,390
27,12,15,2,9,142244,3543,30,1797,436
22,4,18,5,7,65049,65049,91,5848,457
15,8,7,0,9,825390,0,2,5475,659
15,8,7,7,7,160310,161675,113,47597,472
23,9,14,6,22,836082,169587,469,60591,449
5,0,5,0,5,0,0,3,0,676
33,8,25,4,22,87360,49296,58,3694,421
6,3,3,2,6,28115,21460,53,370,528
19,6,13,2,10,423189,15686,15,8305,503
81,6,75,3,5,455340,19257,47,2275,537
8,6,2,5,7,68047,63698,139,23745,567
24,13,11,10,16,310702,192656,171,96824,418
21,11,10,9,12,219155,164194,195,8081,436
12,9,3,2,18,449303,8483,29,8281,619
12,8,4,6,16,653846,122290,37,14521,453
19,2,17,1,7,52067,3593,18,0,626
12,3,9,2,18,16846,12041,43,11041,524
9,7,2,4,33,84395,21996,35,15112,481
10,5,5,4,12,13700,12839,32,2866,462
11,5,6,7,7,39641,50480,90,14381,499
5,0,5,0,4,0,0,0,0,645
114,9,105,2,3,22063,535,42,717,517
7,3,4,4,12,77367,101989,58,56213,463
5,2,3,3,8,0,277814,34,3587,457
5,2,3,1,16,10595,10595,14,10595,581
21,5,16,5,10,24216,24215,301,8259,415
4,2,2,1,3,8428,3692,8,1885,609
14,8,6,8,16,450607,130645,104,69795,414
10,3,7,2,14,31197,28102,90,15521,528
12,1,11,1,8,1744,1744,46,4009,468
4,0,4,0,3,0,0,0,0,669
28,16,12,15,12,560027,154120,231,353307,414
54,17,37,5,12,52786,28220,235,20577,455
8,3,5,4,7,9301,18940,9,3481,448
40,11,29,5,6,69123,41478,69,3173,494
13,8,5,1,12,120309,14620,45,1188,464
4,2,2,2,13,16319,13033,5,8448,529
37,22,15,1,8,329083,657,28,1392,541
10,5,5,1,7,21474,6217,88,6217,633
7,5,2,0,13,236195,0,8,0,653
3,0,3,1,8,56872,52697,21,0,605
3,0,3,0,5,0,0,9,0,617
3,1,2,1,5,31679,8362,11,3764,490
16,5,11,3,6,139596,13190,80,61602,422
5,3,2,0,6,1981,0,0,0,705
13,6,7,2,9,29346,6623,8,4653,421
4,1,3,2,7,0,70994,19,548,631
11,3,8,3,16,605843,210538,12,55956,450
26,8,18,1,16,233442,966,12,2898,466
36,21,15,0,20,6406916,0,15,147,609
8,5,3,2,7,315841,5006,34,6394,655
10,4,6,3,12,23047,18433,49,10536,534
26,5,21,0,8,43150,0,65,1000,505
5,2,3,1,8,55536,28930,29,800,628
6,4,2,2,7,6666,4807,16,611,455
68,26,42,0,17,2003408,0,4,5170,547
8,4,4,4,10,18570,35785,43,3408,600
7,1,6,4,6,56001,37850,52,0,598
12,7,5,0,17,70794,0,4,2870,658
6,3,3,3,12,17844,17844,59,13016,530
4,1,3,0,7,935,0,4,1454,580
32,8,24,3,6,112356,4923,44,0,476
10,4,6,3,12,57544,42918,63,5838,451
30,11,19,9,17,209065,160779,140,84118,425
26,5,21,2,26,251790,43671,24,0,683
15,8,7,2,9,928950,19344,49,1100,636
19,9,10,1,11,233224,50997,8,0,661
16,7,9,0,8,1210666,0,50,0,633
11,3,8,3,10,438527,209098,90,22405,599
7,3,4,1,8,83320,83320,6,83320,459
12,5,7,0,13,639329,0,1,0,720
29,7,22,4,11,45105,30369,102,1903,469
13,8,5,6,7,65621,15058,255,11568,433
7,4,3,2,9,306845,12096,26,8774,495
80,18,62,12,31,99275,48330,306,10780,420
16,8,8,5,21,474217,60760,52,1011,475
6,3,3,2,11,34664,924,33,1220,605
2,0,2,1,6,0,6910,8,0,550
10,7,3,2,6,131110,29654,50,17450,504
13,9,4,5,10,29853,10522,109,5446,481
12,6,6,4,9,23510,18633,111,3434,474
15,4,11,0,9,435819,0,0,0,658
27,4,23,0,15,185529,0,225,2170,607
7,2,5,0,7,0,0,26,1768,687
14,5,9,5,29,445230,72692,0,0,464
8,5,3,2,9,30029,17020,25,14592,679
18,9,9,1,22,349836,1483,32,1483,469
19,5,14,5,10,76874,74100,79,21601,547
56,11,45,2,41,263107,4180,13,7593,659
37,6,31,4,9,18289,7969,112,4674,454
12,6,6,7,15,43843,42367,122,8696,448
57,7,50,1,8,195117,23779,28,11501,466
5,2,3,2,8,296533,295534,23,0,580
19,2,17,1,14,371233,573,20,3060,602
11,7,4,3,7,77723,2422,0,0,574
30,19,11,10,11,154153,76643,259,12657,434
31,12,19,3,20,227932,7933,40,0,476
15,3,12,0,18,110594,0,3,1326,668
12,7,5,0,13,373720,0,0,0,644
21,8,13,7,6,22152,30736,114,752,440
6,3,3,1,4,39995,17112,18,17112,493
3,0,3,2,10,15282,15282,50,0,518
28,5,23,2,9,22493,1206,217,5013,622
27,9,18,5,24,359891,21684,107,13519,444
10,3,7,2,5,12779,12779,39,5378,528
8,2,6,2,14,8500,8219,60,1169,560
33,6,27,5,17,152828,28212,51,15939,471
24,13,11,0,21,798628,0,10,0,643
6,4,2,1,6,276806,12112,24,12112,630
23,8,15,2,16,309884,6574,91,4372,494
37,7,30,4,8,106794,21066,197,836,547
30,7,23,8,13,194558,186315,221,133396,486
29,11,18,4,14,66375,917,3,239,515
10,6,4,4,3,35051,21219,39,4979,427
11,5,6,3,6,49206,5555,80,3090,478
22,5,17,4,14,33615,24456,24,3516,514
30,6,24,2,7,599479,960,15,597,464
10,8,2,9,10,72427,73490,115,10760,429
9,2,7,2,7,5635,5635,43,1206,530
5,2,3,0,2,28595,0,10,2190,584
12,5,7,2,11,122951,11513,0,0,470
19,4,15,0,6,54700,0,4,0,673
5,3,2,2,4,32475,3537,109,1601,463
32,9,23,0,19,112017,0,36,1006,579
10,2,8,2,14,31264,31264,40,20297,473
26,12,14,7,9,22655,15749,27,4500,475
11,7,4,4,8,20995,5188,63,1743,458
12,7,5,5,6,29667,29508,81,10744,436
12,8,4,3,13,376186,30880,34,46767,513
11,8,3,6,5,278371,24030,158,9600,461
6,2,4,3,7,1003101,73401,63,0,633
8,4,4,0,11,517870,0,0,0,688
21,8,13,1,14,423378,45594,23,45594,430
7,3,4,5,12,23384,26037,177,13921,472
40,14,26,11,15,147034,114785,213,15578,432
6,4,2,0,8,177209,0,8,1745,576
17,6,11,3,9,29788,22241,212,20295,492
4,0,4,0,16,0,0,0,853,641
5,3,2,3,7,24377,24377,51,11038,431
12,7,5,7,9,175977,175977,27,75497,428
4,2,2,0,6,49977,0,2,1099,552
11,7,4,5,19,34054,42630,24,1061,528
18,6,12,0,18,584264,0,48,4522,543
5,2,3,1,5,3023,3023,0,0,568
41,2,39,1,13,12378,9894,23,9894,610
7,3,4,2,8,19814,1290,34,2437,450
23,6,17,0,14,124032,0,49,1263,657
17,9,8,0,7,405790,0,35,734,622
59,7,52,0,16,231811,0,9,265,632
12,10,2,10,9,1698236,859534,96,181612,415
47,8,39,3,13,414313,27144,6,2511,586
8,3,5,0,6,0,0,47,5491,451
31,5,26,3,19,27349,27240,21,5406,478
6,4,2,3,5,333338,4729,0,0,473
40,6,34,8,8,123206,122682,25,15222,437
22,5,17,2,14,41564,4886,13,2053,489
10,5,5,0,8,211342,0,16,0,595
15,10,5,7,7,43998,52390,135,17548,546
22,6,16,2,19,144530,23777,28,12360,405
27,7,20,6,16,84307,71866,99,11465,446
7,4,3,0,11,1310,0,8,0,626
31,17,14,5,43,259615,22875,38,9811,461
13,3,10,1,13,140603,1918,2,1918,460
7,4,3,1,9,29045,777,1,777,567
254,5,249,3,11,39644,31999,81,4500,481
4,2,2,4,5,18730,27814,33,16841,498
11,4,7,1,10,46670,14809,22,14809,547
2,0,2,0,11,0,0,0,0,619
10,4,6,4,8,563087,4264,72,637,604
9,6,3,1,13,186967,8127,4,2665,486
11,5,6,3,17,540804,825018,67,890,462
10,5,5,3,10,634161,37895,74,21632,511
10,3,7,2,8,18391,8911,52,0,534
13,8,5,0,17,189185,0,6,664,508
48,8,40,3,14,16724,2751,319,2391,506
63,6,57,2,7,26163,4312,9,3780,464
8,5,3,0,12,456502,0,0,996,664
29,14,15,17,8,371841,502387,274,177216,455
11,6,5,5,8,108462,114477,6,13233,469
5,3,2,2,10,6806,6449,45,1493,493
12,5,7,1,7,124970,7670,39,0,520
18,4,14,3,7,45452,9188,107,4832,509
19,5,14,7,8,49605,35878,171,15656,424
12,2,10,0,8,0,0,185,675,685
12,6,6,2,15,59580,14666,20,9578,683
5,2,3,0,8,58275,0,9,0,463
22,5,17,0,7,264061,0,1,0,499
40,17,23,1,11,4196240,561,12,0,506
4,1,3,0,7,2441,0,7,0,592
6,3,3,2,9,54849,29559,51,26250,455
6,3,3,3,6,13472,13472,216,6840,488
29,16,13,6,19,487654,35484,78,13272,504
35,8,27,4,18,412180,12965,259,8717,489
9,2,7,1,5,9970,7335,16,7335,445
42,16,26,5,12,39769,35047,24,6775,447
12,5,7,6,8,31062,29441,83,9237,468
9,5,4,4,12,36638,15457,0,0,546
13,5,8,4,10,72233,59874,39,29853,477
17,14,3,3,69,33198,5713,132,2790,480
4,1,3,3,6,3423,16150,35,0,636
6,3,3,1,6,62063,18460,46,1340,467
11,9,2,4,6,40796,14279,10,2387,488
16,7,9,5,69,28186,23346,268,15520,508
10,5,5,3,9,15918,23826,19,5194,586
12,8,4,0,11,387776,0,28,9080,485
10,7,3,0,9,79925,0,1,1710,632
19,11,8,10,6,171076,108493,41,20176,454
20,8,12,8,8,251692,17500,28,5795,464
13,9,4,7,13,210187,167511,145,3331,462
48,8,40,8,5,124493,116751,325,3667,482
18,3,15,1,8,131165,4838,45,4838,491
126,16,110,6,16,440770,34994,140,11583,482
10,6,4,2,9,30151,3304,12,1652,459
17,11,6,4,69,663160,90650,51,748,465
15,8,7,6,5,40325,25728,332,14627,448
25,11,14,8,10,20321,20321,118,43330,500
8,3,5,2,3,4838,3305,5,0,535
11,6,5,1,10,471642,68558,27,800,499
5,3,2,2,9,93784,11532,7,8988,561
18,6,12,6,12,125156,110617,41,27918,505
17,10,7,0,17,469106,0,32,0,601
12,5,7,1,9,94422,5183,212,1626,577
14,7,7,3,12,259117,32921,50,22230,478
66,19,47,2,17,216561,1244,66,1390,464
4,1,3,1,5,1000,33918,0,0,600
38,9,29,2,9,332596,5777,15,5003,463
12,6,6,1,8,400387,2337,6,0,435
27,14,13,1,69,153416,66,176,1181,586
17,4,13,0,16,193901,0,7,0,689
11,6,5,1,4,37689,5636,0,0,565
33,4,29,3,6,18195,11370,18,0,493
3,1,2,0,13,207526,0,1,0,595
14,5,9,0,12,218896,0,2,1251,687
7,5,2,3,12,464553,45073,129,25429,482
21,10,11,6,13,141885,39569,121,3783,466
41,13,28,3,18,608208,17695,0,0,465
12,5,7,5,18,538206,750568,132,348399,560
39,12,27,15,8,748985,1034867,289,192782,488
9,5,4,7,7,18433,28452,72,1250,468
12,6,6,6,16,36320,44582,122,13353,458
13,7,6,3,15,59180,2713,88,2114,561
5,3,2,1,13,270619,5053,0,305,526
14,6,8,0,6,77043,0,3,2004,519
35,7,28,5,11,125673,88200,160,7439,455
2,0,2,0,8,0,0,0,0,651
10,5,5,5,14,173246,173246,7,53754,501
17,5,12,3,5,60028,10981,36,7659,457
4,2,2,1,19,0,36787,32,0,687
16,9,7,2,13,81071,79700,54,0,548
3,1,2,1,9,182969,182969,7,3399,654
9,6,3,5,9,79622,72079,53,50421,470
14,4,10,4,8,2410,2781,57,0,519
12,5,7,7,8,65565,62936,358,34127,473
33,13,20,13,12,322051,345523,273,27242,414
10,4,6,2,6,68490,9244,96,5635,478
13,4,9,0,11,82607,0,65,4138,541
5,1,4,0,4,33096,0,41,2072,605
4,1,3,1,6,0,3333,24,0,636
7,3,4,2,14,279475,17607,23,9183,616
16,8,8,0,14,204603,0,15,7495,586
8,5,3,0,3,17692,0,0,0,615
17,4,13,5,7,175438,186777,101,1997,468
22,4,18,6,18,29790,35568,139,9145,452
9,6,3,3,7,35506,13156,9,850,502
13,9,4,7,12,431824,359964,30,1328,471
12,8,4,0,12,36781,0,10,310,639
3,1,2,1,12,377,171,10,6032,518
21,9,12,4,16,339015,20328,34,16396,428
16,9,7,9,20,368622,223384,98,16211,404
15,13,2,1,25,101970,702,14,1990,582
6,3,3,3,9,5792,5792,48,3246,460
12,7,5,7,11,320164,30341,50,4557,412
4,2,2,1,4,6206,6206,22,375,536
5,3,2,1,3,321549,500,7,4189,535
8,6,2,5,11,18905,18818,225,8580,443
33,13,20,11,14,196329,181429,319,10948,438
13,4,9,5,9,422117,1970028,120,95880,445
38,8,30,5,6,37338,11990,39,3677,426
7,5,2,4,13,16218,15468,35,3734,507
36,14,22,4,15,249022,19869,121,3529,447
31,6,25,1,7,205245,2705,6,0,588
19,8,11,2,18,436057,9094,0,0,583
13,5,8,3,15,55877,55877,42,42386,457
10,6,4,3,6,69192,43256,67,22758,493
35,11,24,5,7,82160,5259,17,805,464
2,0,2,0,21,0,0,0,0,732
20,14,6,11,19,988473,352108,90,10280,389
46,9,37,8,9,36222,45606,104,6866,408
39,10,29,1,8,12696,152,64,1511,527
48,6,42,6,18,84928,166598,54,12929,480
18,5,13,1,11,361338,14448,26,14448,524
38,7,31,6,13,34765,31545,64,14625,484
3,0,3,0,3,0,0,8,0,620
14,4,10,2,13,332988,19228,8,18051,508
10,6,4,0,5,370121,0,0,0,684
8,2,6,3,9,44880,34255,73,1455,508
38,12,26,6,10,153509,34879,83,11360,430
11,5,6,2,8,130076,69022,15,0,513
19,11,8,8,18,245692,97213,115,51006,469
7,4,3,0,7,64703,0,3,6491,500
9,4,5,5,17,89004,146185,52,1537,477
7,4,3,0,4,90579,0,0,0,699
12,3,9,4,6,109124,107180,25,14958,579
3,0,3,3,7,0,7793,17,0,546
4,2,2,0,6,5729,0,0,0,670
14,7,7,7,8,275084,58953,258,29071,462
29,24,5,25,19,218765,193514,586,11240,563
30,11,19,7,10,2203570,1004344,111,1905,444
5,3,2,0,16,228418,0,0,700,568
6,4,2,0,5,126214,0,2,0,695
15,8,7,9,8,67259,65908,268,29494,445
13,4,9,4,7,27491,19009,88,11553,630
67,9,58,2,10,88077,28353,44,15298,531
16,8,8,2,14,14314,19118,65,13872,472
26,12,14,2,13,936621,1600,41,3808,517
15,6,9,3,13,91825,74892,76,3576,451
7,5,2,2,10,25178,16295,19,3952,396
7,3,4,4,13,25148,25560,74,427,619
24,6,18,1,14,28258,940,28,7554,587
7,5,2,3,14,82634,51681,42,19635,434
6,4,2,0,4,84357,0,8,1998,545
14,4,10,0,12,1387882,0,35,17043,520
10,3,7,4,8,22989,30011,31,2807,451
26,5,21,2,14,47259,22482,27,11218,544
3,1,2,0,4,1610,0,5,528,654
8,2,6,0,11,160943,0,0,146,679
10,5,5,0,18,414185,0,0,0,715
31,9,22,3,8,137261,26361,34,7672,480
4,2,2,2,3,3552,6049,14,8626,489
18,6,12,9,6,41673,48214,144,12324,445
13,9,4,3,8,26143,14796,299,12857,527
28,3,25,4,14,25572,25144,158,28999,530
45,12,33,2,14,305880,4864,14,5846,416
10,2,8,4,8,35599,19397,38,6972,482
5,3,2,1,25,169676,608,1,0,725
16,10,6,2,23,1913661,286660,79,0,472
9,4,5,4,12,210472,98694,18,61973,481
15,12,3,0,5,132093,0,0,0,614
25,6,19,4,8,82686,20512,75,11501,418
18,10,8,2,13,324822,26088,38,5200,462
9,6,3,5,8,65702,55635,168,33139,451
19,6,13,7,12,32222,55424,182,8287,442
40,11,29,11,8,387120,426473,320,99162,411
6,4,2,1,12,555350,5511,25,0,637
25,4,21,4,17,15437,13329,83,4121,393
3,1,2,1,6,1478,1478,24,1478,649
10,5,5,2,13,256299,8799,28,0,515
7,4,3,0,9,120894,0,22,11787,526
7,4,3,6,5,53858,74361,79,25567,502
17,7,10,2,18,30944,4387,117,855,486
14,4,10,1,9,280656,1022,56,1022,532
8,6,2,7,6,23342,26708,204,10423,417
30,13,17,0,8,219146,0,57,0,560
39,6,33,0,10,40979,0,35,2348,605
11,8,3,3,13,62674,11792,43,7117,466
8,5,3,3,6,44007,42663,48,2667,482
4,1,3,0,9,150909,0,0,0,656
7,3,4,1,9,2056,2056,28,4692,499
7,3,4,1,9,36707,2578,23,2578,573
6,2,4,3,5,13988,13988,53,5351,546
12,5,7,2,19,192382,12101,30,6969,554
3,0,3,0,5,0,0,40,1530,558
20,10,10,7,12,111482,105712,123,60654,458
16,7,9,5,14,218431,27699,117,13163,426
60,5,55,4,11,24475,18874,57,10107,495
24,7,17,4,10,81777,75161,48,67677,483
15,11,4,9,26,1202644,897126,152,2250,503
21,11,10,2,13,593634,6256,20,2787,477
13,6,7,5,12,22273,13933,47,29277,449
16,7,9,6,19,69586,49168,60,20176,426
12,6,6,5,14,30241,27778,76,6422,478
28,4,24,1,10,6600,5400,48,6220,454
9,5,4,3,10,316561,204658,4,100439,436
7,0,7,0,4,0,0,6,1238,621
19,13,6,9,23,1019003,312926,121,64923,456
12,8,4,9,12,159144,107738,2,3384,442
62,37,25,1,16,2899419,324,13,8606,580
11,8,3,2,8,67060,1093,37,4414,439
29,9,20,0,10,569514,0,2,0,641
6,3,3,2,7,3072,3071,54,4376,550
5,3,2,3,7,6623,14123,5,3574,496
4,1,3,3,5,17662,24299,57,0,480
19,9,10,5,12,167229,43159,51,8314,446
12,8,4,2,13,77176,22122,12,11061,504
23,10,13,8,18,1374262,697418,151,2128,485
43,7,36,8,16,335934,74541,424,32485,431
11,7,4,4,11,227898,62064,66,10794,427
62,14,48,10,11,168454,46216,147,9851,449
19,15,4,8,6,315169,156899,67,95966,424
10,7,3,0,28,933150,0,2,2484,635
21,9,12,8,17,3048141,3369134,193,7645,466
10,8,2,3,22,326178,128723,11,60177,446
19,10,9,0,7,655205,0,2,3290,616
9,6,3,5,7,25016,22221,13,1280,486
6,3,3,1,8,79448,989,4,0,643
8,6,2,0,6,102611,0,0,0,670
15,4,11,3,5,50293,22997,52,21959,461
52,11,41,0,14,163858,0,20,1560,600
12,7,5,4,8,1178941,34254,22,0,466
15,7,8,0,9,33396,0,9,197,600
26,13,13,7,13,61566,30435,163,20080,460
3,1,2,0,4,3960,0,0,0,580
29,12,17,5,24,85049,22752,87,6500,436
11,7,4,0,4,131784,0,25,2120,469
4,2,2,2,7,8868,8868,0,0,551
40,22,18,13,26,3475169,757448,164,234661,475
8,4,4,1,9,44137,849,31,0,487
10,3,7,3,11,73563,40393,66,0,551
8,4,4,4,5,15009,14842,95,13508,484
4,1,3,1,4,0,20410,10,20410,600
21,4,17,4,19,19273,23367,85,14807,410
11,5,6,4,7,36428,28009,42,1280,493
2,0,2,1,4,0,25315,10,0,548
28,10,18,2,14,51940,5644,49,4622,476
21,7,14,0,8,36998,0,191,1145,630
7,5,2,0,7,31209,0,8,0,607
14,3,11,2,13,105018,100901,65,459,671
23,1,22,1,19,4813,4813,20,4813,651
119,8,111,4,14,58499,28124,75,0,533
31,11,20,6,9,50970,24546,173,6234,407
15,8,7,2,8,42114,342,7,312,611
18,11,7,1,9,175120,3864,17,0,562
15,9,6,6,10,26768,12484,71,4584,418
19,5,14,3,5,35145,2231,43,2704,472
6,3,3,2,10,9848,10172,30,9848,459
12,4,8,1,7,6921,6469,9,0,505
15,8,7,2,18,174732,9738,48,552,563
9,3,6,2,12,43557,3674,4,0,661
2,0,2,1,4,71195,71195,8,0,598
30,10,20,14,10,58044,95249,306,13711,406
11,4,7,4,7,16014,14574,67,7950,505
56,13,43,10,14,108478,16242,374,5907,570
10,7,3,4,13,26284,25243,85,21279,405
17,7,10,7,12,22988,34896,91,13302,486
7,4,3,5,9,65722,47631,48,41420,536
15,7,8,0,10,1249631,0,8,0,607
7,5,2,1,9,39311,415,27,415,548
9,7,2,7,11,300309,40020,211,14058,420
13,2,11,3,10,7469,7744,25,7139,484
5,2,3,3,11,10346,18917,74,4386,482
6,4,2,3,6,40638,40638,45,2234,504
7,4,3,0,9,4410,0,3,160,645
25,5,20,3,10,55154,30393,288,27556,507
17,4,13,3,15,20574,20574,27,13800,412
9,6,3,0,9,462930,0,0,0,653
13,5,8,4,8,12436,8115,44,2104,450
10,4,6,1,11,10809,16,13,0,684
14,6,8,2,21,786568,23464,55,0,542
16,6,10,1,12,653052,19836,13,4102,477
3,0,3,1,19,0,2000,16,2693,503
13,5,8,6,19,307398,66357,95,15855,440
15,5,10,10,11,124279,184140,160,54398,469
26,7,19,5,38,43287,37037,62,13807,399
6,1,5,1,14,20984,20984,8,20984,632
3,1,2,1,12,32644,32644,9,32644,603
5,3,2,2,10,103847,26015,15,3018,496
12,4,8,2,15,34698,34826,41,4814,481
23,9,14,0,7,240054,0,18,1392,569
6,4,2,2,6,69799,1380,11,870,468
25,15,10,4,9,961402,6850,45,5029,494
24,9,15,1,13,586934,5658,74,1748,559
13,5,8,0,5,105447,0,7,2340,614
11,8,3,4,12,223630,4512,74,11321,481
5,2,3,0,15,44301,0,1,0,664
8,6,2,2,6,538160,1901,15,1389,510
8,2,6,2,10,62147,30283,13,496,420
21,6,15,6,10,14011,9161,52,4230,435
9,7,2,0,7,299383,0,3,0,656
7,3,4,3,8,357089,109151,40,61680,405
17,8,9,0,13,32940,0,2,6725,609
38,15,23,7,9,1009820,112212,69,32316,408
27,12,15,12,11,333957,87297,190,16580,389
7,4,3,3,7,14630,14630,44,3519,438
31,4,27,1,10,12601,4198,25,4198,637
10,6,4,4,12,4534,4534,19,1650,440
9,2,7,0,12,2293,0,2,403,648
14,5,9,0,8,123334,0,0,0,662
23,12,11,19,12,199199,272029,120,19492,403
10,6,4,7,11,53692,57192,4,16990,424
15,8,7,0,21,3085949,0,1,0,671
12,7,5,2,13,335957,8258,0,0,478
30,13,17,9,25,108350,43175,391,6007,454
15,7,8,4,10,387902,94273,35,83871,414
14,11,3,6,18,459135,97896,46,1132,466
33,13,20,0,17,872714,0,134,2135,558
6,2,4,0,5,6306,0,9,0,652
8,6,2,3,23,49335,7618,48,3399,516
25,4,21,3,19,39888,39888,205,1464624,617
15,5,10,5,18,42182,20041,43,15650,395
11,3,8,2,5,18761,6887,18,6883,569
6,1,5,1,13,966,966,3,2898,545
10,4,6,2,9,278959,9880,21,9159,524
11,3,8,0,9,365909,0,19,0,708
9,5,4,4,13,14460,17089,23,7111,604
6,4,2,4,18,33600,45375,166,13004,451
8,2,6,0,9,49231,0,0,0,676
17,3,14,2,9,3984,2716,34,2461,546
9,5,4,0,10,304871,0,0,0,557
17,8,9,2,13,89061,21028,35,20367,430
22,7,15,3,9,122036,30265,33,14386,395
19,3,16,1,12,11768,3058,21,3058,493
19,5,14,4,11,24217,17455,75,1468,502
26,9,17,0,11,250030,0,22,9567,627
15,5,10,2,9,27922,26370,24,1215,672
13,6,7,0,3,57541,0,2,0,489
14,8,6,9,20,487120,96416,109,27914,394
85,7,78,3,15,569025,7440,83,940,513
18,4,14,3,13,14589,14443,55,7175,467
9,7,2,0,8,518386,0,1,267,619
7,5,2,2,6,16146,6924,27,2763,470
22,14,8,8,11,2530076,2063743,93,0,486
9,6,3,0,13,298411,0,6,0,571
9,4,5,0,7,16049,0,2,0,666
12,7,5,8,8,159109,139184,184,29684,568
11,3,8,2,13,534457,12287,39,0,589
4,2,2,1,9,2878,1608,3,1608,615
13,4,9,3,19,18932,18932,15,7551,530
17,8,9,5,4,452459,24715,39,8744,452
13,8,5,6,21,177098,49550,93,15643,479
32,11,21,0,10,385208,0,25,9042,441
10,2,8,1,18,172786,11322,14,11322,581
11,6,5,1,6,470294,5806,8,0,667
15,1,14,2,9,4321,4321,22,3618,570
7,2,5,0,13,38270,0,0,0,623
21,8,13,3,15,610746,7339,0,0,483
6,4,2,1,4,415,415,86,3931,589
18,6,12,3,12,29994,11994,0,0,518
19,6,13,0,7,35364,0,0,0,544
29,6,23,8,8,35285,41522,122,13615,455
7,5,2,0,4,296010,0,0,0,592
14,4,10,5,15,85824,82788,175,64764,484
8,6,2,1,14,18554,1065,28,0,531
4,2,2,2,6,13685,10844,40,0,457
6,1,5,2,6,17879,21473,31,10921,557
7,5,2,4,6,12058,8617,300,10484,454
14,5,9,5,12,121401,256002,117,88138,468
31,13,18,6,13,261609,6242,302,3300,506
11,5,6,3,13,20079,12937,34,11077,507
6,1,5,0,6,24583,0,5,4255,537
33,19,14,4,7,471862,55992,1,326,485
11,7,4,6,11,94643,58982,64,26509,466
15,12,3,8,14,26028,26027,117,13183,418
19,11,8,5,14,30439,2603,161,1236,528
25,2,23,3,6,34244,15078,81,7805,526
12,4,8,0,8,129870,0,22,0,663
10,6,4,1,6,97687,94270,0,0,526
14,7,7,3,7,32989,7890,15,6739,603
6,2,4,2,9,31998,31998,29,3129,597
46,16,30,15,15,442874,83201,270,9610,423
21,10,11,6,9,651520,132550,102,119464,417
13,6,7,7,9,62164,62164,91,27406,435
6,4,2,5,11,28386,11601,42,2898,463
16,9,7,6,7,926407,47922,27,75654,447
56,11,45,1,9,983896,918,71,3019,429
14,5,9,3,12,54497,6048,57,0,549
13,9,4,1,7,27974,7760,103,7760,669
41,9,32,4,16,187439,93057,65,7757,391
8,5,3,1,13,112548,3000,14,0,519
35,21,14,0,22,888513,0,1,0,664
13,7,6,1,9,327377,18655,8,0,466
6,3,3,3,13,82912,81018,0,0,482
24,11,13,9,11,435429,38679,114,8803,411
12,9,3,5,13,190599,13112,73,2965,605
16,3,13,4,5,5997,5592,162,2554,428
29,10,19,11,29,943155,293335,150,0,500
19,14,5,8,7,547693,135505,44,460,439
27,8,19,3,69,356345,39008,56,19675,449
4,2,2,2,6,159291,10816,26,0,539
100,12,88,9,13,341637,34489,42,4747,435
18,4,14,6,7,17804,27631,69,10312,424
19,11,8,0,9,471832,0,1,0,682
9,5,4,2,15,185467,82612,39,12500,568
3,1,2,2,6,3484,3041,34,1837,623
12,5,7,7,16,320346,37152,96,4332,474
5,2,3,0,5,50610,0,0,597,610
21,10,11,5,13,127254,20809,66,1891,419
22,12,10,5,15,303591,100577,58,36439,386
16,9,7,3,4,36871,2259,65,9755,479
29,17,12,0,11,1777477,0,8,1623,648
11,7,4,5,5,20453,41906,89,21753,514
70,8,62,0,9,230970,0,148,1171,603
46,6,40,1,15,279099,2219,37,11648,555
12,7,5,0,5,137129,0,1,34,548
29,7,22,5,19,188595,22438,353,15357,452
11,4,7,5,22,203059,227749,71,7551,461
19,5,14,0,9,95777,0,7,1704,705
8,6,2,0,9,353647,0,0,147,626
28,14,14,10,11,243541,161630,25,53856,442
12,9,3,1,4,55452,23817,13,245,537
19,7,12,0,17,188471,0,22,674,623
12,5,7,1,9,32367,5840,2,5840,464
9,2,7,3,9,1666,3687,47,1109,533
22,10,12,8,13,150761,90966,129,15670,440
16,5,11,0,9,42604,0,9,593,703
12,9,3,5,16,379980,75112,86,31134,375
23,9,14,0,25,46642,0,1,0,674
14,9,5,5,13,43058,36425,67,27880,475
34,3,31,3,8,136658,77869,30,56348,551
10,8,2,5,9,445078,26310,0,0,520
10,1,9,1,5,19941,19371,54,19371,608
16,7,9,9,8,359550,92353,379,8107,411
22,6,16,3,12,24987,24987,55,21150,529
22,6,16,7,7,169999,252689,134,0,470
30,8,22,6,13,279412,31662,109,11987,509
11,9,2,0,8,264476,0,1,1221,577
15,12,3,4,7,1018149,64169,92,44690,493
8,4,4,4,8,22137,22137,62,13020,600
16,10,6,0,8,45363,0,9,540,501
32,8,24,7,9,140084,53059,317,8288,448
25,4,21,1,12,646679,1676,152,19474,436
6,2,4,1,17,6074,6073,21,6073,525
21,6,15,4,12,241686,21644,305,17460,508
15,5,10,4,11,47555,46384,48,11750,495
8,1,7,1,9,4332,4332,16,4506,653
6,3,3,2,7,32473,4515,0,0,480
283,9,274,3,15,226064,21526,57,12834,523
14,3,11,1,13,18506,5598,27,0,565
20,9,11,2,13,687498,177797,46,0,545
10,3,7,0,16,1928728,0,0,0,642
46,13,33,10,25,111390,47465,70,1028,445
11,0,11,0,6,0,0,155,977,632
15,10,5,5,13,237219,10895,8,5194,470
10,3,7,2,3,18832,16170,29,11783,476
7,3,4,2,9,11659,10881,48,2098,492
10,5,5,2,14,310312,5333,27,19941,494
7,3,4,0,6,42021,0,19,0,623
11,5,6,4,9,563948,97125,78,19124,492
14,6,8,6,10,30690,26088,129,17376,456
274,4,270,0,10,15386,0,0,3956,662
36,10,26,14,9,391292,90312,369,20344,398
38,12,26,8,13,137421,56852,258,12965,371
13,8,5,10,15,63513,73444,83,22289,419
2,0,2,0,16,0,0,1,4370,650
27,7,20,1,4,23611,5570,2,5570,507
19,10,9,12,69,220443,243878,206,46708,430
55,9,46,1,14,316542,1097,5,1097,654
16,8,8,4,6,76876,51274,70,9656,521
12,5,7,0,25,221365,0,22,7713,600
9,5,4,2,15,601182,8988,18,8639,559
17,11,6,13,9,332861,116196,107,14023,424
20,4,16,5,7,17844,25976,63,10125,468
14,6,8,5,8,55603,40814,40,225,534
19,11,8,7,15,98726,31432,127,9387,432
9,2,7,0,22,0,0,10,772,667
4,2,2,0,9,70721,0,1,0,652
34,10,24,5,8,322473,59581,131,14261,420
22,7,15,1,13,32255,11473,6,11473,545
9,4,5,4,15,19816,327849,76,10222,474
27,13,14,1,15,1175879,974491,15,974491,603
37,18,19,17,19,236349,152400,456,9353,448
5,2,3,3,4,41177,41177,43,3397,452
8,6,2,3,7,312964,8442,56,2778,455
10,3,7,3,10,7770,22075,38,877,563
9,1,8,1,7,802,802,10,802,512
17,10,7,4,13,175415,82190,92,3038,492
12,6,6,0,8,16227,0,0,0,557
26,7,19,2,13,397025,15542,22,10331,618
5,3,2,2,20,288292,275399,26,274949,465
36,2,34,0,13,7541,0,0,0,679
76,12,64,12,15,262069,238183,241,52214,432
13,5,8,4,19,13114,13114,97,18600,479
25,5,20,2,37,54779,10692,2,5822,440
7,2,5,4,8,51233,51233,0,0,523
18,14,4,5,7,247776,45642,29,21989,440
14,5,9,4,14,244275,22447,1,2465,462
70,7,63,4,14,53692,47940,104,13921,447
10,8,2,7,7,24566,33644,95,11324,453
11,7,4,7,6,15638,14512,74,2930,443
21,12,9,11,12,120029,76077,270,9202,446
5,3,2,2,8,16132,16132,0,0,474
17,7,10,6,11,11230,22992,25,7670,423
21,7,14,1,13,138440,10912,19,10912,504
4,2,2,1,9,3887,1134,24,3407,587
11,0,11,0,5,0,0,0,0,595
9,4,5,0,9,91543,0,0,0,474
9,6,3,3,5,65705,39324,154,1601,509
19,11,8,5,17,1227143,1279440,124,471284,499
8,6,2,3,4,33282,9482,25,1571,536
57,8,49,5,13,271966,11579,7,2367,477
12,7,5,0,8,522904,0,4,0,468
40,18,22,16,12,133791,129552,276,85285,388
30,3,27,0,6,135723,0,23,0,614
7,3,4,2,13,40983,41136,45,1036,584
24,8,16,7,16,44827,102537,115,60232,593
11,7,4,4,12,59979,55194,22,21764,467
4,1,3,1,16,7631,7631,12,7631,515
20,8,12,0,15,397570,0,7,0,516
4,1,3,0,11,171193,0,17,0,617
6,4,2,4,7,52478,37878,82,8049,431
16,7,9,8,9,57265,50563,134,8859,434
9,4,5,2,18,14051,6467,48,8150,529
15,8,7,2,14,1001907,8249,24,10673,481
68,9,59,7,11,93014,95822,85,25528,427
9,6,3,4,5,38039,3331,19,1586,491
17,6,11,7,7,43302,52148,69,17735,451
6,4,2,2,13,5227,3377,49,94183,577
8,3,5,0,7,8117,0,0,0,555
12,10,2,3,7,133973,21131,28,10352,538
15,6,9,4,9,46976,2729,26,481,489
30,7,23,2,18,296854,5660,91,5568,476
20,12,8,15,7,93657,106682,162,15496,407
46,9,37,6,10,49926,21614,95,8356,500
7,1,6,1,9,805,805,15,12071,487
7,5,2,1,3,12819,262,20,0,458
31,14,17,5,10,237389,116875,74,9428,480
111,7,104,0,16,129819,0,5,523,683
29,3,26,0,19,2624,0,13,9527,592
4,1,3,0,3,340107,0,1,0,665
23,3,20,2,7,27514,5650,36,1164,526
7,4,3,0,4,73467,0,0,0,663
24,1,23,0,4,14765,0,1,1284,523
26,20,6,9,8,578992,74701,80,14452,426
77,11,66,7,12,489098,56651,144,19329,423
9,6,3,7,9,80051,119239,162,63917,434
17,11,6,5,8,55936,13275,32,5888,419
18,11,7,8,7,381476,195468,224,60866,439
27,10,17,4,15,39062,5368,44,3051,492
7,5,2,3,19,33794,24184,39,6808,544
27,12,15,13,16,172772,153204,372,52441,444
12,6,6,6,17,303273,97582,7,10394,502
11,6,5,6,4,15628,22216,35,2870,504
8,4,4,3,9,32771,26656,54,3577,477
8,4,4,3,8,22531,22315,124,3303,518
20,9,11,4,8,139684,64982,74,31358,474
38,19,19,9,16,499273,59188,12,15261,474
8,5,3,1,15,72626,3176,1,3176,528
21,11,10,6,12,418103,33602,51,14595,384
8,4,4,1,17,662818,13952,23,0,480
11,8,3,0,13,43448,0,21,3287,500
18,7,11,2,8,196134,12163,53,0,489
11,5,6,5,13,49145,34606,25,2760,494
4,2,2,2,4,2848,2848,4,225,433
6,3,3,0,24,569466,0,9,240,700
9,4,5,1,3,87468,1049,7,0,490
26,14,12,7,14,321514,47159,55,21152,446
3,1,2,1,1,525,225,1,225,528
17,5,12,4,13,22825,11861,209,8171,531
24,5,19,0,11,3437,0,12,247,631
7,3,4,0,6,36637,0,1,0,603
8,5,3,4,7,1065875,1062814,55,964256,370
10,3,7,3,21,1066158,1789459,26,0,444
5,0,5,0,5,0,0,4,0,605
25,12,13,0,9,349508,0,30,4192,497
15,1,14,1,7,11447,11447,0,0,546
25,11,14,2,13,214695,12975,125,6914,477
11,1,10,2,11,1113,6088,18,0,640
7,5,2,0,11,21812,0,0,0,585
38,6,32,4,18,798307,177634,87,115229,435
38,16,22,4,27,90143,58233,127,48673,507
7,5,2,5,9,71704,44443,114,31978,458
31,5,26,1,9,40122,1394,15,784,503
86,5,81,2,11,68955,29106,133,28922,464
23,10,13,8,9,369783,411582,184,83104,444
14,8,6,5,69,105396,38584,129,0,510
3,0,3,0,7,0,0,17,3351,622
7,5,2,1,11,162936,4671,3,0,505
109,16,93,16,15,744324,204246,409,14262,398
6,4,2,5,6,22909,31833,95,13261,438
11,6,5,2,7,239739,5721,28,1845,566
8,5,3,0,5,161084,0,9,0,598
34,14,20,7,18,170740,26077,145,2657,514
23,2,21,0,15,7816,0,0,4880,652
6,4,2,4,8,20673,20285,33,6591,440
19,2,17,1,10,3626,173,8,1036,587
7,4,3,2,8,19053,18289,45,17840,479
12,8,4,6,11,66064,35322,54,8858,447
13,6,7,3,13,469316,11117,24,648,453
21,11,10,3,10,473048,9850,62,3135,496
31,9,22,2,6,309593,9020,0,0,452
19,7,12,6,9,264809,47704,85,21488,440
5,2,3,1,6,25191,2765,32,0,544
22,7,15,8,8,63141,102454,107,51187,382
10,8,2,6,13,817181,199960,81,5372,459
18,8,10,4,13,1127934,437278,44,0,450
74,8,66,4,19,82940,58547,81,25148,610
21,15,6,13,9,475228,392152,10,5927,425
64,14,50,14,21,136444,122293,740,32109,455
15,6,9,3,8,271134,40120,82,11521,475
15,8,7,1,11,112986,9810,13,1436,584
19,2,17,2,8,8588,8182,20,6578,527
13,8,5,0,30,274397,0,2,5741,610
6,4,2,2,12,62881,62881,27,37163,573
9,5,4,2,8,408869,15486,39,0,456
6,4,2,1,13,73776,322,12,17484,532
15,4,11,0,28,93066,0,0,0,713
18,5,13,1,9,11881,3762,2,3762,496
22,8,14,8,18,218004,215738,76,138997,444
8,6,2,1,14,266586,6467,0,0,609
15,8,7,5,16,121585,56799,102,20562,526
18,10,8,2,13,170676,5004,89,3370,472
82,28,54,2,15,639734,4778,20,4647,497
40,8,32,5,34,2528751,251919,97,0,511
38,12,26,10,10,82305,64304,469,8688,411
8,4,4,5,7,16798,60595,0,0,468
10,3,7,2,7,14462,14462,70,5928,531
8,2,6,2,4,20568,9216,197,1692,465
64,9,55,8,13,112696,80877,144,4669,428
8,6,2,1,4,138991,3516,6,556,483
18,2,16,2,12,64894,40639,21,1638,573
18,6,12,2,15,43947,14622,36,14201,528
46,14,32,9,16,415732,139341,436,21736,422
11,5,6,0,5,47062,0,7,0,643
9,4,5,0,3,142200,0,1,2538,562
7,2,5,1,16,1204,792,9,792,545
11,8,3,0,28,187494,0,8,0,581
5,1,4,1,16,72229,65502,25,0,655
13,5,8,4,13,274935,91732,82,1354,451
34,7,27,5,13,662867,23579,34,11693,441
37,3,34,2,7,8486,5228,9,0,517
31,4,27,1,9,250511,30613,0,0,524
14,8,6,8,14,26702,37364,45,10765,469
13,5,8,4,20,102436,91651,102,59027,421
19,6,13,5,17,113128,21409,74,7051,480
30,18,12,19,9,140483,187300,295,67567,448
46,29,17,0,23,1527788,0,2,43,525
20,8,12,0,15,334518,0,2,1858,615
8,5,3,1,15,10443,294,0,149,426
22,8,14,1,15,71796,1797,71,2528,500
56,11,45,9,15,379380,126237,114,2687,525
4,2,2,1,6,7104,7104,36,0,533
25,4,21,4,11,7183,7910,127,5969,525
50,9,41,8,23,492189,371803,148,39893,431
20,5,15,2,18,143889,55002,96,6000,445
8,3,5,0,10,11452,0,4,504,608
16,9,7,1,6,258233,1450,13,1450,511
8,6,2,1,3,52980,136,12,1216,497
15,11,4,2,8,334238,7457,78,12278,478
13,4,9,4,25,22694,30415,41,16369,480
8,3,5,2,11,301541,26976,0,0,630
7,2,5,2,6,15080,8927,30,51844,494
33,14,19,11,8,2158679,153748,143,6440,453
49,15,34,6,9,171262,61680,406,18875,408
11,8,3,5,14,636173,41806,67,2570,459
71,18,53,11,9,152116,75307,113,15712,411
46,10,36,9,69,71358,71127,277,27179,438
3,1,2,3,7,59478,84502,0,0,566
4,1,3,1,11,5115,5115,10,5115,591
65,7,58,6,11,67903,16843,160,3917,537
10,7,3,5,9,117343,113875,0,0,509
9,5,4,5,11,85961,115935,145,32917,515
13,8,5,2,22,850840,850690,54,69814,468
11,9,2,0,20,100806,0,1,0,648
10,5,5,5,10,114884,114884,138,99385,449
26,2,24,1,7,130970,121480,23,0,633
25,7,18,2,14,13243,691,9,512,490
9,5,4,0,10,395702,0,20,1215,536
13,9,4,0,9,236157,0,1,0,634
8,5,3,4,9,59056,37591,0,0,453
10,3,7,3,8,9013,9013,13,4240,523
6,4,2,3,5,14687,14687,115,7154,610
13,5,8,4,8,37046,5627,80,2304,383
9,5,4,5,4,71641,88964,68,0,421
21,9,12,7,17,710426,177470,164,14659,431
24,8,16,12,8,363253,570765,137,114800,461
39,9,30,4,16,258710,44757,54,8264,524
10,7,3,3,18,328078,12683,30,6297,542
26,5,21,2,14,37671,6631,24,0,545
38,12,26,3,15,320535,20081,128,3101,440
10,2,8,4,8,11995,31266,216,19271,571
8,5,3,1,12,224899,906,27,0,528
7,5,2,5,2,44373,18408,20,3889,461
5,1,4,1,19,0,4988,18,0,654
19,10,9,4,8,36395,18647,103,15638,496
9,2,7,2,12,448818,17418,47,0,488
14,9,5,3,7,305869,115561,30,670,524
15,4,11,1,10,20073,2997,0,0,439
19,7,12,0,11,808406,0,29,12237,673
7,2,5,2,7,39316,24426,41,23997,451
3,0,3,0,7,0,0,18,0,622
10,6,4,5,10,100916,13904,17,2075,419
10,7,3,0,26,590933,0,3,0,711
17,9,8,1,9,51122,25400,44,25400,608
21,10,11,8,12,515291,69871,51,13600,469
76,9,67,0,12,52155,0,48,474,528
6,4,2,3,7,8365,8365,45,405,533
14,9,5,3,10,48813,3618,20,1833,463
4,2,2,0,8,8800,0,6,0,662
16,8,8,0,6,416329,0,3,4853,563
12,4,8,3,8,8120,4627,139,8220,515
4,2,2,3,3,12581,7976,11,6067,524
17,6,11,2,16,80947,12495,52,8356,529
34,4,30,3,12,31708,31708,53,21721,393
50,22,28,25,36,898533,665272,258,145333,433
5,3,2,2,13,534717,11069,5,3159,496
8,4,4,4,12,34932,26908,79,17163,462
14,5,9,7,8,53651,63641,114,21177,428
17,6,11,2,13,145892,8233,109,15898,488
17,8,9,8,8,49521,52498,112,5808,389
12,7,5,1,16,305832,21,1,115,513
7,5,2,5,6,20897,14521,47,7974,483
53,12,41,0,17,930423,0,32,1669,545
14,6,8,4,8,111987,68542,84,0,472
20,10,10,6,11,344769,76676,46,0,488
18,6,12,0,11,667040,0,31,17434,531
14,6,8,3,8,17787,12268,44,7447,688
7,3,4,1,21,485905,49590,18,0,648
12,9,3,8,18,48969,51690,319,18885,453
6,3,3,1,11,6032,1331,18,1331,482
11,5,6,7,8,101459,86849,364,18740,466
17,3,14,2,6,8846,5066,11,3519,571
5,3,2,3,42,312735,220895,0,0,558
10,2,8,3,13,70523,75092,77,0,542
41,8,33,7,13,128467,143682,283,76467,557
24,10,14,2,11,122718,29370,54,23102,575
11,5,6,1,13,56288,410,24,410,626
18,14,4,8,14,85379,40588,155,11009,408
10,7,3,6,12,36079,42524,76,4981,439
9,6,3,0,11,6780,0,0,0,638
14,7,7,6,15,378896,98771,66,7942,446
31,4,27,3,8,111696,25361,32,13006,578
16,5,11,2,12,448258,214297,30,0,532
8,4,4,3,13,396250,34625,61,11320,538
9,0,9,0,5,0,0,0,0,647
5,3,2,1,19,271115,1896,37,3067,625
6,3,3,2,6,7492,7492,200,4442,512
5,3,2,3,6,22912,41479,73,0,577
13,8,5,0,10,148827,0,5,592,536
6,4,2,1,12,163976,1517,22,0,664
10,2,8,1,10,11938,9788,0,0,538
37,12,25,10,69,173326,42257,397,11008,430
6,3,3,0,12,87853,0,15,0,565
17,7,10,0,5,160929,0,25,1898,521
15,6,9,0,6,339323,0,0,2082,626
10,6,4,5,3,548861,15784,19,5161,434
9,4,5,3,16,613024,102865,24,6198,424
18,3,15,1,14,227556,754,24,1412,502
32,5,27,6,69,152013,127495,121,50136,435
12,8,4,3,14,221989,20098,0,0,486
7,2,5,1,12,1176,1176,0,689,497
17,9,8,0,8,64499,0,26,66,581
6,4,2,5,4,27135,35666,27,5548,466
5,3,2,1,15,491568,14717,22,0,526
8,4,4,3,10,27948,27948,123,53502,576
21,10,11,3,9,39535,41651,46,0,437
8,2,6,1,7,662751,1296,25,0,530
7,5,2,4,13,718851,42282,49,18684,599
2,0,2,0,11,0,0,0,0,685
21,3,18,2,19,307004,9819,54,8724,644
18,8,10,0,21,454729,0,1,0,639
4,2,2,2,13,19252,19252,20,17192,492
14,5,9,6,11,40375,46931,39,3976,447
4,1,3,2,3,51206,14454,21,10254,586
37,13,24,7,11,123702,432820,163,87057,482
33,14,19,3,19,609880,37258,75,879,494
28,15,13,0,49,1042486,0,16,34361,563
32,12,20,6,12,113456,12736,69,9779,415
19,9,10,2,6,265144,9931,25,9655,464
38,3,35,2,8,268006,188335,35,194446,483
14,6,8,5,14,403756,166543,47,32025,463
6,4,2,0,9,1305,0,29,2877,450
10,3,7,2,9,11261,22243,194,21573,567
15,7,8,2,10,108953,9615,10,8801,512
12,6,6,3,9,81182,20870,18,458,459
10,6,4,5,9,59092,67150,23,27306,589
28,8,20,10,6,25914,44620,219,26607,483
11,4,7,3,14,56395,84237,0,0,560
9,6,3,0,6,2621,0,107,11664,535
10,6,4,4,8,29961,17924,11,13730,499
5,3,2,2,2,17106,228,16,215,543
22,9,13,3,17,28718,13451,40,8000,528
14,11,3,8,9,72924,35485,144,4204,437
7,3,4,2,17,9283,8897,46,1577,655
8,2,6,2,19,221418,285967,0,23433,591
6,3,3,3,13,266933,54013,13,4715,544
5,2,3,2,7,7070,14181,14,2542,492
20,11,9,1,9,98474,560,13,1734,528
6,4,2,1,14,31462,30547,24,30547,456
11,6,5,2,8,614648,2444,29,719,578
10,3,7,0,8,37048,0,0,0,705
31,6,25,5,14,47068,17954,83,7500,580
14,5,9,1,13,37548,35471,50,35471,474
16,7,9,6,21,65349,48207,51,18121,469
14,8,6,3,23,117579,115947,51,30147,519
7,3,4,1,14,5053,5053,25,7050,503
23,5,18,5,12,44869,12927,230,1680,428
10,6,4,3,17,53836,22112,64,16753,414
9,5,4,4,14,63496,60455,66,1085,523
7,4,3,4,8,29614,35717,43,10465,499
19,12,7,1,16,229282,4156,8,4436,430
8,4,4,0,9,389420,0,1,0,543
9,6,3,2,5,77441,244,29,3241,491
33,9,24,2,15,51968,15037,118,15456,422
10,6,4,3,10,170102,5484,41,0,469
16,8,8,0,6,187480,0,0,0,666
27,8,19,4,10,675466,17125,101,15188,386
19,7,12,0,14,597910,0,8,3250,558
21,3,18,2,4,144501,12937,164,20308,478
9,7,2,2,5,402370,44907,5,0,495
8,5,3,4,15,49530,49038,71,3909,451
3,1,2,1,15,5968,5968,4,0,634
4,2,2,3,3,9596,21390,33,0,479
34,11,23,7,15,601405,569811,45,208020,446
7,4,3,3,12,29063,10173,62,8643,473
26,4,22,5,13,31948,145637,64,102135,474
22,17,5,17,13,168363,154688,328,37714,481
19,8,11,6,12,43024,25679,90,15431,535
8,5,3,5,19,34824,31809,115,4075,450
21,3,18,4,11,15339,27346,43,10028,420
45,10,35,13,27,650050,555767,85,111174,433
25,6,19,3,17,109817,79629,49,2199,439
17,9,8,2,20,223028,12900,38,2870,492
24,6,18,5,14,255638,16369,60,6062,504
16,6,10,0,12,551585,0,1,0,641
40,8,32,4,12,262851,9789,304,13486,449
13,7,6,0,17,90558,0,7,0,635
22,7,15,1,12,33144,5184,2,3947,445
27,9,18,6,13,97201,56858,29,27587,459
5,2,3,2,8,11497,11497,26,5979,524
13,10,3,4,11,317445,17026,71,6463,459
5,3,2,1,22,40786,40786,2,40786,459
41,12,29,6,20,355257,24943,67,12338,417
59,25,34,1,22,1511005,20,12,2150,616
6,4,2,0,3,108633,0,10,0,573
45,10,35,0,13,19844,0,24,7900,623
11,5,6,0,5,113278,0,80,392,545
4,0,4,0,4,0,0,40,0,653
8,4,4,2,8,4970,1936,17,1574,511
20,8,12,8,15,284796,247142,142,10849,501
24,5,19,2,14,253142,63829,43,38962,535
5,1,4,0,7,12796,0,0,0,636
11,7,4,4,11,98420,51285,0,0,493
19,5,14,3,15,45370,37484,237,32403,514
10,5,5,7,9,55432,68219,84,20220,551
9,7,2,4,7,278774,8145,0,0,443
39,20,19,0,15,2135511,0,20,10065,509
24,9,15,2,11,241390,7987,25,388,476
33,5,28,2,7,52779,355,274,770,522
5,2,3,2,11,3654,3569,0,2984,505
11,5,6,4,15,351207,350207,88,164669,515
6,3,3,2,8,33022,30394,30,0,548
2,0,2,0,11,0,0,0,0,675
30,5,25,5,10,26790,28148,54,17360,423
8,4,4,1,69,342048,48,2,48,465
14,4,10,2,12,8477,8477,34,7948,487
8,6,2,3,7,200852,29182,22,0,464
35,6,29,4,16,14801,12654,76,9529,461
58,13,45,9,22,163411,110191,61,87257,468
12,5,7,0,17,217771,0,0,990,614
5,1,4,1,7,0,5393,44,0,615
40,4,36,1,15,13755,6706,0,27067,636
7,4,3,3,8,11676,11676,50,0,560
30,8,22,2,8,445925,54229,70,3500,515
6,3,3,4,2,29675,25711,16,0,450
7,2,5,1,2,11031,3370,80,3370,494
35,12,23,1,15,51867,10,9,3469,584
4,2,2,2,8,35262,24098,0,0,498
23,6,17,3,14,117754,12630,26,6270,407
6,4,2,2,8,50101,5827,53,3024,524
16,7,9,4,15,37746,30601,71,9005,484
8,4,4,1,14,23524,22702,17,22702,417
22,11,11,3,11,402697,7610,141,4948,454
16,9,7,1,14,32569,284,4,601,511
5,2,3,1,12,4214,4214,24,4214,594
8,2,6,1,7,44397,44397,24,0,546
13,10,3,10,9,72356,72356,83,9669,466
42,12,30,6,13,299808,22450,119,11491,415
16,11,5,8,8,43690,23491,136,7246,382
30,14,16,4,13,190871,12410,104,6076,447
9,3,6,3,18,44835,63993,0,0,481
6,2,4,3,9,71409,61478,0,0,573
23,18,5,14,9,418647,115613,171,20709,340
153,9,144,6,12,201126,43679,102,19713,439
22,6,16,3,7,337340,3840,55,783,481
5,3,2,4,6,9675,13641,4,7510,515
46,7,39,5,8,89341,72259,155,35924,449
4,2,2,2,6,1686,1686,9,0,480
59,16,43,5,28,901927,492903,157,4667,525
43,11,32,9,10,34371,27882,268,7663,475
12,7,5,4,8,1037643,146707,56,97083,432
10,4,6,1,12,47089,654,5,611,639
24,8,16,0,9,146953,0,0,415,675
34,14,20,9,18,525540,289235,316,75599,438
15,2,13,2,11,6609,6609,40,6106,462
13,6,7,2,13,55830,614,19,219,519
137,20,117,7,19,945797,360283,176,5315,548
11,1,10,0,8,8018,0,25,5464,646
13,5,8,6,15,24902,38647,56,4464,463
146,23,123,3,17,351241,7413,91,8785,466
3,0,3,0,12,0,0,3,632,660
27,2,25,1,7,25428,6952,29,0,531
17,6,11,0,19,34451,0,3,0,577
17,8,9,0,11,398900,0,5,0,547
12,8,4,4,12,68039,11712,29,7665,426
12,3,9,1,8,791,500,25,500,517
9,5,4,2,16,0,29519,40,3924,616
11,7,4,7,8,241806,60164,113,25348,419
30,5,25,5,13,183996,35447,69,12595,498
9,4,5,3,16,52185,1474,34,415,533
27,12,15,7,16,206118,40489,79,8748,386
10,6,4,1,15,383021,1405,11,0,454
11,3,8,1,8,103268,4455,93,9877,508
20,12,8,15,9,105759,152307,301,32032,406
27,5,22,0,8,16444,0,105,7343,601
7,5,2,2,9,108147,104040,31,92119,500
8,6,2,2,3,38716,9732,11,3016,448
35,16,19,12,7,122302,29368,403,12053,406
12,7,5,1,12,175084,4237,2,0,625
6,4,2,2,2,6137,1165,8,305,418
22,6,16,0,11,391556,0,0,1530,591
29,6,23,1,8,90093,18910,0,0,591
21,14,7,9,10,399019,109936,171,31397,411
19,2,17,2,11,3454,3548,16,2590,536
46,11,35,0,7,427090,0,22,1900,508
4,1,3,1,9,16582,16582,0,0,623
45,9,36,9,10,52049,38403,365,7879,437
2,0,2,1,7,54049,54049,25,0,597
4,2,2,1,7,13576,2482,0,0,546
13,6,7,5,14,260279,33632,55,4704,451
114,15,99,2,11,101840,8154,30,0,679
9,2,7,1,13,6418,6418,25,6418,639
12,8,4,7,9,120882,60833,94,19369,442
4,2,2,0,3,17324,0,0,0,609
17,5,12,0,14,37160,0,18,27709,605
16,6,10,0,4,47327,0,15,0,513
10,3,7,1,11,15638,2763,13,3345,429
3,1,2,0,3,7625,0,0,0,686
6,3,3,1,14,64725,5011,0,0,502
12,4,8,2,14,183287,182037,127,305,462
18,11,7,4,22,299724,35370,76,6770,501
8,1,7,1,15,0,10789,0,0,481
7,2,5,2,6,129625,127885,27,818,490
10,2,8,0,15,1000,0,0,972,682
24,6,18,2,7,206791,13792,185,1939,454
24,8,16,3,15,134738,116166,244,33259,514
7,5,2,4,14,59935,50434,64,2293,544
64,13,51,6,11,99728,50229,187,5051,516
9,6,3,3,5,23442,16381,1,3334,429
20,5,15,2,8,158695,12572,35,8146,488
25,13,12,0,10,785458,0,14,1070,488
10,3,7,4,9,7480,7480,52,7336,499
15,10,5,3,14,625199,18659,26,12487,417
15,4,11,2,12,29074,29074,37,15017,575
107,5,102,3,18,71727,68530,81,32115,496
19,15,4,11,9,202828,193777,202,7479,440
20,10,10,3,18,5119,12676,66,7823,393
61,28,33,0,15,6928856,0,22,0,602
13,7,6,7,13,53161,64490,115,9961,498
25,12,13,8,14,231179,79365,295,51171,382
3,1,2,0,10,235512,0,0,0,565
15,11,4,0,14,131139,0,5,309,605
11,4,7,1,10,13780,238,58,4060,504
13,3,10,3,28,26860,21323,43,15350,462
15,13,2,10,5,299868,63342,228,5967,429
10,8,2,8,8,133002,139766,297,62552,424
13,9,4,0,17,979317,0,30,0,529
23,6,17,4,69,58342,31398,69,11773,466
6,4,2,2,11,479448,29785,28,0,603
13,4,9,4,13,25745,25745,36,1350,448
5,2,3,0,5,1910,0,3,0,507
20,10,10,9,10,368571,91914,155,13654,403
11,6,5,3,7,33239,25932,0,0,489
15,4,11,2,10,29555,22897,95,11900,615
5,2,3,2,7,11647,11647,0,0,487
7,3,4,2,9,6942,757,36,541,519
15,5,10,4,11,333809,41744,54,0,454
9,4,5,3,9,1401,1401,240,9454,512
4,2,2,2,3,34268,5345,23,4335,480
10,5,5,3,12,584969,38929,0,0,495
8,5,3,0,9,6482,0,1,0,611
20,4,16,3,18,36366,28572,63,22734,556
23,11,12,9,10,343868,553689,112,14523,453
27,5,22,5,11,31840,31840,288,13817,465
17,8,9,3,16,40066,37394,55,0,507
6,4,2,5,15,17820,22002,55,10934,449
36,17,19,1,20,3612917,256,26,929,517
8,3,5,6,8,67671,67671,31,0,517
18,14,4,8,9,60321,20497,45,6106,419
6,2,4,3,6,12964,4695,20,1056,457
10,7,3,2,9,221389,7726,26,3258,604
29,9,20,7,5,73103,29620,207,15551,395
59,10,49,2,12,584125,29389,0,0,490
41,7,34,4,11,498272,19676,328,12930,427
9,3,6,1,9,170127,1043,0,0,525
27,15,12,3,14,611596,24262,136,7030,444
14,4,10,4,9,38266,57373,49,11902,450
16,11,5,4,22,219582,128823,117,4280,427
20,5,15,4,18,97161,74307,54,13473,480
6,4,2,0,5,20235,0,19,0,520
13,2,11,2,8,6477,6477,37,4090,533
19,5,14,5,4,38449,23423,98,14249,477
44,15,29,9,19,51382,28802,35,11629,453
5,3,2,3,4,346240,214450,34,0,543
12,10,2,3,22,204899,13963,0,0,459
20,5,15,3,8,11646,4958,77,2125,545
17,13,4,4,12,115159,7570,189,7414,383
6,3,3,1,16,329215,4358,3,20,548
5,3,2,1,19,0,1794,6,0,723
7,5,2,3,5,12770,12770,91,8964,422
11,3,8,0,17,271526,0,31,4672,587
9,6,3,0,17,63253,0,0,0,497
9,4,5,1,8,773286,102089,16,0,490
9,6,3,3,16,410221,30806,42,6906,540
3,1,2,0,9,0,0,20,0,660
4,2,2,2,9,20513,16740,0,429,470
41,18,23,14,15,141395,87433,204,24342,415
19,8,11,4,19,725824,335412,74,15323,444
8,6,2,4,12,43031,15224,28,6738,462
13,7,6,1,13,249120,4718,35,4718,427
11,6,5,4,11,534751,138678,54,123006,451
17,3,14,3,12,13374,13374,46,10306,581
12,10,2,6,7,86251,77836,131,41689,476
17,12,5,9,12,202633,51039,21,7172,409
15,10,5,6,26,385238,412730,132,53917,514
42,8,34,6,13,114629,46751,16,6352,443
8,5,3,2,13,42290,6818,17,6003,481
9,3,6,3,7,19721,12809,39,5512,457
34,7,27,2,14,23730,200510,191,1266,549
10,6,4,1,8,451014,10093,5,0,469
19,7,12,0,10,52289,0,0,0,705
17,7,10,2,7,157749,2910,4,2810,438
10,5,5,3,12,203962,12061,68,608,491
13,10,3,8,9,308561,100447,93,20648,418
10,2,8,0,5,10240,0,2,0,625
16,7,9,6,19,123108,63819,55,1132,477
18,9,9,4,10,92384,13736,81,5494,438
7,5,2,4,7,30016,15029,0,0,453
17,7,10,7,6,74035,84706,143,5902178,450
26,10,16,0,11,83419,0,20,149,551
13,6,7,1,12,125900,29199,52,1367,581
22,5,17,3,8,141017,14161,221,12241,512
18,8,10,3,13,476995,27653,83,23819,463
7,5,2,5,17,353477,148064,56,35143,577
33,6,27,3,8,43394,29479,13,11568,402
13,8,5,2,11,458266,50581,19,0,464
7,3,4,2,9,10325,20650,41,1744,530
28,7,21,2,18,42783,6233,29,5711,427
21,10,11,8,14,92498,54738,160,19247,488
3,1,2,1,4,36792,2084,0,0,481
31,12,19,9,16,668034,46954,165,3560,414
18,9,9,2,14,985362,30571,15,0,506
7,1,6,1,7,771,771,14,771,535
45,5,40,3,8,26439,24135,58,2226,493
4,2,2,2,13,323178,21766,29,7678,468
10,3,7,1,12,23501,14085,24,14085,612
30,11,19,0,11,1585639,0,1,0,612
6,4,2,3,20,16892,16662,123,12811,484
39,17,22,2,36,734150,117009,19,0,564
11,3,8,3,13,50778,53733,57,45569,494
15,7,8,1,6,21086,5005,3,5005,504
22,8,14,8,4,27550,29002,145,8895,504
20,11,9,14,7,55077,67539,215,10497,419
36,7,29,1,16,493978,1627,25,3870,573
17,6,11,2,10,30930,1711,29,0,517
33,6,27,5,15,324912,54398,104,39635,489
19,12,7,10,24,29797,20750,132,9750,510
31,15,16,10,14,643497,127694,30,5276,477
12,7,5,3,12,309649,29221,15,14363,466
12,5,7,7,16,237478,63435,79,698477,523
12,4,8,0,7,52926,0,13,0,599
32,11,21,2,14,1153781,17323,21,12724,525
14,11,3,7,6,444936,284617,191,45508,457
14,5,9,1,13,207545,28049,25,28049,603
4,1,3,0,10,0,0,0,4341,672
18,5,13,7,9,27791,31594,121,13063,457
10,4,6,4,27,83191,53527,69,28701,476
31,11,20,4,9,314353,77451,190,181983,510
13,5,8,4,8,19080,19080,138,8059,487
19,7,12,2,14,27946,1247,27,14365,500
48,4,44,2,15,399946,5355,30,0,533
4,2,2,3,9,16128,16128,38,7094,600
29,5,24,3,13,123222,123222,13,11823,474
17,7,10,8,7,366695,33211,293,9775,427
12,10,2,6,38,284618,50079,96,7200,497
52,5,47,4,14,325926,141513,229,67444,498
36,7,29,3,9,24405,4115,63,3529,486
20,13,7,2,7,401337,9637,46,8876,442
30,4,26,4,13,19832,17573,332,8155,587
11,5,6,3,9,25023,21925,26,21184,501
14,7,7,5,17,60031,59361,54,3198,404
13,5,8,4,7,80120,20527,38,5742,489
14,3,11,2,7,26450,176,3,150,587
14,7,7,0,10,519087,0,0,0,557
15,5,10,0,12,13753,0,11,0,670
13,4,9,8,7,10407,40857,198,16017,460
14,5,9,4,14,52206,71867,58,1256,547
11,5,6,5,14,111798,114498,0,0,471
13,6,7,0,40,188510,0,0,0,623
18,8,10,2,7,326228,1805,7,1028,440
14,6,8,1,19,33703,1479,290,16127,389
15,6,9,5,13,51180,34288,53,6257,482
13,3,10,2,9,47580,15002,18,7434,640
7,4,3,2,7,28277,13068,81,0,484
53,11,42,10,11,125150,112133,253,28808,517
10,2,8,3,8,17155,10560,140,2028,540
14,5,9,4,14,99792,71098,61,15427,479
8,5,3,2,34,63021,4192,26,1721,559
10,8,2,4,14,16270,13763,147,7023,430
18,12,6,3,13,1385520,121840,64,0,481
15,5,10,2,9,11222,5042,46,0,527
4,2,2,0,3,15543,0,0,0,694
15,9,6,0,6,67846,0,35,4060,510
7,3,4,2,10,32999,8837,27,5801,427
13,5,8,1,7,60629,12454,29,2676,472
20,13,7,6,15,774523,51165,61,21484,450
14,7,7,3,26,28560,60430,60,20709,608
17,9,8,3,9,29788,7417,70,3500,466
3,1,2,0,25,0,0,1,0,718
17,11,6,7,13,332473,28163,27,14682,405
19,12,7,10,22,397459,402975,148,6991,464
31,4,27,0,6,155237,0,1,0,609
36,14,22,7,19,534091,58579,152,9565,461
15,6,9,4,9,30210,27723,67,17954,466
62,14,48,8,26,178306,149714,200,87711,454
5,1,4,1,10,2771,2771,7,2771,530
19,12,7,4,9,168410,15532,16,7854,453
12,5,7,1,14,17996,6315,40,2320,545
3,1,2,0,7,224494,0,0,0,677
26,9,17,0,13,824809,0,22,6808,648
75,4,71,4,7,29569,26961,23,7429,601
18,10,8,8,16,401552,254941,168,15430,492
8,3,5,1,14,88455,4463,19,4592,614
9,3,6,0,3,8766,0,3,7347,538
30,5,25,0,11,649556,0,8,10,589
15,4,11,0,15,584004,0,28,1268,537
39,11,28,6,21,216307,49021,317,23835,507
10,8,2,8,13,55022,59641,124,14797,472
12,3,9,2,10,22050,8162,31,7245,640
11,6,5,4,14,637211,108176,55,21902,474
24,5,19,2,7,78363,19003,59,4333,508
11,5,6,6,10,155308,165226,0,2324,469
11,6,5,6,31,224216,54112,36,11063,481
7,3,4,0,16,63969,0,10,6162,554
10,6,4,4,8,28727,24819,180,18044,463
4,1,3,0,23,379106,0,13,1262,649
13,6,7,4,8,147225,28855,50,4369,478
13,3,10,2,16,225677,17191,29,15911,589
14,4,10,2,15,455931,15188,26,10363,421
11,7,4,4,9,69506,38190,78,10381,454
18,13,5,7,18,409718,42593,61,20511,453
8,5,3,4,11,654982,193165,14,741,454
4,2,2,2,6,10668,10668,54,4203,618
9,2,7,0,6,17624,0,0,0,599
10,4,6,4,20,73600,73600,146,39175,449
8,5,3,2,11,743189,1686,23,1490,488
10,2,8,0,5,23079,0,3,286,601
9,5,4,1,6,12376,798,168,1406,498
37,7,30,4,14,36664,12782,95,3975,471
10,5,5,0,10,182986,0,4,219,650
6,4,2,3,4,98219,35034,23,0,508
10,8,2,5,16,624150,37063,62,29828,477
39,7,32,2,18,114595,656,90,12214,469
38,27,11,3,13,1228802,8850,36,1038,487
22,8,14,1,16,91645,4111,10,3997,522
24,2,22,1,8,3848,3848,123,3848,516
21,4,17,3,11,15009,3777,90,8120,466
4,1,3,0,7,0,0,4,743,640
24,6,18,2,8,14196,5162,54,7444,633
13,11,2,1,4,21143,119,10,0,531
12,5,7,5,12,261012,260662,108,0,459
6,2,4,0,11,27367,0,0,0,625
13,10,3,10,13,208577,50713,74,8721,517
40,9,31,7,18,103689,76817,96,34959,425
22,16,6,1,22,998510,9232,27,2662,517
12,6,6,2,13,280631,31243,47,30255,579
8,6,2,0,2,13469,0,1,145,577
10,7,3,6,5,92971,75881,143,10372,384
13,9,4,11,6,40324,57702,196,7185,600
6,2,4,2,5,4552,4552,0,0,471
8,5,3,7,9,75438,110280,0,0,497
20,7,13,7,8,15231,56182,132,5829,470
28,6,22,0,11,25292,0,67,3439,549
7,4,3,0,7,24489,0,0,0,685
13,9,4,3,17,362031,10133,45,4760,417
3,1,2,1,13,332218,15515,10,15515,575
17,11,6,5,19,1264738,229685,108,30037,537
10,3,7,2,8,72286,13670,20,11955,466
19,10,9,5,9,462701,6730,58,2892,535
7,5,2,4,9,13119,9935,81,7287,489
3,1,2,1,1,2944,2944,1,2944,545
23,7,16,0,7,58582,0,43,2262,633
6,4,2,4,13,34683,37160,0,0,530
10,4,6,1,9,31124,2891,0,0,478
10,4,6,7,10,289505,486138,133,255,487
6,2,4,0,2,1919,0,0,1269,580
11,4,7,0,19,150740,0,2,0,607
2,0,2,0,3,0,0,4,139,652
8,5,3,0,9,93185,0,0,0,684
24,14,10,1,9,593146,43041,50,2947,469
8,5,3,3,8,20038,20038,86,18999,425
10,4,6,0,2,58888,0,0,0,652
12,3,9,4,4,26784,45718,28,900,476
5,3,2,0,11,67007,0,0,0,479
87,6,81,4,11,44104,38083,88,22559,435
13,8,5,8,9,41179,43888,342,11592,437
8,4,4,3,7,9792,13992,52,7530,635
19,6,13,8,31,291814,523836,244,275029,492
32,9,23,1,11,258346,10060,13,10060,549
27,7,20,2,25,576552,2526,129,2474,503
15,6,9,0,11,458519,0,3,1961,675
5,2,3,1,4,24779,15271,8,15271,607
9,7,2,0,3,39716,0,0,0,551
17,6,11,1,12,304502,1333,22,0,482
9,7,2,4,14,18856,14775,14,8826,535
26,8,18,2,14,140753,14003,51,12546,446
11,4,7,4,8,498469,348903,37,34633,443
7,3,4,3,9,37777,37777,34,23748,410
15,7,8,7,5,214515,59659,74,11100,394
10,3,7,4,7,34309,32711,44,10876,464
8,5,3,4,19,298182,87446,60,35349,471
8,1,7,0,15,0,0,0,4845,709
24,7,17,0,15,23668,0,1,4375,677
8,3,5,2,9,3908,3908,26,3276,482
16,9,7,2,7,566839,11726,0,0,462
17,8,9,7,7,107863,78139,167,29796,423
62,8,54,4,9,538104,39907,119,17311,498
6,3,3,5,10,91003,69708,0,0,494
13,3,10,0,2,79722,0,0,0,612
6,2,4,0,6,0,0,2,1627,657
40,17,23,16,10,74719,77891,425,14331,404
4,2,2,3,4,3910,4170,30,2650,533
52,5,47,2,9,93409,5702,25,0,539
22,8,14,6,18,83266,82110,63,15676,443
9,6,3,0,7,50903,0,3,769,594
24,5,19,5,13,659535,131767,89,1105,457
17,8,9,3,16,41447,13736,65,12694,525
8,4,4,3,14,442492,121962,69,96351,567
11,8,3,8,11,1074998,114112,140,13965,430
17,10,7,3,19,177388,62301,154,2458,492
15,1,14,0,13,8142,0,0,0,656
5,3,2,2,4,15190,6535,79,568,485
69,16,53,14,12,279636,303804,255,66336,440
10,7,3,0,13,101234,0,0,0,622
8,5,3,3,8,35096,42249,43,17860,451
16,6,10,4,19,94657,48248,30,65033,480
31,7,24,3,8,44344,136369,103,732,537
17,6,11,7,69,3448,329858,52,529,489
10,4,6,2,8,24329,17736,90,38398,431
13,5,8,1,6,80923,944,8,0,560
15,11,4,9,14,19658,24294,87,12789,514
38,3,35,0,9,16887,0,27,1011,503
15,6,9,5,8,13202,15120,342,4557,525
31,6,25,4,6,40999,35048,81,1425,488
12,7,5,4,15,10370,9233,56,0,474
17,7,10,2,9,438824,13217,50,0,551
10,5,5,7,20,195819,107260,146,0,547
155,11,144,6,12,225783,113493,103,83382,439
9,3,6,0,22,296560,0,1,0,682
33,18,15,14,11,451297,185618,292,62276,415
29,5,24,3,12,35484,12183,22,8014,531
5,2,3,1,14,63709,63709,28,1368,557
6,3,3,1,12,49237,7932,2,7932,485
16,9,7,3,31,92114,19639,41,3322,510
26,20,6,0,13,904006,0,2,0,624
9,5,4,3,7,9011,6082,82,5734,539
81,12,69,13,13,720097,354918,638,25933,447
9,7,2,7,10,139464,156898,88,42409,451
17,2,15,2,15,78473,78473,36,2497,537
12,7,5,6,8,53056,52090,102,15794,503
22,10,12,2,16,459203,197746,95,188782,426
11,2,9,0,8,23886,0,0,0,616
7,4,3,2,17,29048,4270,40,2740,421
9,4,5,1,12,298043,5836,12,5836,416
3,0,3,1,5,0,1590,12,0,592
14,5,9,1,21,572107,2678,16,2021,566
4,1,3,1,15,8372,8372,19,810,575
9,7,2,6,4,45923,33455,40,1800,450
5,1,4,0,7,0,0,4,4081,536
24,11,13,0,14,607322,0,17,96,491
5,2,3,3,17,2895,4602,108,5050,511
28,9,19,8,9,260660,261045,91,98965,410
16,6,10,3,5,298488,40030,160,8366,429
23,7,16,1,12,120290,2609,89,3900,488
7,4,3,0,6,485442,0,0,0,445
5,2,3,2,10,10759,10759,116,5147,516
26,3,23,1,7,534951,2141,33,0,497
32,3,29,3,11,11182,21540,206,7536,517
7,5,2,4,17,33713,34652,60,22724,535
16,2,14,1,11,5854,5854,43,1634,529
7,4,3,5,7,42080,31185,0,0,468
8,5,3,0,8,688365,0,0,0,593
32,9,23,0,17,388807,0,7,7829,480
11,6,5,2,19,87909,14192,16,1330,465
5,2,3,2,3,6018,2660,10,900,479
12,8,4,0,6,566644,0,40,0,536
25,11,14,0,8,419037,0,4,0,615
36,3,33,0,18,28226,0,15,5886,640
11,4,7,1,19,32653,9122,29,0,632
9,7,2,4,14,22644,23524,117,12855,549
37,7,30,7,5,66329,12626,124,4133,378
15,13,2,2,12,893012,261,10,251,651
17,6,11,2,13,1541,198346,76,0,516
5,3,2,2,11,198716,12072,193,7854,503
20,9,11,5,15,384837,24640,105,512,463
25,7,18,1,12,708975,18927,2,487,639
15,5,10,2,8,538690,153933,53,0,492
20,5,15,9,33,140910,300306,103,0,481
32,22,10,1,14,3584043,47537,19,13553,523
13,3,10,3,12,7799,7799,299,4276,469
4,2,2,0,4,34537,0,1,0,603
21,10,11,1,7,145714,2250,5,538,546
8,1,7,1,9,754,754,0,0,486
41,10,31,1,24,84750,7425,0,0,500
22,6,16,1,17,633064,13211,37,13211,409
21,14,7,1,10,444386,4100,0,0,565
11,2,9,1,14,306169,9173,0,1726,530
16,11,5,2,28,278419,10039,65,0,578
21,13,8,0,10,538628,0,11,10758,528
10,5,5,2,16,9199,1551,17,1353,523
10,4,6,0,12,521443,0,1,1197,669
4,2,2,3,6,7701,13963,31,977,558
36,5,31,2,16,24102,17060,27,16360,488
41,11,30,7,11,62700,22689,446,8583,415
8,5,3,1,8,39868,1918,23,0,486
103,12,91,7,17,157785,74643,252,9998,485
14,3,11,5,11,45998,52819,83,50976,458
6,4,2,1,13,335470,3635,26,5682,469
15,6,9,3,6,17082,8150,390,5560,476
12,6,6,7,11,47422,74506,0,8642,454
30,10,20,3,12,689873,30037,17,0,461
8,5,3,4,8,14921,26486,36,12786,431
19,6,13,5,9,42213,23386,237,6460,423
19,4,15,0,8,6657,0,29,3058,581
9,5,4,1,11,134627,31283,6,0,443
17,11,6,13,10,459244,649074,236,186298,434
10,7,3,0,29,65795,0,7,394,673
7,1,6,0,12,34,0,6,19207,637
10,7,3,6,9,22458,22458,63,9702,436
9,5,4,6,5,14347,17024,62,4504,437
4,2,2,2,7,9268,9268,69,7781,602
9,3,6,2,4,13472,12427,104,8704,452
29,7,22,3,10,19133,5836,63,2080,460
28,7,21,6,19,12244,29646,173,9711,465
69,14,55,9,9,110720,43178,127,14462,387
16,9,7,1,23,1873616,1164,16,0,523
21,7,14,9,9,57296,54725,92,57036,378
11,2,9,2,13,10509,10509,19,8869,488
44,11,33,4,11,541723,4730,109,8562,452
10,8,2,5,14,90602,42361,10,6575,389
38,17,21,15,21,636881,613732,274,0,446
17,12,5,7,19,52031,40874,94,18970,457
7,2,5,3,14,6009,9609,49,3856,511
21,17,4,16,7,73063,76167,153,23485,407
6,2,4,1,9,57669,7831,21,19046,486
21,10,11,4,9,277585,88544,57,0,481
79,21,58,14,6,202402,90295,173,5590,453
10,5,5,1,6,381312,1091,3,5,469
17,6,11,2,3,50438,8569,5,4649,496
10,8,2,8,6,31767,21656,224,6648,462
9,5,4,0,9,65218,0,30,0,480
24,9,15,6,8,44541,20696,178,3326,436
94,3,91,0,11,10615,0,0,4860,681
61,15,46,10,9,150862,55683,248,9065,427
14,7,7,10,7,37766,44524,107,11885,463
8,3,5,0,10,31537,0,6,638,675
31,5,26,1,6,111941,3052,9,3052,487
5,3,2,3,8,36647,30302,0,0,452
10,5,5,0,8,26799,0,34,209,606
25,8,17,1,8,392387,902,24,2050,580
16,6,10,6,7,113673,80346,219,30364,452
22,5,17,0,16,35138,0,8,1215,630
2,0,2,0,14,0,0,1,1250,635
11,3,8,3,8,29301,29301,181,15223,496
51,2,49,0,15,253154,0,14,641,579
9,4,5,2,12,288962,47943,16,0,489
36,13,23,6,17,142132,33462,354,21568,419
20,8,12,2,14,26350,8884,43,16385,483
20,11,9,11,14,160160,152148,384,64144,516
16,3,13,3,6,47700,30577,45,16063,445
14,7,7,2,8,55784,16605,101,1092,445
21,10,11,5,12,34825,20896,88,800,459
11,6,5,0,19,1154598,0,24,0,627
30,14,16,5,14,239876,27453,52,11472,423
13,6,7,1,9,113363,9519,19,9519,491
4,1,3,2,9,0,9932,54,5264,639
10,6,4,9,9,416722,173403,130,55174,422
23,12,11,0,10,605624,0,31,1,548
13,6,7,2,14,75018,6891,11,4420,486
13,11,2,3,4,363673,102863,48,7366,535
11,6,5,5,7,12497,11875,42,5192,392
23,7,16,2,10,269504,8330,95,6624,515
5,3,2,3,6,326080,326080,230,14800,482
4,1,3,0,7,0,0,2,0,729
8,5,3,4,11,363688,40963,37,0,490
62,7,55,0,24,90952,0,123,1570,673
11,7,4,7,17,188238,237337,28,2215,465
42,17,25,12,7,843684,676199,230,231342,435
7,4,3,2,24,328518,113460,53,0,540
15,10,5,3,18,379153,26311,43,19960,403
37,5,32,5,9,224648,190136,147,5356,454
28,6,22,3,19,177308,82498,82,14323,461
11,3,8,0,6,62184,0,8,1238,614
4,1,3,1,14,3429,3429,18,3429,652
19,6,13,0,15,247663,0,16,8994,465
34,8,26,4,17,317699,46876,82,27273,413
26,6,20,3,8,14546,12278,82,8196,547
7,5,2,0,14,44617,0,0,0,633
13,6,7,2,18,573449,14177,24,8374,468
17,9,8,5,8,315744,29520,135,26801,400
30,8,22,4,12,52998,5350,26,1792,547
4,2,2,3,8,12634,18237,31,10140,505
34,15,19,16,10,862012,282205,242,14653,407
20,9,11,6,17,42404,46603,118,28619,468
20,9,11,5,23,33761,30729,89,9906,414
34,11,23,0,16,170564,0,46,610,586
42,6,36,1,32,646703,5359,2,0,646
4,2,2,0,5,411,0,0,0,639
8,5,3,3,24,149445,127295,22,44528,463
4,1,3,0,16,0,0,0,0,649
37,21,16,22,9,866675,854332,406,231749,506
5,3,2,2,16,50630,50630,27,37198,579
12,8,4,3,22,388419,1997,15,0,558
48,5,43,0,9,61469,0,44,9880,482
14,6,8,3,10,296534,54390,9,49754,447
11,5,6,3,8,302750,23964,75,484,494
15,11,4,3,11,323699,12439,31,6035,399
24,11,13,8,10,103752,83546,180,1746,527
5,2,3,1,6,10788,7685,23,7685,662
36,8,28,4,13,181044,30101,80,667,474
8,6,2,3,15,261588,9844,11,2480,555
6,1,5,1,8,8387,8387,11,8387,575
6,3,3,1,10,536345,109348,14,0,606
25,7,18,7,4,38119,36842,325,8598,449
45,16,29,5,15,280303,25794,82,4900,459
35,10,25,3,9,49656,14670,74,2409,458
28,14,14,0,10,448182,0,29,0,633
7,5,2,0,8,53019,0,0,0,668
11,7,4,2,9,657613,36627,52,10921,469
6,4,2,0,19,59059,0,7,0,622
3,1,2,0,11,4956,0,1,0,605
24,9,15,0,18,308861,0,0,0,570
12,2,10,2,18,322912,322912,50,44171,662
7,5,2,4,11,254602,38616,37,34493,431
131,6,125,2,7,33883,817,71,925,591
15,4,11,6,12,37573,48260,89,18394,449
20,6,14,1,8,71109,4260,104,8396,513
25,3,22,1,16,5422,112,22,1317,521
14,2,12,0,14,269811,0,0,0,659
20,11,9,6,9,347230,62515,0,0,453
9,5,4,6,7,48909,37161,0,0,526
18,6,12,4,13,39572,38352,61,3616,474
11,3,8,1,6,2230,2230,99,6664,550
48,17,31,2,17,967747,6360,44,5360,487
7,4,3,3,7,8418,3864,54,2433,521
16,9,7,4,9,351258,1761,41,406,527
15,5,10,3,10,40656,38688,42,15691,440
5,2,3,0,14,270590,0,6,0,530
10,3,7,0,13,26697,0,5,17573,598
19,11,8,9,4,59217,44999,123,19878,416
21,9,12,4,18,286759,1893,42,4781,453
63,5,58,6,12,109841,100984,41,10435,420
19,5,14,2,12,31838,31838,50,946,510
9,5,4,2,7,44742,31294,47,6300,639
16,8,8,6,12,362790,119055,182,5368,457
4,2,2,2,8,4699,4699,32,4596,588
12,9,3,6,7,458854,63581,78,7220,429
38,7,31,0,14,78728,0,0,2080,638
13,8,5,1,7,213619,45,36,0,524
4,1,3,0,3,0,0,138,2797,361
13,11,2,0,7,333202,0,20,5051,504
18,3,15,3,8,13842,13842,462,7316,507
16,8,8,0,3,316910,0,14,2991,523
2,0,2,0,4,0,0,190,11609,430
17,8,9,0,11,233696,0,8,1578,619
24,12,12,0,13,983100,0,19,3274,555
15,9,6,8,12,47227,42523,204,10192,456
7,4,3,1,7,22893,6433,33,6433,544
7,5,2,0,22,61423,0,0,0,654
6,4,2,0,15,16736,0,1,2118,628
9,4,5,4,7,826871,169113,73,95602,460
25,10,15,6,18,537013,88378,100,30711,434
7,3,4,0,4,959121,0,0,0,540
5,3,2,3,13,152975,152975,55,28196,521
16,3,13,2,15,295967,5098,96,8031,503
23,15,8,5,9,97329,20860,35,8618,490
20,1,19,2,7,56823,68246,73,330,519
34,15,19,0,13,394949,0,10,872,615
17,5,12,3,15,367461,59607,36,26120,513
20,8,12,2,10,964730,3334,6,4500,563
10,2,8,1,9,80534,11602,23,11602,593
12,5,7,2,16,20876,259,200,1724,599
20,7,13,3,26,857985,29354,74,266,531
13,8,5,1,5,86042,1465,7,0,573
20,9,11,5,9,29665,7037,219,2601,419
18,9,9,3,5,188025,12264,161,7108,465
24,9,15,4,16,15423,4643,152,2662,442
25,7,18,3,7,164569,17501,46,9322,515
21,2,19,2,11,20042,20042,15,3362,556
4,2,2,1,7,14121,14121,37,1870,488
3,1,2,1,9,12005,1505,0,0,510
18,4,14,3,8,53214,39600,243,1272,503
37,14,23,12,14,558127,145630,190,12686,481
6,4,2,3,15,32595,31595,81,18553,506
7,1,6,2,11,152903,152903,46,1275,492
15,11,4,0,3,73098,0,4,130,650
12,6,6,8,7,35349,51117,149,15721,418
5,3,2,4,14,465201,465201,77,0,521
17,13,4,1,7,482415,40,24,0,563
95,19,76,10,18,94219,68792,454,16941,410
3,1,2,1,15,43334,43334,12,298,649
16,9,7,3,12,309998,24455,112,12294,459
20,7,13,2,13,81803,76127,90,2000,519
14,7,7,11,9,111215,127262,120,4492,467
28,6,22,0,16,233611,0,83,1710,545
21,10,11,8,13,961210,61615,266,17963,384
2,0,2,1,5,3234,3234,7,0,605
5,3,2,0,14,0,0,18,0,603
13,6,7,0,16,142645,0,0,0,605
23,5,18,3,6,55760,20716,50,2316,510
53,23,30,7,22,301549,57536,169,38569,434
15,6,9,2,9,399228,120398,65,0,503
31,17,14,4,21,607742,13920,6,3240,674
8,3,5,0,8,32000,0,3,1211,669
33,5,28,4,16,259669,36216,36,19659,455
27,10,17,8,14,251412,56548,124,20829,578
15,6,9,1,15,579210,8251,16,2246,560
28,3,25,2,13,10626,9977,54,0,540
58,14,44,3,13,30856,14497,96,1495,501
33,14,19,7,9,121255,29459,71,11651,499
15,5,10,2,10,349695,10059,9,0,469
8,4,4,4,6,368484,161678,0,0,452
22,11,11,5,15,51134,27450,7,2069,494
20,6,14,9,14,766629,1277899,175,576902,401
4,1,3,4,8,231836,238844,0,0,499
53,16,37,4,10,315546,38010,63,1945,493
8,4,4,4,7,25153,25153,98,8020,472
27,7,20,0,8,144464,0,12,1710,524
21,2,19,3,8,47060,47060,40,0,458
8,6,2,6,10,180142,161916,90,59156,445
15,4,11,3,16,173295,151620,52,0,532
7,2,5,3,11,3154,7462,58,2188,478
8,5,3,5,19,42562,59235,79,5364,517
38,10,28,6,14,448879,44963,123,23463,439
23,16,7,0,6,100622,0,18,242,567
8,4,4,3,10,11729,11729,51,6580,459
5,1,4,1,16,20216,20216,33,264,499
14,9,5,9,13,652729,77524,0,0,446
18,11,7,9,12,224401,94077,193,20806,425
9,3,6,0,5,29724,0,5,0,468
6,3,3,0,13,368683,0,0,0,497
15,11,4,6,6,322756,275524,56,4556,484
11,4,7,0,12,176472,0,0,0,611
24,6,18,0,18,463976,0,0,7829,607
14,3,11,3,7,65427,65427,105,361,503
15,7,8,8,9,17946,28262,9,484,439
116,21,95,8,24,420777,48452,288,10678,434
29,16,13,0,17,810053,0,27,3485,600
9,5,4,5,5,29561,29330,249,13913,561
12,1,11,0,14,334155,0,0,0,643
3,1,2,0,8,0,0,0,581,648
10,8,2,4,17,122873,43065,121,34001,446
16,10,6,1,27,489911,512,41,11721,482
4,2,2,3,8,51395,60675,45,50475,467
72,16,56,2,16,728728,19743,21,18333,555
10,5,5,3,13,62287,98532,115,4058,511
21,6,15,7,9,59711,75131,126,15270,458
36,4,32,2,7,23335,12854,28,5012,474
17,8,9,6,13,129153,23835,132,10783,460
13,7,6,5,7,96123,90019,79,657,382
15,11,4,9,7,56003,54904,299,8956,457
24,6,18,8,14,24517,44819,149,10122,526
18,10,8,2,12,532025,19601,58,11470,386
5,3,2,0,3,52825,0,0,0,630
41,13,28,9,19,132991,146840,253,7140,452
7,5,2,5,5,18734,25542,13,7908,512
6,3,3,2,10,12857,8043,26,7573,566
3,1,2,1,23,807568,30795,15,30795,559
25,16,9,0,16,714136,0,40,10999,527
31,4,27,4,8,64672,63105,74,672,437
27,18,9,10,18,900542,132525,0,265,462
11,6,5,5,8,34341,25764,38,9816,552
12,5,7,1,8,89327,35,2,0,536
22,11,11,7,13,81358,28778,66,1743,455
10,8,2,5,25,333158,301994,79,224223,473
2,0,2,0,3,0,0,5,0,620
35,11,24,6,12,537356,14792,146,8700,436
14,5,9,0,11,1084197,0,0,0,589
8,5,3,5,8,10547,10547,86,7536,441
24,19,5,9,8,758286,120473,130,63206,437
8,5,3,3,18,119757,119757,38,6993,525
4,1,3,2,19,29881,35348,50,0,497
37,12,25,11,14,190864,114687,322,17799,427
17,9,8,6,17,72670,70270,91,21529,429
12,9,3,0,15,163168,0,0,0,679
7,3,4,1,12,300057,1148,25,831,538
13,8,5,1,17,557733,5119,19,5119,449
12,7,5,0,8,94468,0,11,737,495
5,1,4,2,10,6228,27351,44,0,526
23,9,14,3,29,44692,17354,97,0,456
10,4,6,1,8,41654,4338,43,4338,536
5,3,2,1,8,7204,7204,6,0,481
13,3,10,2,9,384686,43161,39,26978,493
31,12,19,0,17,401836,0,45,1093,570
8,2,6,1,12,32555,4798,0,0,462
8,3,5,4,14,44454,53285,48,18566,483
3,1,2,1,6,546,546,32,546,506
16,8,8,6,12,132500,50523,51,13104,408
4,1,3,0,10,277620,0,0,0,649
17,5,12,1,8,19645,1045,228,9011,442
38,10,28,2,9,418806,22056,15,13785,512
12,9,3,7,16,145444,106492,166,1162,475
17,12,5,5,2,44478,3279,54,2516,518
16,7,9,1,16,90807,2550,57,5370,436
12,7,5,4,8,130315,35201,54,14169,498
16,6,10,2,7,143950,13522,69,14291,632
15,2,13,1,10,880,44290,69,57985,523
38,6,32,1,11,172579,2487,5,3819,413
4,1,3,0,6,0,0,122,910,612
30,11,19,2,13,63348,19138,19,10856,463
13,2,11,2,8,21725,2757,0,0,551
13,6,7,0,10,164786,0,0,0,696
25,9,16,4,19,686549,106908,45,64968,439
10,3,7,0,14,16730,0,30,8253,654
11,9,2,4,20,284311,274506,91,3082,470
9,7,2,3,10,31588,8728,44,4673,398
30,2,28,2,11,372186,36783,34,9378,431
19,5,14,4,12,16766,18405,208,8929,513
6,2,4,2,12,39934,12547,0,0,512
56,24,32,10,14,339612,107793,54,57032,418
14,10,4,0,11,78670,0,50,1047,522
16,4,12,1,22,47359,65335,78,0,630
12,2,10,0,8,0,0,17,0,575
13,4,9,1,23,116260,3948,3,3948,596
15,8,7,1,12,922048,167,0,1111,648
29,14,15,11,16,489064,41429,45,13669,444
13,8,5,8,16,364709,51570,66,19186,417
3,1,2,2,15,24263,36586,28,24263,461
10,4,6,3,6,10082,7112,38,4055,548
24,4,20,4,18,36021,36021,111,23092,465
6,3,3,0,10,182611,0,1,0,465
11,5,6,0,17,503577,0,0,0,698
13,9,4,6,10,1129577,542287,38,0,459
5,3,2,2,10,13055,7093,23,6033,480
15,13,2,6,22,60509,627926,124,12081,513
9,7,2,8,4,43456,63626,78,12825,455
5,3,2,3,7,19681,14833,74,2547,585
20,9,11,1,6,270706,2751,1,2751,621
53,13,40,3,27,75216,18896,103,2917,504
7,4,3,1,9,759433,5102,4,0,554
18,12,6,5,12,159580,16430,113,7969,526
4,2,2,2,12,41531,41531,19,13017,430
25,2,23,0,18,8234,0,1,786,691
8,6,2,0,11,71601,0,2,3055,579
6,1,5,1,12,6753,6753,8,6753,667
12,7,5,6,6,306585,23452,57,9266,488
22,6,16,3,15,241759,26534,140,6744,460
17,6,11,0,14,54795,0,3,0,662
8,1,7,0,4,59117,0,3,0,602
13,8,5,4,4,271499,890,79,828,561
18,8,10,0,13,630355,0,0,1038,658
19,6,13,0,25,98097,0,8,0,648
8,3,5,1,10,27582,4677,86,4677,641
25,8,17,0,19,37215,0,5,1951,652
16,7,9,0,15,47348,0,69,2480,490
25,6,19,3,5,36874,32303,11,11393,454
21,9,12,5,15,83149,5400,6,0,534
9,7,2,8,9,494193,632937,179,0,471
27,12,15,2,69,15007,1596,67,1082,554
21,8,13,7,4,378762,39477,103,4613,446
14,10,4,1,11,154584,472,0,19393,502
18,5,13,1,9,318656,14272,2,1936,491
21,7,14,4,27,119923,31819,151,26447,425
12,3,9,4,15,0,194493,68,733,546
10,6,4,3,15,457432,64974,56,15819,425
7,2,5,0,8,3854,0,3,396,641
17,3,14,4,13,200754,200133,30,0,465
3,1,2,1,6,6181,6181,35,1048,477
5,3,2,3,14,12462,11842,32,5648,428
8,3,5,0,9,64627,0,3,1350,584
32,20,12,1,10,580045,999,11,0,608
10,6,4,4,11,157860,16257,3,714,493
33,2,31,3,15,55397,55397,34,23863,612
16,3,13,1,10,34146,1723,24,16000,574
8,6,2,4,7,49419,37013,57,19817,477
9,4,5,2,7,372056,24487,0,0,506
10,6,4,0,9,17927,0,35,2550,593
31,10,21,5,13,27353,2298,176,2356,441
22,6,16,4,6,73235,5537,213,2376,480
18,8,10,5,14,123730,59891,49,21258,455
7,3,4,0,5,0,0,22,434,645
9,5,4,0,4,24325,0,125,1486,604
11,4,7,4,8,247968,26872,102,4535,593
19,7,12,2,14,50218,2056,27,380200,541
41,19,22,17,10,798464,658904,230,11890,431
17,8,9,0,10,149430,0,5,5869,525
20,17,3,0,8,1302503,0,12,57,551
59,4,55,1,10,308780,14858,15,14858,553
25,6,19,0,8,21843,0,0,0,642
16,7,9,5,15,371478,119227,130,59125,447
5,2,3,0,2,15758,0,4,51,547
26,11,15,0,13,430225,0,21,0,620
20,10,10,0,9,208535,0,2,0,592
6,0,6,0,1,0,0,1,2678,535
7,3,4,1,8,18035,2557,47,0,522
6,4,2,3,6,10843,4564,9,1617,484
11,9,2,3,9,172733,21782,66,0,481
4,2,2,2,8,7397,3218,32,0,540
8,4,4,1,14,45965,534,1,534,501
15,8,7,0,11,246472,0,49,2144,563
10,6,4,1,7,122883,408,9,408,535
11,4,7,3,12,32134,18027,22,8317,479
8,4,4,5,12,561314,125019,85,6347,448
23,5,18,1,7,29749,455,114,2448,449
9,1,8,1,6,1112,1112,125,1295,650
62,6,56,2,15,28039,4076,32,10316,483
3,1,2,0,7,219,0,26,765,686
38,5,33,5,9,21722,13448,26,7920,485
4,2,2,1,15,475,475,7,1755,613
19,9,10,7,16,60852,62270,22,1030,447
10,8,2,2,12,160260,28622,102,28415,591
12,3,9,0,14,365060,0,0,0,577
6,4,2,3,5,30527,23851,49,0,509
9,5,4,1,20,23167,3330,5,3384,465
13,8,5,8,9,499301,50411,421,14890,421
33,12,21,1,26,517139,1337,0,4320,673
3,1,2,2,8,7544,7544,16,6759,590
21,9,12,7,10,349966,25726,221,7289,432
15,10,5,1,19,428266,314,54,7125,389
13,8,5,0,16,4990406,0,28,0,576
6,1,5,2,12,4830,18023,41,1541,520
6,2,4,3,11,85845,39011,22,0,495
19,6,13,5,11,78894,75371,119,0,535
18,3,15,1,11,164619,3159,80,1322,476
4,2,2,2,7,73678,73678,48,0,521
12,1,11,0,11,0,0,0,0,729
3,1,2,1,4,3946,3946,2,3946,608
12,8,4,6,11,448427,79863,80,49899,438
8,6,2,2,22,87839,60538,1,1647,528
2,0,2,2,5,3635,3635,73,2694,580
5,1,4,1,11,10755,10755,53,10755,500
16,10,6,3,13,389868,6541,77,4633,440
30,11,19,1,19,501364,186749,22,117,683
6,4,2,3,9,22373,22373,73,6630,510
44,14,30,8,8,493568,42239,46,255,391
24,3,21,1,11,10164,1461,26,3692,575
11,2,9,3,19,81220,103531,52,67338,434
14,5,9,3,14,252188,4308,17,3402,554
5,1,4,1,9,5250,5250,42,9081,485
8,2,6,2,15,12056,15810,23,12056,547
5,3,2,1,13,31214,31214,27,39213,610
20,12,8,3,19,1338901,104418,46,67830,460
9,7,2,8,9,183201,114444,0,0,511
30,5,25,5,17,137811,53858,371,33480,408
30,10,20,1,11,523965,1336,0,0,498
6,3,3,0,13,65029,0,0,0,589
16,11,5,1,30,55459,321,2,3831,538
6,2,4,0,10,34221,0,6,1289,459
17,7,10,2,7,327511,33539,18,3059,516
8,5,3,2,12,455692,20906,0,0,435
6,4,2,2,4,5879,18483,13,1250,462
10,4,6,1,9,15909,7800,23,7800,554
6,4,2,4,17,22764,22764,311,12779,543
17,10,7,9,6,270163,131185,95,39347,443
28,9,19,6,12,579619,7921,60,1772,452
16,8,8,4,11,95573,25420,129,7790,487
12,5,7,0,2,21154,0,0,0,607
14,9,5,6,7,38294,29721,281,14569,447
15,6,9,7,14,439967,55577,31,9941,469
15,9,6,0,23,692692,0,2,0,673
48,13,35,12,18,72579,24824,218,11151,408
19,11,8,0,5,125796,0,2,1028,564
44,9,35,6,11,162620,52084,221,10763,433
15,9,6,0,17,590615,0,24,1148,573
41,21,20,3,29,1018214,35933,28,3121,485
6,3,3,3,8,30002,46099,57,0,443
9,7,2,4,10,133981,53234,58,27706,395
7,3,4,2,10,3814,19379,4,1005,482
26,13,13,13,20,595895,96578,174,30151,373
7,3,4,2,7,7370,7370,36,6400,479
14,7,7,5,6,21317,14421,14,5236,448
18,5,13,4,6,101023,43480,92,4059,449
18,8,10,9,12,33382,35988,118,13996,446
14,7,7,0,16,600613,0,8,0,631
27,16,11,13,30,2902127,597923,30,0,476
3,0,3,1,7,0,5055,0,0,614
8,5,3,1,10,134352,35144,26,194,540
18,9,9,5,8,230691,33455,80,11603,440
15,7,8,7,13,29785,26824,59,7808,504
14,9,5,0,7,79169,0,0,775,616
17,10,7,0,16,1167601,0,36,2865,594
7,3,4,1,7,11435,1704,19,1704,482
30,7,23,0,18,1428158,0,0,0,669
9,6,3,7,10,107455,88780,190,31750,481
17,7,10,5,13,245725,41754,50,21977,439
7,4,3,0,6,15944,0,17,0,675
23,15,8,14,4,70159,51506,233,12693,431
17,6,11,0,15,105689,0,0,0,594
13,2,11,2,2,38037,13016,10,0,465
7,2,5,1,9,72788,60783,5,60783,527
12,3,9,0,13,421784,0,25,5770,633
8,5,3,4,19,405820,121312,73,18140,569
21,6,15,4,4,27874,16257,51,8463,424
8,1,7,1,13,0,7788,31,0,630
11,3,8,0,9,118538,0,1,1131,635
15,10,5,5,24,146696,22571,34,0,444
10,4,6,0,8,5755,0,0,0,700
44,6,38,2,15,647,647,8,2221,488
27,12,15,0,18,1505057,0,1,1316,661
7,5,2,1,9,239811,6161,0,0,652
34,10,24,7,10,138556,133051,189,5729,423
4,1,3,0,1,3293,0,1,1228,509
21,6,15,7,11,83769,85432,109,20073,372
20,8,12,2,12,147999,7304,31,6166,425
3,1,2,2,7,10257,20579,0,0,491
6,3,3,4,11,18470,31248,47,13451,525
40,5,35,0,18,185228,0,13,1263,566
17,7,10,3,14,36297,41291,76,2000,496
24,7,17,2,7,108741,56025,158,8822,510
43,9,34,0,5,97359,0,11,455,590
5,3,2,1,6,10093,419,0,0,511
24,4,20,1,34,235279,129297,29,1193,513
21,11,10,0,12,280387,0,1,592,659
13,4,9,3,7,58519,57906,53,2688,474
11,9,2,7,9,132756,173208,139,44352,376
16,8,8,1,11,1299671,9424,0,98,601
16,5,11,5,13,141646,36354,100,16904,450
45,9,36,2,18,160717,5747,8,3406,413
23,11,12,0,16,308337,0,3,1327,613
41,11,30,5,11,31546,22327,390,7886,452
7,4,3,0,5,27937,0,4,2292,641
22,8,14,2,12,35637,3411,166,5967,580
27,13,14,8,14,360554,288061,130,922,443
4,0,4,0,13,0,0,0,0,650
8,4,4,0,27,683431,0,92,13720,704
17,15,2,6,31,355955,13464,34,2577,476
12,9,3,0,7,1770639,0,5,13065,563
14,4,10,1,18,43090,16398,95,16398,654
11,7,4,1,4,277567,3755,12,3755,513
29,7,22,7,15,19967,20459,327,12097,527
11,4,7,1,5,5030,2455,4,4195,537
35,14,21,7,13,435379,270177,113,117256,427
11,6,5,0,14,146347,0,0,9188,630
8,3,5,1,10,4661,429,0,257,524
14,12,2,5,69,321280,19408,34,159,500
3,1,2,0,3,2214,0,0,0,613
17,10,7,16,5,302907,489394,192,23249,477
3,1,2,1,10,467349,467349,32,0,623
5,2,3,3,14,109552,135775,49,65819,550
15,5,10,2,10,106976,101776,50,0,585
5,3,2,0,6,136171,0,0,183,687
9,3,6,4,8,13443,22660,125,9000,485
7,1,6,3,8,24365,27451,65,6878,584
20,4,16,4,15,345804,229806,46,0,508
13,8,5,3,11,185511,91068,51,13380,468
20,11,9,2,15,543543,31651,16,0,450
13,8,5,5,69,1118649,55900,40,1576,468
8,4,4,3,8,43509,33947,92,548,519
14,5,9,0,13,503067,0,1,13061,641
9,4,5,1,7,63038,52273,30,0,564
11,4,7,0,7,9954,0,118,493,640
5,2,3,1,7,25301,25301,8,25301,515
5,2,3,3,4,25640,31738,62,5647,496
13,8,5,10,15,63627,73558,87,22289,419
21,5,16,0,7,76129,0,1,1861,656
12,3,9,1,4,22385,1476,8,1476,604
33,13,20,0,7,238104,0,0,0,668
19,5,14,3,13,98891,98891,55,71412,412
6,3,3,0,14,83257,0,2,656,684
8,4,4,5,7,20546,20916,181,16371,482
13,7,6,5,10,230769,49687,109,14352,489
5,3,2,3,13,41843,36303,8,152595,463
15,10,5,0,10,109106,0,6,415,632
23,5,18,4,8,50880,43336,121,6754,460
13,7,6,0,7,150266,0,1,0,640
9,4,5,4,16,50143,30711,81,32103,475
27,9,18,4,13,463209,26857,53,11227,485
18,4,14,0,17,271329,0,8,4630,570
6,3,3,1,9,8858,4754,31,4712,512
22,8,14,7,8,189430,136290,110,1888,519
40,6,34,5,18,13229,33991,109,26696,499
6,2,4,1,5,74337,15261,0,0,528
11,9,2,5,11,920516,125453,39,78584,455
22,8,14,4,11,407189,16490,21,9576,459
11,5,6,4,7,18262,18262,61,4438,447
11,9,2,1,5,1225984,449,6,0,531
14,7,7,0,8,574152,0,16,1788,524
10,6,4,2,21,75330,38637,51,2287,488
22,7,15,3,69,59497,54994,47,29581,599
7,3,4,4,9,80244,114887,64,61075,510
8,4,4,4,11,131477,122530,45,18170,470
11,4,7,2,17,445841,30766,51,11210,532
102,6,96,0,4,11840,0,0,0,591
25,2,23,1,3,15715,782,16,3654,535
12,9,3,5,25,58607,45440,83,37630,447
18,7,11,0,14,36845,0,7,470,607
6,4,2,1,14,142730,1539,2,7408,464
56,8,48,2,20,232337,13162,29,13088,448
8,5,3,1,12,489593,5844,28,17013,454
12,3,9,3,13,37516,37516,58,15898,480
11,0,11,0,3,0,0,0,0,653
7,1,6,1,10,20498,20498,20,20498,628
7,2,5,4,8,1236,9896,0,0,486
7,3,4,3,10,430389,24015,47,17656,528
25,11,14,2,5,179029,19180,47,11710,529
11,4,7,6,8,49340,63652,79,19046,472
8,4,4,4,19,64375,36267,27,17001,472
40,4,36,0,11,195332,0,0,0,673
171,11,160,5,21,39316,33543,307,4340,480
15,9,6,7,14,44451,24888,196,21676,420
21,5,16,1,7,30545,654,43,3562,501
9,6,3,4,16,66089,60054,95,19450,484
111,20,91,16,17,646297,640332,140,94398,498
5,3,2,3,5,26061,26061,49,938,511
17,4,13,6,7,117907,115845,158,2231,513
33,21,12,0,7,452148,0,9,0,521
4,2,2,2,8,9602,6484,26,3450,525
22,7,15,0,25,43801,0,7,0,677
64,7,57,3,17,49840,23625,51,17568,457
14,10,4,9,6,57309,56781,208,10896,374
8,6,2,1,2,25807,104,6,300,572
4,2,2,2,17,0,32251,19,163,668
8,6,2,0,8,59310,0,2,0,572
22,10,12,6,15,172190,26042,125,8210,443
9,6,3,3,14,362425,15869,56,13138,498
15,10,5,5,6,56263,13696,6,5450,440
8,4,4,2,17,30866,15249,37,12389,527
16,10,6,6,7,50494,68629,89,21973,475
19,12,7,12,8,120214,118939,43,11102,411
19,5,14,2,6,17630,13508,34,1899,525
19,6,13,0,7,43418,0,16,883,545
14,6,8,2,20,260590,7856,24,6192,540
48,7,41,4,13,50745,16889,87,7000,525
22,12,10,9,8,671742,47759,406,21455,423
18,10,8,1,20,1017094,1,24,1,606
43,9,34,3,14,64378,53031,59,875,546
37,16,21,10,22,1063608,527415,190,48562,506
4,1,3,2,14,14988,19422,8,12490,431
11,6,5,6,16,21569,29107,79,2153,556
36,10,26,10,13,171841,98149,199,22233,455
18,7,11,2,18,14909,16191,28,9274,652
11,6,5,1,9,21238,35,1,35,466
11,6,5,1,9,151459,667,47,1550,536
15,8,7,3,14,78064,15098,69,6876,469
23,5,18,2,12,147760,25081,23,10076,485
6,2,4,2,9,484736,96546,40,0,536
19,8,11,10,7,82178,95391,88,16850,413
14,12,2,12,7,113162,112977,91,21296,463
10,7,3,3,7,15094,4357,43,3300,508
4,2,2,1,11,12472,10572,0,0,625
12,3,9,3,10,14799,11603,33,3901,489
10,3,7,1,10,175004,28686,19,4502,486
15,5,10,3,18,104032,81065,0,0,523
26,10,16,0,8,1352031,0,162,20171,427
10,3,7,3,16,18330,23959,10,4200,532
4,0,4,2,4,0,29761,17,0,606
4,1,3,1,6,752,752,18,0,490
14,9,5,9,18,219427,208505,69,11830,457
7,4,3,2,9,3424,3345,38,4413,501
10,6,4,1,10,67938,37146,12,37146,652
16,12,4,8,18,1091983,77688,53,10133,453
34,13,21,8,9,112220,9488,135,8644,493
5,2,3,1,16,343,343,10,343,488
15,3,12,1,8,7025,1739,4,1594,575
22,12,10,2,8,241116,4410,26,6428,436
13,9,4,1,8,95131,1797,6,1797,582
11,8,3,1,13,147464,31462,15,31462,511
10,3,7,1,11,11389,10512,9,0,687
25,11,14,8,8,235933,217009,80,9405,498
61,18,43,5,4,374777,15329,113,3180,477
10,4,6,2,10,302721,16140,44,9831,462
4,2,2,0,16,6718,0,26,0,617
11,2,9,2,8,29590,28706,80,26035,509
10,5,5,2,14,31624,3378,18,7457,532
28,9,19,1,6,48875,308,3,850,506
6,4,2,1,10,92322,2458,31,3125,538
3,1,2,1,8,5737,5737,30,0,644
7,5,2,3,9,194836,21395,41,0,487
5,2,3,0,16,2203,0,9,243,691
4,1,3,1,15,272410,34407,9,34407,562
29,7,22,2,6,30367,3851,9,0,476
15,9,6,3,7,254950,30661,58,5791,401
14,6,8,7,18,1703769,356162,113,48131,425
35,8,27,11,7,36225,46302,152,5330,473
12,7,5,4,11,447561,59016,61,0,444
104,10,94,1,14,61418,4990,62,10090,486
13,10,3,0,16,158036,0,3,2178,615
13,4,9,1,6,41547,328,23,12000,552
26,12,14,5,10,113812,43091,81,14812,478
8,2,6,1,4,163008,9720,11,0,475
31,9,22,1,15,276600,1070,65,22155,468
18,7,11,3,12,149511,127828,31,62397,498
40,7,33,3,22,373948,336306,69,264424,503
10,6,4,6,8,60158,61224,120,22043,459
10,7,3,7,17,23586,34139,71,10553,472
7,1,6,2,16,12585,19085,11,12585,487
14,7,7,6,19,183021,188990,137,0,522
30,6,24,0,7,88319,0,25,7262,519
15,1,14,1,11,660,3902,15,647,653
13,9,4,10,9,76634,82974,166,12062,411
9,1,8,2,8,0,18349,38,0,601
20,3,17,2,8,17674,17674,120,7377,451
25,5,20,2,13,37069,6959,14,1658,563
37,11,26,9,13,23812,16950,557,5242,455
40,6,34,3,12,24871,5853,36,2350,521
13,6,7,7,14,72185,31389,2,3152,383
75,8,67,2,13,14714,2738,77,2995,486
17,4,13,0,20,364607,0,11,188,693
11,9,2,2,11,336623,12748,59,1315,530
28,10,18,6,14,245453,268746,67,181304,408
25,8,17,7,13,58192,48779,122,10172,489
8,5,3,0,10,30212,0,1,562,553
31,9,22,2,12,222271,20631,16,1484,531
9,4,5,0,7,23511,0,2,492,652
11,6,5,6,19,127783,151546,117,10703,469
13,3,10,3,7,50703,50703,116,49936,480
8,3,5,1,14,229694,7118,22,7118,569
9,5,4,3,5,21401,15203,42,6987,503
16,11,5,14,18,977172,1291431,234,259113,356
6,2,4,0,12,18975,0,1,350,738
13,10,3,7,24,63119,42291,104,7840,495
10,6,4,6,14,25340,19042,32,9869,447
12,8,4,4,13,329758,19300,89,17942,464
17,10,7,11,7,108717,107643,473,30500,439
7,4,3,7,6,468515,909078,123,53601,523
55,15,40,7,12,362576,119517,163,12100,407
24,12,12,9,17,101397,26522,198,13109,433
15,6,9,3,8,15784,9591,37,5492,445
25,9,16,4,9,382406,4418,5,6436,481
30,4,26,0,9,301508,0,1,1642,536
7,4,3,1,8,73101,1096,13,1285,533
11,8,3,5,5,146366,134200,0,0,459
36,6,30,1,10,296776,1037,3,1990,592
5,3,2,1,3,9375,317,1,317,491
6,3,3,4,8,232451,36256,0,0,585
10,8,2,8,7,17862,29510,109,1634,468
45,7,38,7,7,572790,180546,64,60515,417
8,3,5,2,7,51134,33540,51,0,482
40,9,31,10,11,460735,109550,187,10965,376
52,13,39,3,5,825544,4104,20,2532,476
6,4,2,0,4,64040,0,0,0,564
30,13,17,5,10,67483,34558,194,24690,451
39,11,28,8,18,180937,158585,73,1403,501
8,6,2,0,8,122386,0,1,0,631
5,2,3,1,7,8618,8618,64,8618,577
24,5,19,6,12,58754,57754,339,26887,499
6,4,2,3,4,7476,5138,5,1876,504
129,4,125,2,7,29825,817,71,925,558
19,14,5,7,9,616061,152023,8,2996,439
15,4,11,0,16,332746,0,0,1216,682
11,4,7,1,15,619776,141162,10,1276,640
16,4,12,2,19,14470,7227,85,6315,452
22,10,12,4,11,124483,57073,0,0,454
77,13,64,9,11,574803,425752,159,71397,478
12,7,5,7,9,53285,43123,113,9747,456
13,5,8,3,14,36646,34117,57,21947,479
23,8,15,2,14,56026,8769,83,6090,455
6,4,2,4,8,188394,188379,30,6252,449
33,19,14,0,14,137112,0,31,7343,500
9,3,6,1,6,6651,3531,20,3532,635
13,7,6,4,9,184256,15387,39,6024,417
17,6,11,6,13,57339,62023,112,17603,476
7,3,4,2,11,20698,20698,34,13700,564
4,1,3,0,7,0,0,0,0,645
11,7,4,8,39,321079,61784,145,5995,421
16,9,7,3,25,133297,113379,25,582,558
4,2,2,1,12,291972,9324,23,230,493
11,5,6,0,15,5127,0,0,0,619
8,4,4,3,19,24529,20964,71,0,531
5,0,5,2,7,7421,7421,164,6562,538
9,6,3,0,10,179371,0,0,0,648
20,11,9,8,17,1014788,146582,160,0,585
13,11,2,10,21,377690,42231,138,8096,460
16,8,8,8,11,997154,66984,22,21167,496
88,12,76,12,13,249224,240529,217,106819,422
12,4,8,3,3,9835,7657,43,4783,449
7,5,2,0,14,385001,0,0,584,746
11,8,3,0,10,1773938,0,38,0,466
4,0,4,0,10,0,0,0,0,666
28,5,23,3,18,47536,29688,34,27956,523
16,11,5,1,18,888899,178252,57,178252,409
22,9,13,1,16,521208,5025,41,5025,472
18,10,8,2,13,1704860,6948,16,4492,571
90,13,77,7,10,339474,38344,114,11960,432
10,5,5,2,23,13011,4848,51,5647,446
34,10,24,2,19,229845,32568,120,8753,538
2,0,2,0,7,0,0,16,871,593
13,8,5,1,25,576322,2274,3,6822,454
5,2,3,0,6,0,0,2,313,632
11,9,2,5,27,1083744,1021165,82,482897,516
13,4,9,1,9,68343,4500,57,4500,439
5,3,2,1,6,8029,3367,110,1017,491
22,7,15,5,8,37472,46999,250,41625,415
23,6,17,4,17,430635,268424,30,515,563
4,2,2,1,12,13675,13675,13,21368,632
7,2,5,1,17,9000,8000,35,0,506
12,6,6,4,12,41467,31524,19,10278,420
26,4,22,3,10,114653,8296,41,7640,520
8,4,4,1,2,162862,4131,8,4131,498
6,2,4,0,10,98731,0,0,0,687
6,4,2,1,12,540948,3993,0,425,600
12,1,11,0,14,0,0,3,6351,433
35,15,20,0,13,504330,0,5,0,647
8,4,4,0,2,3039,0,2,238,482
8,3,5,3,8,18351,18351,46,14906,570
8,5,3,0,16,187992,0,0,0,684
13,7,6,1,18,44036,7360,13,7360,683
8,3,5,1,9,80323,11248,207,3836,337
13,7,6,2,14,836987,62688,42,56635,521
10,4,6,7,16,251618,210699,120,9615,458
20,13,7,1,16,140074,25,61,5355,438
26,13,13,1,17,897877,3172,0,0,607
26,12,14,0,18,800475,0,8,598,631
22,1,21,1,7,10972,10972,25,0,523
8,3,5,1,13,292062,29313,23,0,577
24,6,18,3,15,348901,102179,147,3300,547
29,5,24,1,18,39507,14200,26,14200,572
4,2,2,2,8,2568,2568,38,1297,491
29,5,24,7,9,34923,42146,245,17095,470
24,10,14,1,18,303294,4511,96,4354,492
7,5,2,5,7,16852,31979,15,2665,477
19,9,10,3,18,424960,16494,12,0,611
15,13,2,12,13,177879,174658,123,26246,387
15,4,11,1,8,19998,1992,63,3601,493
10,5,5,3,19,11211,10420,80,4695,488
4,2,2,1,12,3534,3134,25,0,545
2,0,2,0,4,0,0,8,134,604
9,5,4,1,17,17021,4496,18,3310,519
5,2,3,1,6,2365,2174,21,2174,513
9,4,5,2,16,24460,10230,15,8059,468
11,7,4,4,10,309393,3410,33,630,512
9,5,4,4,13,6004,6004,49,2104,458
8,3,5,4,10,13814,20633,0,0,559
7,3,4,2,9,23687,23687,38,3185,537
11,5,6,4,9,8144,7674,37,4339,478
27,6,21,2,7,160876,539,8,457,541
33,6,27,4,12,8546,4034,244,2008,507
18,5,13,1,34,554993,30265,59,277,512
12,7,5,3,6,17923,15585,0,0,491
25,9,16,4,15,51517,44362,25,28401,471
11,8,3,7,6,45601,35203,159,15198,476
7,5,2,3,9,15516,2781,65,2053,465
20,8,12,10,9,152409,219120,222,55895,382
30,7,23,8,18,208028,139550,232,50154,449
13,10,3,4,14,246385,50085,10,29931,462
17,8,9,2,14,501772,4499,4,5744,513
32,12,20,5,14,373696,55826,105,39255,573
8,3,5,1,12,497451,10161,42,2470,458
20,7,13,4,4,25408,16608,37,3584,476
9,7,2,1,2,78793,850,1,0,644
22,4,18,1,18,161995,2485,84,7290,492
9,7,2,0,6,157580,0,4,282,527
27,5,22,1,8,13359,5744,29,5744,458
11,9,2,1,10,95918,1552,4,0,555
21,11,10,6,8,87515,56219,166,23201,413
37,14,23,0,39,679952,0,16,0,693
20,5,15,7,7,395682,24524,74,384,489
8,3,5,1,24,27562,27562,33,778,522
6,1,5,2,8,21261,55798,48,0,487
2,0,2,0,3,0,0,0,0,594
6,4,2,1,8,1000,33285,11,33285,683
15,9,6,6,14,337713,210956,59,17388,453
15,9,6,0,11,339623,0,1,0,665
30,7,23,2,9,65630,23026,8,22597,443
9,5,4,5,12,54199,63606,121,0,485
21,9,12,0,11,1552499,0,12,10660,493
6,0,6,0,8,0,0,2,1988,571
4,0,4,1,8,1087,1087,10,1087,507
29,14,15,7,12,586598,82967,78,55638,419
8,3,5,5,8,12116,12116,50,5263,424
9,6,3,2,7,28892,8381,50,7215,466
13,10,3,1,26,642504,4425,38,49748,590
4,1,3,3,5,7375,7375,44,3600,578
4,1,3,1,22,0,162275,16,0,675
13,11,2,0,13,798094,0,4,26249,596
24,6,18,6,12,57561,28330,54,16268,494
5,3,2,2,11,137906,21056,45,15303,542
16,0,16,0,7,0,0,84,9952,575
26,5,21,4,13,96133,59628,114,41800,463
17,8,9,7,9,518103,65994,65,1445,413
42,15,27,0,23,1865636,0,0,0,682
30,15,15,9,10,749304,129133,78,22122,403
29,9,20,5,13,41855,162858,88,8291,405
13,2,11,1,11,6645,966,26,1610,579
23,13,10,0,17,844716,0,3,407,549
8,4,4,1,14,15906,9142,27,9142,537
12,8,4,6,16,29999,29999,107,7055,486
5,3,2,0,14,151019,0,4,0,584
23,8,15,7,14,1680710,806278,138,21385,443
4,2,2,0,8,46313,0,0,1222,619
9,4,5,3,10,356694,6638,125,6025,430
5,1,4,2,13,808229,225780,56,0,595
15,4,11,1,11,88554,106,0,0,521
32,6,26,5,11,50046,52769,116,7667,526
13,8,5,6,12,667540,20957,142,10775,467
25,4,21,2,10,416535,147777,133,0,446
19,7,12,5,19,405770,13398,21,3634,510
5,2,3,1,8,317639,3244,25,0,630
22,4,18,4,9,472759,37260,45,11372,450
12,9,3,0,6,479389,0,3,1780,507
17,8,9,0,37,200442,0,0,0,705
10,7,3,0,12,429412,0,0,7917,513
34,8,26,2,5,37809,5115,3,1790,507
39,15,24,11,15,610798,155172,179,11574,433
13,7,6,2,17,50447,19985,57,6756,439
30,6,24,4,6,37003,10256,78,3149,439
24,4,20,2,13,209088,14150,36,0,474
15,12,3,5,13,416353,38498,112,3506,521
18,9,9,5,13,804697,26700,73,6169,453
11,6,5,1,12,231377,4609,13,1277,526
18,0,18,0,10,0,0,41,1900,518
6,4,2,4,14,205926,186721,64,94413,509
23,8,15,8,11,13697,13697,120,4991,469
6,3,3,4,8,30431,39729,23,29484,417
3,1,2,2,7,3786,14262,37,0,532
10,5,5,1,7,9659,75,10,150,587
4,0,4,1,7,0,2480,0,0,617
12,8,4,7,5,171497,51245,351,8840,493
16,5,11,4,16,38719,38719,60,6680,465
16,11,5,10,11,58306,58306,195,3998,422
14,8,6,7,9,28147,27019,103,6307,434
24,10,14,6,14,48826,19663,274,22802,459
50,12,38,4,25,991415,285335,105,165711,481
9,4,5,1,13,5614,5196,13,17301,698
11,4,7,1,11,5808,5710,44,22949,617
2,0,2,0,5,0,0,25,0,624
6,4,2,0,10,36054,0,4,258,638
10,6,4,0,12,195518,0,2,11569,679
34,15,19,12,8,190815,168630,339,20935,375
27,12,15,2,29,1031348,19118,10,18910,563
14,5,9,1,18,79106,7519,96,7519,678
21,13,8,14,18,978045,668783,179,127390,471
12,6,6,2,7,23268,11129,39,604,520
11,7,4,5,11,224718,69631,73,10794,475
5,2,3,3,8,45719,45719,50,0,540
10,5,5,5,13,20432,238788,30,5543,486
13,9,4,11,7,50449,65071,145,2888,475
37,6,31,3,16,374198,33346,51,11341,488
15,8,7,4,12,355820,8202,66,4353,448
9,4,5,2,8,16884,12511,132,11738,529
10,5,5,5,16,69995,32144,44,944,495
7,3,4,1,9,318373,10877,25,640,510
9,6,3,2,10,182465,4767,18,0,475
17,5,12,8,9,364358,276189,47,41470,546
17,11,6,10,14,301143,74605,104,11476,414
22,3,19,2,12,35892,18072,136,1005,568
12,7,5,3,17,181813,31438,35,7618,519
16,9,7,0,9,64395,0,0,0,687
20,9,11,0,11,855388,0,24,0,589
6,4,2,3,17,103316,124209,10,79352,511
4,2,2,0,5,223508,0,0,0,517
19,5,14,6,13,186524,186824,42,12235,464
16,2,14,0,23,210033,0,13,0,463
13,6,7,9,8,272043,312154,21,102547,469
3,1,2,1,8,2291,2291,4,2291,619
9,4,5,4,13,34499,21488,52,12798,487
10,3,7,1,9,188732,5200,1,5200,518
13,7,6,2,13,245534,13673,18,7060,481
12,8,4,6,16,284203,29970,112,6371,494
34,10,24,10,24,363212,362115,140,21577,402
18,11,7,5,16,100317,48508,83,11140,453
4,1,3,1,8,38870,38870,26,0,516
20,5,15,0,6,30840,0,0,0,597
4,2,2,1,8,10146,10146,94,10604,541
14,8,6,5,12,876211,39292,120,14480,514
16,14,2,14,3,80912,65709,93,17274,300
8,5,3,3,4,383052,62358,53,48283,466
10,8,2,6,11,158668,117560,112,0,503
15,5,10,1,8,292232,6316,24,1557,495
52,10,42,0,22,39225,0,30,6202,529
24,4,20,6,8,29121,24784,18,5462,489
5,3,2,3,8,28569,21210,131,13161,461
6,1,5,2,7,693,9223,24,693,468
5,3,2,3,13,152975,152975,55,28196,469
19,9,10,1,13,538091,28067,58,624,548
29,16,13,5,8,130646,28977,433,12824,448
17,11,6,10,15,629427,261962,142,32145,469
9,5,4,0,8,46190,0,11,0,606
9,2,7,0,7,8093,0,1,250,691
13,9,4,2,8,64565,766,4,0,479
21,10,11,0,8,791102,0,1,0,646
20,6,14,6,11,57567,63087,47,6318,459
33,12,21,5,14,388697,24943,153,23075,474
11,7,4,0,5,31079,0,0,0,628
24,7,17,0,15,686811,0,0,0,664
6,2,4,2,7,7988,7988,30,0,490
78,11,67,5,18,534066,70997,170,3345,480
5,2,3,2,9,94620,37209,54,27068,554
18,5,13,2,18,310375,47650,65,26087,453
16,9,7,0,15,87365,0,11,1790,606
36,14,22,5,22,923376,125463,37,1386,452
20,14,6,2,15,491660,1612,28,0,513
7,1,6,2,13,0,15317,44,0,586
10,3,7,1,9,21702,5887,8,5887,617
8,4,4,3,16,18592,21197,60,0,540
10,5,5,2,7,9118,336,19,272,568
5,2,3,2,7,7591,14005,0,0,457
9,7,2,3,14,1614,1614,25,0,602
39,4,35,4,7,19819,28988,51,6897,508
4,2,2,3,5,14088,32636,49,1598,482
26,8,18,11,7,55922,83227,126,20843,382
6,1,5,1,11,137956,137956,1,127361,591
20,5,15,3,8,199453,39954,49,19019,551
7,2,5,2,5,3510,3510,28,3151,530
16,10,6,7,3,149296,39944,16,3219,437
12,5,7,0,12,50049,0,24,0,558
6,3,3,0,3,13917,0,14,0,616
7,5,2,5,12,714195,57593,38,5288,486
12,4,8,4,13,1764,2175,46,2112,512
10,8,2,10,6,54015,60053,153,20384,411
8,3,5,1,7,2996,775,22,2161,547
12,7,5,1,9,665245,13713,8,0,511
48,10,38,4,8,30378,6537,167,2012,469
26,4,22,0,10,92444,0,48,2666,521
10,3,7,1,10,6881,1200,45,1200,454
8,4,4,4,6,58465,58051,78,0,524
13,5,8,1,16,568186,46515,49,6110,585
9,5,4,4,9,45903,14740,56,2737,517
15,6,9,0,13,21137,0,0,4126,632
6,2,4,2,13,28531,24429,29,15198,620
16,6,10,5,7,107940,123029,114,50201,492
15,8,7,0,15,440247,0,3,0,705
6,2,4,1,15,63579,63579,11,63579,612
22,9,13,3,11,326079,31672,187,29412,470
20,7,13,0,11,340812,0,0,0,692
15,4,11,1,5,734489,5997,6,1364,530
14,6,8,2,19,123701,23311,15,1252,522
23,6,17,7,8,286871,466502,155,221390,426
37,8,29,0,12,277281,0,34,0,624
47,11,36,7,11,29320,8364,141,2121,415
16,7,9,8,11,67754,89964,141,19242,429
15,7,8,7,17,979592,240395,78,140413,458
17,13,4,4,11,162809,19362,14,8172,408
3,1,2,1,7,311,311,19,311,592
59,24,35,4,18,253865,14873,98,8024,542
11,5,6,3,11,20351,14985,35,11413,580
36,2,34,1,5,520,520,43,5763,630
25,10,15,8,13,292046,26308,29,0,483
5,3,2,0,9,28172,0,9,0,614
22,5,17,4,17,358894,26885,125,8808,433
38,12,26,9,14,302330,153469,116,38495,431
16,9,7,4,8,30643,11838,81,821,485
27,6,21,5,10,47586,19936,144,13624,500
47,6,41,4,14,321335,87529,119,11160,481
9,2,7,1,11,6169,5091,24,5091,532
7,5,2,3,16,256864,16218,0,0,486
55,8,47,4,13,128840,77302,65,493,586
11,1,10,0,6,0,0,44,56916,591
9,3,6,1,10,57584,93,3,1835,579
11,6,5,2,18,235266,3218,21,2197,461
12,6,6,2,14,824857,48227,24,32039,533
8,2,6,1,12,17108,3430,0,160,634
22,4,18,1,11,10726,1019,75,5508,548
20,7,13,4,7,25410,19315,333,9732,498
38,31,7,2,11,547461,35078,7,34709,520
5,3,2,3,18,10699,10698,64,1945,488
42,10,32,0,13,162387,0,18,4363,551
5,3,2,4,7,25516,40169,34,15438,464
8,3,5,4,7,12113,33887,88,0,545
12,3,9,1,7,63595,13871,8,0,504
6,4,2,0,7,30825,0,6,593,550
11,4,7,4,14,19006,17898,70,15934,438
17,7,10,2,11,86588,36987,0,149,494
16,8,8,6,13,60275,53546,49,18248,456
10,4,6,4,10,35255,35255,93,7200,525
3,1,2,1,7,2850,2850,26,11989,419
75,10,65,10,14,144200,183262,397,76988,427
14,5,9,4,13,112242,103700,0,0,449
13,3,10,3,8,75137,75137,12,61243,511
19,13,6,10,14,856714,130358,100,39172,441
9,6,3,1,9,243743,185,1,7993,495
10,6,4,4,13,261191,16248,32,4809,439
8,6,2,1,5,248064,1556,32,627,447
23,10,13,7,10,227032,59727,44,20912,391
14,6,8,5,16,28466,25738,62,8802,452
6,1,5,2,10,4556,4556,14,3722,640
14,10,4,0,9,1078914,0,19,6514,546
10,7,3,4,7,426661,21653,6,2875,443
8,3,5,2,8,57380,18039,45,0,465
21,8,13,6,42,537768,112304,89,13379,424
14,6,8,1,12,24827,410,75,6207,568
20,6,14,2,16,41674,10010,17,9030,456
11,5,6,4,14,13579,13579,27,4931,498
18,7,11,6,9,94343,94736,77,15134,486
12,8,4,3,21,543319,46556,39,36288,444
6,2,4,2,9,14022,21662,41,0,667
10,3,7,6,9,12434,87446,93,457,565
14,5,9,3,10,57597,18138,0,0,443
12,6,6,1,8,354001,484,24,713,524
8,4,4,6,14,109682,122488,99,13119,431
12,3,9,0,8,59483,0,6,1530,508
7,5,2,3,12,26943,22452,79,8727,518
7,3,4,2,5,21684,15911,28,9878,435
13,2,11,4,12,47154,108970,105,1770,567
20,6,14,2,17,714233,6333,12,9396,492
30,11,19,8,7,64821,56460,94,35148,421
9,2,7,4,13,39141,110882,70,635,505
32,11,21,3,9,215798,14799,31,438,495
40,18,22,7,13,467444,58506,190,23932,414
33,7,26,0,19,247414,0,1,580,700
11,8,3,3,9,155319,77699,0,0,553
39,6,33,1,14,870045,113700,14,0,609
9,3,6,0,13,4758,0,5,1149,555
13,5,8,1,7,376899,5105,9,0,623
10,7,3,1,7,87256,150,3,623,584
35,6,29,6,9,144183,115187,172,45004,442
16,3,13,2,14,31529,12978,18,11984,579
9,6,3,0,8,1017000,0,13,0,528
9,2,7,2,8,3727,7331,63,3727,489
80,5,75,3,6,24753,13216,41,0,488
51,14,37,0,69,446674,0,11,1105,625
6,3,3,1,11,11884,10884,19,10884,645
6,4,2,3,9,42373,42373,0,0,525
8,5,3,4,7,17445,24262,38,7854,440
35,16,19,2,17,487095,7481,28,751,505
26,6,20,6,9,37863,37863,205,10298,454
43,12,31,4,11,105367,22576,227,8818,461
11,6,5,4,9,75373,27047,259,27093,498
15,2,13,1,10,854,854,97,1664,555
7,4,3,5,8,56371,64181,59,709,514
10,1,9,0,13,281727,0,0,0,568
24,9,15,0,14,734500,0,18,1028,457
7,3,4,2,16,10303,15161,62,10055,442
10,3,7,2,6,14388,10028,22,9400,451
25,14,11,10,16,174042,89595,22,26903,447
22,7,15,3,10,290678,14644,54,1405,520
16,8,8,0,20,270786,0,7,2462,528
10,5,5,4,12,111476,23981,50,512,455
15,8,7,7,13,31055,25004,83,6630,443
32,4,28,6,18,43925,40432,95,9904,446
34,10,24,3,12,451803,115639,109,68898,400
13,1,12,2,17,6959,10897,20,10450,566
12,6,6,7,12,58173,90178,214,36024,447
20,10,10,2,12,304393,9435,1,7936,460
10,4,6,0,12,217332,0,2,672,413
15,6,9,3,10,94016,36095,58,2551,523
10,6,4,2,20,392436,15454,29,7776,512
34,6,28,0,18,150332,0,0,2083,708
9,3,6,1,15,9941,4736,25,127,635
21,11,10,3,8,371713,343,49,220,549
19,6,13,0,12,77386,0,10,7998,479
12,7,5,0,16,309610,0,9,13289,587
37,8,29,7,28,92840,50331,446,4887,536
12,9,3,6,10,365076,69117,93,20672,489
18,4,14,1,31,514,218,26,13601,462
16,5,11,3,8,384127,32608,109,18153,512
21,12,9,1,11,136656,52,92,10421,380
29,12,17,0,15,690897,0,40,4259,621
13,7,6,6,16,138380,98522,44,16312,471
18,5,13,0,12,68698,0,51,2217,572
13,10,3,8,7,196044,76009,196,16029,413
19,7,12,3,14,168894,165812,109,53171,432
29,21,8,8,7,110625,39734,126,11398,417
8,6,2,3,22,331419,16601,38,9228,438
6,2,4,2,5,1684,1684,23,1072,398
10,2,8,1,12,3175,1790,8,8888,469
53,8,45,5,14,74581,50800,155,30122,481
30,11,19,4,18,2729464,39903,45,21782,504
14,10,4,8,8,299660,148735,95,6195,402
12,6,6,0,17,99638,0,5,1817,537
26,12,14,8,13,116185,31554,134,13377,415
27,9,18,6,7,23957,17118,95,4380,419
13,5,8,0,9,148998,0,0,0,696
19,9,10,6,9,81391,59245,62,922,469
12,9,3,2,4,723643,4619,8,35,371
23,1,22,0,5,38642,0,12,2222,668
5,2,3,1,5,1636,676,197,1958,533
7,4,3,2,4,22770,10673,24,4421,499
15,6,9,8,11,455428,757861,163,192939,454
15,7,8,6,19,107825,92688,46,9600,509
4,2,2,3,6,8085,20078,0,0,528
11,4,7,2,10,18447,9854,28,8490,532
7,5,2,0,5,47092,0,44,2340,493
18,8,10,1,16,666389,820,0,0,555
19,4,15,0,18,36759,0,141,1805,583
17,5,12,3,14,25724,24826,68,13971,505
51,13,38,12,6,181016,78971,236,47019,465
19,9,10,11,13,1257298,689563,30,33079,416
6,4,2,3,13,233069,233069,45,198089,499
31,8,23,4,12,23622,9522,67,6396,484
16,5,11,0,31,80547,0,63,0,570
22,14,8,5,10,157147,70282,62,23262,396
26,14,12,13,16,339141,121370,78,17071,373
13,8,5,1,10,189467,8064,14,8064,517
21,8,13,3,18,62228,12178,90,10984,477
20,4,16,5,9,171908,29013,61,6695,491
20,2,18,4,14,20584,22467,104,15495,541
16,11,5,7,11,298361,75706,48,21574,433
5,0,5,2,4,0,11140,0,0,522
39,20,19,13,15,2337416,315690,256,4362,454
10,3,7,0,17,13248,0,2,5914,612
6,3,3,4,11,8165,16788,42,2898,490
10,4,6,2,7,15188,2109,38,1299,513
19,6,13,4,6,31827,31827,95,4750,432
60,19,41,12,15,144188,87871,214,3319,425
9,4,5,1,9,50474,283,0,0,700
39,13,26,7,11,210416,113336,179,69487,481
53,15,38,13,11,727846,212440,235,26919,462
33,10,23,3,13,181151,8236,59,3110,489
10,2,8,0,7,70063,0,3,0,672
49,23,26,10,9,798241,436391,157,7101,439
9,2,7,1,12,66572,632,29,632,557
11,8,3,0,12,55028,0,17,12654,577
3,1,2,1,5,6190,6190,5,6190,584
9,2,7,1,9,3648,628,2,628,401
10,7,3,2,7,1949,21959,78,0,517
21,8,13,3,13,220342,110064,77,3327,524
16,11,5,9,10,69066,71196,140,9753,417
15,5,10,1,21,292196,512,15,7537,586
4,2,2,1,8,15252,4979,8,4980,485
6,3,3,3,3,7943,6052,31,2975,441
8,4,4,0,9,67075,0,16,0,678
135,8,127,3,11,53018,108000,69,7500,475
34,7,27,7,14,399650,370698,121,153929,430
32,7,25,2,16,228162,10195,118,7958,639
35,12,23,0,14,83821,0,3,2734,503
8,5,3,0,2,32935,0,15,1203,585
30,6,24,6,16,21882,19350,48,4299,457
17,5,12,4,13,35289,35288,64,9304,455
17,5,12,5,6,350366,217336,107,1681,486
9,7,2,6,12,20555,14798,0,0,514
24,7,17,2,11,57124,2595,3,3414,496
7,5,2,1,8,286841,44927,37,44927,449
11,8,3,0,7,180440,0,18,0,579
43,31,12,1,7,87242,450,33,4313,669
13,10,3,6,5,448659,22182,49,3896,467
6,3,3,4,14,3570,6708,76,995,535
9,7,2,5,5,60643,4587,20,1558,428
7,3,4,1,11,100415,3187,62,0,579
40,20,20,6,13,666756,56089,199,17850,425
4,2,2,0,3,13187,0,1,0,662
18,3,15,1,12,15385,2165,50,2888,498
25,11,14,9,19,243139,215705,37,7968,437
7,4,3,0,2,48060,0,3,0,547
12,5,7,5,14,35286,25519,106,23002,481
11,7,4,2,18,73462,4804,24,168,550
23,5,18,2,12,13688,11838,59,4066,383
20,9,11,0,12,788355,0,3,0,561
8,5,3,0,14,80195,0,0,0,688
11,7,4,0,17,3961,0,0,0,659
12,9,3,6,23,682221,61336,73,16669,425
12,5,7,0,7,11543,0,68,5310,597
12,3,9,6,6,16389,22673,96,14150,512
14,9,5,4,9,52227,8391,32,3565,501
4,2,2,2,19,533365,34332,25,0,540
23,4,19,2,10,13413,13413,45,7193,490
5,3,2,5,7,255907,386750,106,229789,416
14,10,4,10,10,57633,101549,159,43916,466
15,7,8,5,7,7981,7066,121,2100,535
12,7,5,8,13,65388,79422,90,20570,449
14,9,5,5,9,158601,77569,9,11871,522
10,2,8,3,10,38567,46403,62,17580,439
24,12,12,4,25,295154,10921,39,4462,430
17,8,9,8,8,85714,62002,147,11556,505
25,9,16,1,12,586980,5019,24,0,497
14,9,5,3,20,210921,22295,27,16064,546
32,13,19,1,17,695109,1309,401,13492,495
9,4,5,3,5,72748,2049,49,1113,480
25,16,9,0,26,1036496,0,13,250,663
31,5,26,7,11,70933,59234,133,19020,487
36,2,34,2,11,11350,11350,119,5826,651
26,7,19,7,12,416900,151921,66,38551,415
25,14,11,2,21,415459,2315,52,4274,497
3,1,2,0,11,850,0,0,143,645
9,6,3,5,9,90525,90525,68,18499,401
13,5,8,0,12,66290,0,0,1763,679
12,5,7,1,8,373129,22380,87,2642,469
19,4,15,4,8,46198,49771,95,0,514
17,5,12,2,9,470006,3367,26,1821,544
12,3,9,3,7,829,7245,51,424,516
8,1,7,0,11,7362,0,0,0,591
11,9,2,0,6,84433,0,0,0,662
14,9,5,3,18,50295,11790,57,3120,605
14,5,9,2,7,13170,113,19,99,623
29,3,26,0,6,215958,0,0,0,606
12,6,6,5,11,866652,629214,26,5140,446
13,4,9,3,8,147691,5175,0,0,466
31,9,22,6,15,87775,14902,110,6206,457
2,0,2,0,4,0,0,0,0,617
6,3,3,3,5,13322,13322,0,0,486
9,6,3,0,8,79877,0,9,222,572
5,2,3,2,6,12061,12061,4,8517,456
18,4,14,0,9,802595,0,5,0,584
7,3,4,1,5,17172,6088,23,6088,496
12,7,5,4,8,47547,11294,0,0,477
8,3,5,1,9,51181,4876,15,0,531
57,6,51,4,14,204763,25794,76,3791,507
19,6,13,6,7,75806,51017,295,15832,455
12,7,5,0,15,810207,0,4,0,582
19,9,10,9,10,159064,129399,19,6361,479
46,7,39,6,18,60369,62245,298,24785,386
15,4,11,2,8,6507,3469,142,3244,419
31,25,6,10,8,71012,33570,107,11027,406
39,6,33,6,10,60348,56407,328,19806,471
4,2,2,0,16,289237,0,0,212,643
8,4,4,3,14,439514,121962,69,96351,553
35,8,27,5,9,50966,26493,51,6220,403
64,11,53,8,9,99840,69417,249,23876,455
19,5,14,3,11,81844,81523,62,12346,492
48,15,33,13,14,330258,134144,140,36037,437
10,7,3,1,12,59014,23870,22,23870,508
26,6,20,2,13,65669,11754,48,11347,535
13,4,9,0,10,7038,0,16,1117,571
4,1,3,2,8,0,27749,15,0,654
27,7,20,7,8,440726,76188,35,9568,407
12,8,4,9,10,104700,116047,128,9895,447
16,6,10,0,18,114679,0,1,1204,535
20,6,14,1,14,250982,30172,15,2355,594
22,9,13,5,12,636104,7824,22,3065,440
17,7,10,4,9,27150,15987,27,10870,508
12,4,8,5,7,42873,42873,43,20811,488
16,5,11,2,17,15387,13739,41,9649,470
21,8,13,3,17,133824,2772,78,2232,465
5,3,2,1,7,15583,234,29,1957,450
8,3,5,2,7,12154,12154,45,11882,554
28,6,22,2,16,121710,17214,41,7647,527
12,7,5,2,9,52895,1809,90,2010,483
18,6,12,3,16,33547,7208,30,4676,466
11,4,7,1,16,277419,84423,37,0,582
17,4,13,1,14,11668,6667,39,18922,655
19,16,3,1,10,142335,560,8,0,596
14,12,2,12,8,91300,130126,30,27485,376
22,11,11,3,15,668534,4199,40,1572,509
7,1,6,0,11,0,0,0,3206,665
14,7,7,5,15,367704,121549,0,6321,494
21,9,12,0,13,144393,0,6,477,632
3,1,2,1,15,7765,7765,22,7765,522
9,7,2,4,7,12884,17653,66,1361,430
22,14,8,1,4,295785,889,0,0,528
14,6,8,5,12,473580,31265,110,12085,529
13,9,4,2,11,22665,35842,54,0,519
14,10,4,10,14,22964,22964,42,13944,496
28,12,16,10,17,56184,44506,556,13860,460
40,19,21,16,19,501557,257947,201,58491,412
6,3,3,3,14,41338,41338,43,23990,508
7,2,5,4,9,14526,16253,37,3112,507
12,4,8,0,16,252723,0,0,2473,661
13,6,7,5,7,148698,121122,111,457,570
7,4,3,0,14,115774,0,5,0,575
12,8,4,6,7,81528,81528,121,11543,470
9,2,7,1,20,0,59786,32,0,717
20,7,13,2,12,107797,11584,33,3841,450
20,10,10,5,69,796025,584227,91,4102,507
9,7,2,6,9,32351,32351,96,14227,561
14,5,9,5,12,59196,707498,70,3030,613
16,7,9,3,11,64814,48179,26,37800,503
22,3,19,0,16,32855,0,18,24041,541
12,9,3,10,8,69270,80517,135,27470,434
14,6,8,0,8,74918,0,0,4000,529
7,4,3,2,13,5124,4132,50,846,530
39,13,26,0,18,281332,0,1,3470,713
16,6,10,5,15,483237,20449,83,18330,411
32,4,28,6,9,100054,193245,69,13434,486
6,3,3,0,7,16745,0,18,663,604
14,3,11,4,15,336525,559919,54,1623,575
9,2,7,2,6,10644,10644,24,7200,623
23,14,9,4,7,307300,20783,54,9127,452
8,2,6,4,10,48761,61491,64,20962,523
11,4,7,3,21,141690,61870,81,5364,559
12,6,6,4,9,20975,14888,25,3525,460
5,1,4,2,11,5428,26323,0,0,549
14,4,10,4,14,45667,84378,13,1353,483
10,6,4,1,10,411093,1666,9,0,456
9,7,2,5,9,181474,38896,14,14690,418
24,8,16,0,19,73990,0,2,0,672
19,4,15,2,8,805201,132492,29,0,586
18,7,11,5,10,564060,21007,41,8997,433
17,7,10,5,13,68661,19927,61,10567,459
7,5,2,0,9,71951,0,24,0,617
23,6,17,8,8,35752,37317,345,3917,475
7,5,2,3,19,162519,158281,47,101698,612
22,8,14,8,14,95637,89034,215,32201,427
20,4,16,2,11,8506,8506,43,5243,543
4,1,3,2,7,1046,14549,15,1046,473
25,7,18,1,17,70451,6981,29,0,520
21,11,10,1,13,326108,498,27,13640,487
8,3,5,1,7,298795,18051,33,0,605
20,11,9,0,19,561124,0,7,0,539
11,5,6,4,13,237468,40918,30,10611,451
9,7,2,4,19,239226,50074,72,6190,476
36,21,15,6,20,438575,170292,129,11092,558
7,5,2,4,10,30147,29303,20,19825,496
80,6,74,2,14,25931,5475,3,4125,602
8,5,3,4,9,4980,4638,26,3260,433
38,15,23,16,10,211853,185748,74,33575,463
25,13,12,4,9,278027,42421,110,35082,390
5,3,2,2,10,6609,6609,7,5640,463
10,3,7,2,5,40469,37507,32,0,517
7,3,4,1,9,32540,7268,3,7268,486
7,3,4,3,9,2042,2042,76,937,555
13,6,7,1,4,312434,14434,1,14434,564
6,3,3,0,17,0,0,6,0,629
4,1,3,1,7,5608,5608,0,0,537
4,2,2,2,10,3619,21523,29,3619,658
16,6,10,6,11,73119,73119,52,34543,431
12,10,2,1,7,89336,1117,12,0,502
8,4,4,3,9,9063,9063,58,1843,509
20,5,15,1,11,231401,2741,8,9873,641
15,9,6,1,8,90755,200,35,200,547
36,19,17,8,15,320740,16139,146,16353,499
19,12,7,8,33,463583,59273,282,23654,384
18,8,10,4,15,875175,237066,84,31473,417
12,4,8,4,5,7262,13770,69,2705,479
19,11,8,6,16,357046,92448,139,9022,495
10,6,4,4,9,4792,4792,60,3644,401
19,9,10,6,17,1354900,58598,159,28616,420
33,15,18,11,7,63224,40169,292,12021,499
9,4,5,6,7,74794,65189,0,0,450
18,4,14,1,8,26835,1318,0,0,450
21,7,14,3,13,54728,24189,119,19042,473
20,7,13,5,7,251565,2007,102,304,514
45,8,37,3,18,126785,18845,302,17829,434
77,12,65,6,16,174817,23039,51,12617,460
26,6,20,6,11,14215,15367,54,3552,376
5,3,2,3,4,3390,2610,26,1868,443
7,4,3,4,9,85910,85910,19,58159,425
10,3,7,4,8,25169,43781,47,15662,489
15,9,6,1,10,1000438,470,2,340,522
21,5,16,5,13,217058,16440,54,5101,446
20,3,17,0,7,29211,0,46,2918,487
32,19,13,8,20,890842,88679,112,28279,435
21,4,17,0,5,194702,0,7,106,613
20,9,11,0,22,1802223,0,0,0,720
10,7,3,7,14,146363,93867,89,28379,501
8,3,5,1,33,1400,1400,65,16042,574
21,10,11,0,24,402613,0,5,0,598
6,4,2,3,12,5762,17205,32,1398,535
11,3,8,2,10,136088,19771,98,11962,476
6,1,5,1,11,7153,7153,32,0,555
22,10,12,7,15,41197,347340,176,8013,498
36,16,20,4,7,162353,4406,26,3776,526
17,5,12,7,7,80184,79571,70,20302,481
6,2,4,1,15,3481,3481,97,9598,540
14,11,3,0,10,1903073,0,36,12240,475
12,7,5,7,9,54807,47205,78,14327,417
15,7,8,0,7,115129,0,1,0,576
7,5,2,4,14,47001,47001,48,16881,475
14,8,6,4,10,83687,29080,82,14202,440
17,3,14,4,29,116,47913,69,4772,650
7,3,4,2,4,7555,7555,15,0,544
6,1,5,0,7,14700,0,0,0,607
11,4,7,1,12,407978,140127,8,0,473
51,7,44,1,18,183433,318,141,3042,599
88,11,77,5,14,63773,6619,49,6822,474
7,2,5,0,6,10240,0,12,1486,482
4,2,2,0,5,12650,0,16,1283,512
13,6,7,5,13,115207,113230,0,0,506
3,1,2,1,10,4124,4124,0,0,504
30,19,11,17,14,77615,49440,166,6185,437
10,4,6,4,9,36499,37391,42,13461,519
12,10,2,8,8,143331,111362,187,23735,517
18,5,13,5,14,368943,336337,140,25676,491
10,2,8,2,19,65549,30698,30,21194,627
17,6,11,3,9,11376,9301,51,866,508
163,12,151,11,14,85657,84922,179,8871,431
12,6,6,2,14,36998,55041,14,2708,526
11,6,5,6,7,43254,42863,59,10381,471
5,3,2,3,15,17873,17411,44,6510,443
18,12,6,7,8,135654,44759,293,14740,432
17,6,11,6,6,23820,30317,95,13887,521
25,9,16,5,14,24065,13846,56,9208,525
10,6,4,1,11,177724,5740,11,4002,521
8,6,2,3,6,27761,1069,79,973,478
26,8,18,0,10,271258,0,9,3784,615
9,2,7,0,2,14924,0,1,0,557
15,5,10,1,10,12140,3908,31,300,663
13,7,6,9,10,168066,232137,169,18093,491
12,10,2,2,6,210690,2200,6,0,525
10,8,2,0,7,8928,0,7,0,623
13,7,6,2,17,342477,5809,10,3239,492
34,10,24,10,23,1277974,1132067,212,331894,424
4,2,2,2,21,331889,72085,10,1044,461
12,5,7,2,13,4873,4873,44,4627,690
7,1,6,0,4,8939,0,11,4108,659
20,4,16,4,10,6623,3506,28,2839,520
49,7,42,6,14,95350,68234,71,5049,427
10,7,3,5,7,13608,13141,142,1341,427
12,7,5,1,20,276134,111942,0,5664,519
11,6,5,5,7,36595,30489,4,1340,441
10,7,3,5,11,81461,59747,0,0,509
11,4,7,2,9,285586,6532,39,3281,517
18,4,14,4,18,38757,49210,29,10429,471
36,12,24,0,20,365888,0,16,4200,437
11,3,8,3,8,992393,41433,51,790,496
14,9,5,0,16,518417,0,4,0,590
8,4,4,3,15,112882,108629,62,0,489
28,13,15,5,19,76866,47588,161,19181,545
24,10,14,3,9,403773,2906,204,1809,451
13,7,6,6,6,32326,8880,137,5671,424
10,6,4,5,10,422566,35660,95,0,458
22,14,8,7,12,52895,14888,70,24310,451
10,4,6,1,19,12632,2135,57,3996,526
32,12,20,3,12,249854,48507,55,7827,602
12,6,6,5,12,64639,105995,96,25838,424
16,6,10,0,13,284225,0,1,1599,562
16,8,8,1,11,482505,13687,20,13687,494
7,1,6,1,6,28400,733,45,2444,630
7,5,2,3,4,14440,4831,0,0,443
8,3,5,2,6,73729,24842,25,14768,579
25,11,14,7,10,90584,35426,108,21280,406
19,12,7,6,9,112314,59999,112,1867,438
23,8,15,2,48,129265,6804,104,15835,460
9,7,2,0,6,79919,0,0,0,653
7,2,5,2,4,3142,3142,17,1642,454
27,8,19,6,11,225436,46194,116,7921,455
10,5,5,1,10,74040,1831,15,1813,445
5,1,4,1,13,1206,1206,8,2826,505
10,4,6,4,9,179790,14360,66,6808,471
11,5,6,2,8,15734,9238,102,362,522
10,5,5,4,14,289067,21472,58,0,534
11,7,4,7,9,13077,10515,139,2872,471
8,3,5,0,11,54894,0,0,0,651
35,6,29,8,11,65092,128129,179,1320,439
10,7,3,1,15,397942,136711,23,136711,527
55,12,43,6,35,69611,37961,225,7525,455
8,5,3,2,13,35913,32317,16,916,544
7,3,4,4,12,216055,215693,15,1504,383
5,2,3,0,16,2761,0,0,1539,592
13,1,12,1,14,237945,2750,46,3868,657
11,6,5,0,10,5846,0,10,2502,658
57,8,49,5,9,26776,19076,238,7275,425
22,12,10,7,11,457464,25193,125,14622,419
20,5,15,0,9,92095,0,0,0,567
22,12,10,0,8,364779,0,25,739,663
15,9,6,1,20,2204687,4899,49,4899,587
45,23,22,1,24,5123547,7149,21,7149,561
14,6,8,1,14,81334,543,32,661,536
21,14,7,11,27,166812,145391,313,24322,515
22,7,15,5,10,26221,24776,91,11049,419
13,7,6,1,20,482529,46937,39,49208,530
12,5,7,1,11,325918,214893,29,214893,586
88,17,71,0,15,775112,0,68,725,520
105,15,90,11,36,391526,365434,237,26153,395
12,7,5,5,13,51464,71957,84,20487,495
11,7,4,5,21,24674,24459,101,10814,477
14,7,7,0,21,267196,0,0,0,590
7,3,4,4,7,27998,36177,83,17486,494
7,1,6,0,14,4246,0,0,0,676
14,8,6,1,15,156195,98407,0,0,522
7,3,4,2,15,20778,20778,119,18167,489
25,9,16,6,8,214470,76316,80,59829,472
43,8,35,2,17,627922,7193,50,7093,452
7,5,2,3,2,237095,4078,40,2517,417
13,4,9,2,8,248603,214152,71,1430,511
4,2,2,2,9,12083,12083,35,4718,462
40,16,24,4,10,92024,17240,4,8852,487
9,5,4,1,16,663304,65898,29,4682,656
24,10,14,8,18,264128,143026,188,44171,500
8,4,4,3,8,16020,13983,24,1905,519
6,2,4,2,14,3174,3174,24,2534,531
32,0,32,0,6,0,0,5,1878,606
5,3,2,1,5,40591,20335,11,20335,494
6,3,3,2,8,157137,11030,5,2903,553
16,6,10,1,17,234747,1912,44,1912,656
8,5,3,0,7,112713,0,0,0,716
14,11,3,6,21,697142,84056,97,1500,462
7,5,2,4,9,385889,25128,16,964,488
7,3,4,5,7,5078,17544,66,926,447
9,5,4,6,7,30403,44833,99,1365,450
15,5,10,8,13,67997,117478,145,38741,451
4,2,2,3,4,3635,4835,32,3286,497
4,2,2,2,12,72533,58380,15,50983,462
9,5,4,2,13,117363,629415,21,8859,465
8,3,5,4,9,82511,38890,62,0,472
11,3,8,0,9,244,0,0,647,638
44,5,39,3,17,22726,8449,49,6848,481
43,11,32,4,9,61114,16368,140,12952,486
11,6,5,2,19,180241,25093,72,4999,517
40,12,28,1,14,380433,717,9,2655,473
15,6,9,3,13,193933,29805,161,14373,463
14,8,6,1,9,11220,12903,14,0,583
35,9,26,2,29,985065,61442,79,5446,465
9,5,4,0,14,79568,0,38,261102,569
8,4,4,2,12,270865,3352,7,1879,463
13,9,4,1,21,1287279,800269,2,800269,641
6,3,3,3,13,35229,46567,54,23890,497
12,5,7,1,10,111357,825,34,825,598
19,4,15,1,15,149085,1053,16,1453,514
12,7,5,0,10,107395,0,0,1052,550
7,5,2,3,3,23339,13007,24,9837,484
15,6,9,4,9,41269,41269,148,28083,401
8,4,4,1,15,237329,53399,5,0,690
34,0,34,0,19,0,0,15,1777,665
15,10,5,2,25,7100,590,45,190,498
18,4,14,2,7,28107,521,6,1665,561
12,8,4,6,11,412128,47877,6,17683,453
3,0,3,2,15,0,31947,28,0,528
26,11,15,3,9,588912,29118,20,1872,466
14,8,6,1,14,343504,4749,0,125,628
40,9,31,1,12,281535,4973,12,4973,482
9,6,3,5,9,879047,659452,22,4949,451
17,8,9,6,12,298670,61909,102,15172,419
20,3,17,1,19,438344,15330,31,2182,627
104,10,94,2,26,754985,114032,66,9686,435
66,3,63,1,7,325115,3876,7,3876,479
24,4,20,2,7,40663,13835,57,5022,477
18,12,6,6,17,188875,85721,191,20988,513
105,4,101,0,19,69410,0,7,859,633
13,7,6,2,18,294768,160695,34,1000,538
14,3,11,5,9,61214,60982,0,0,499
20,15,5,12,7,880772,411431,82,249343,429
15,12,3,0,6,1770475,0,1,98,678
9,5,4,3,8,6339,7412,47,4009,496
7,5,2,6,6,33982,44307,45,16234,415
6,4,2,2,9,11348,402,30,4104,425
8,4,4,2,18,27223,26663,51,22144,432
16,4,12,2,14,27910,2428,108,14166,466
6,4,2,2,12,196264,6463,55,0,523
11,2,9,0,10,66255,0,2,0,643
20,5,15,5,8,29382,18947,124,13893,429
6,3,3,3,9,6592,4591,83,2058,495
8,1,7,1,4,20898,5563,10,0,639
20,12,8,5,19,336992,54042,166,2587,414
14,3,11,0,14,418912,0,5,0,597
14,8,6,7,11,171708,43426,38,1216,423
7,2,5,0,4,22042,0,0,0,558
14,5,9,2,12,7490,1721,141,2792,510
12,8,4,1,3,620170,1975,2,1975,435
11,6,5,5,18,685227,369112,4,2094,400
11,5,6,5,10,45757,65296,49,35401,406
23,11,12,2,13,278674,12222,11,40614,497
7,5,2,2,6,172628,5420,17,456,545
29,14,15,4,13,834135,302339,114,203690,446
6,4,2,3,12,318182,68280,109,24051,466
10,6,4,7,7,161402,122080,151,0,450
22,7,15,1,11,8764,10590,71,0,556
11,7,4,5,11,55520,4260,89,1200,470
28,2,26,1,7,1070,1070,19,1912,576
10,3,7,1,5,7802,1177,7,2363,522
33,16,17,11,15,1204343,468093,21,43235,427
7,5,2,5,35,21628,29041,48,9335,476
11,5,6,6,12,74627,74802,101,3999,451
8,4,4,0,8,462102,0,0,0,668
40,6,34,0,10,109838,0,4,9678,687
10,8,2,6,5,37003,62998,148,5455,414
26,10,16,3,8,91546,20174,72,10713,489
31,18,13,0,20,1137634,0,5,190,695
12,8,4,5,16,351016,22989,137,11045,400
19,4,15,0,13,337909,0,26,0,561
8,2,6,2,13,43566,43566,50,1600,493
29,12,17,10,11,128183,118452,225,8643,508
13,3,10,0,10,27130,0,0,0,625
4,2,2,1,8,670783,1063,5,0,567
7,3,4,2,10,13069,9460,54,0,470
13,6,7,5,12,82093,82193,110,39930,555
37,2,35,0,8,140023,0,30,0,475
23,7,16,0,8,255843,0,3,371,682
20,11,9,4,6,248758,5451,27,2515,470
11,4,7,1,18,23058,1490,41,1671,546
14,7,7,2,10,12459,6089,27,5034,426
114,9,105,0,8,158307,0,2,345,681
28,14,14,1,9,237970,32176,25,32176,549
9,6,3,2,7,18334,2474,26,3230,488
17,8,9,1,18,449814,1132,5,1132,580
82,42,40,5,17,1481536,18439,16,11747,400
16,10,6,6,9,290013,73081,14,6590,419
37,9,28,0,10,26828,0,54,1047,665
35,12,23,6,18,759840,375332,161,145557,434
19,8,11,6,19,1455700,251014,99,515,561
14,7,7,6,13,52488,28348,127,11238,459
8,4,4,4,7,40911,22425,77,14466,491
9,6,3,4,3,34866,24056,15,0,415
4,1,3,0,11,2569,0,0,0,652
14,5,9,3,9,437526,13931,91,9509,531
9,5,4,5,13,21559,42903,80,7415,485
13,1,12,2,18,0,103436,20,0,579
18,10,8,0,18,378618,0,1,0,704
10,3,7,6,13,168560,239659,44,6620,474
25,8,17,0,25,272199,0,24,9778,683
17,12,5,7,7,222234,11731,109,2388,391
20,7,13,1,11,427691,4189,29,4189,668
11,6,5,0,5,85407,0,28,0,453
22,10,12,8,8,56785,38818,69,6432,347
20,7,13,4,20,141913,28598,114,16210,488
6,4,2,1,23,57823,40080,25,40080,506
12,4,8,4,11,23243,22243,61,5609,481
8,4,4,2,6,41744,2544,2,895,470
115,10,105,4,8,95556,37870,192,28585,427
24,5,19,3,13,208601,24814,59,4457,464
5,2,3,1,10,3930,8856,30,1240,613
21,9,12,0,9,95217,0,1,3907,562
13,5,8,5,9,9317,26308,91,6818,392
11,5,6,5,11,28907,28907,85,7547,490
23,6,17,2,20,48721,10858,32,4732,633
3,0,3,2,7,0,56898,0,0,586
9,6,3,0,12,239123,0,0,0,704
10,8,2,0,12,52043,0,19,0,535
15,8,7,1,15,103209,625,4,0,494
15,7,8,2,14,57326,150,26,0,519
7,2,5,0,14,3177,0,4,0,708
9,3,6,0,4,20073,0,2,0,549
29,15,14,0,16,273488,0,32,3777,495
6,4,2,4,8,941830,229204,68,8410,491
16,6,10,5,10,11134,24593,108,3546,480
12,5,7,4,6,24157,5131,196,763,539
38,8,30,4,20,31472,21410,391,17939,501
27,6,21,2,7,44652,960,27,0,609
21,4,17,3,13,7671,7671,68,2224,435
16,6,10,6,16,21398,28070,64,3206,467
18,9,9,9,7,75789,74389,479,17431,426
25,8,17,8,8,370768,96356,102,1937,523
20,14,6,9,14,660995,317944,9,1680,469
39,6,33,5,9,66959,52401,302,18010,478
7,2,5,1,12,5724,5724,82,10677,528
39,19,20,18,18,2777028,3302691,386,423460,529
7,4,3,0,8,153103,0,0,0,641
11,8,3,8,8,544839,278250,164,0,508
7,4,3,1,15,171420,5172,3,5172,556
16,6,10,0,12,391289,0,8,448,608
12,3,9,4,7,6089,9853,79,4112,534
19,3,16,2,8,9382,8778,111,7518,459
7,3,4,0,12,647,0,37,2543,534
6,1,5,1,9,0,4134,52,0,557
42,7,35,3,13,213042,15500,37,10766,510
18,2,16,3,8,17804,12890,40,4248,526
13,5,8,4,13,93106,75946,30,53348,408
9,6,3,2,16,171637,20640,12,15770,489
28,5,23,6,15,614277,266536,142,31345,450
16,9,7,10,25,197132,158264,168,971,458
12,4,8,1,12,281041,10371,24,10371,551
11,5,6,3,9,367454,14015,39,0,477
9,2,7,0,12,8326,0,2,403,690
11,1,10,0,8,0,0,0,0,614
11,8,3,5,6,851066,77779,15,2711,463
24,7,17,3,9,98830,64117,9,45191,432
4,2,2,2,4,16518,15168,95,14718,492
16,9,7,3,15,194403,1742,0,732,497
27,11,16,3,22,558039,8069,141,6636,555
17,4,13,2,7,28827,6302,134,16217,579
12,10,2,0,9,73373,0,0,0,638
15,5,10,0,5,40120,0,8,0,553
11,4,7,4,7,11796,11796,66,4003,452
27,9,18,5,10,775394,681178,77,6670,469
31,17,14,11,14,262599,145902,111,31180,426
8,3,5,3,6,8344,30292,66,8000,493
28,10,18,9,10,270909,227514,112,11477,438
6,4,2,0,14,121092,0,1,1597,647
11,4,7,2,10,18447,9854,28,8490,532
20,7,13,6,15,15482,14903,126,4734,457
66,11,55,2,13,740126,21310,28,6804,469
13,10,3,7,6,31799,21642,94,3713,404
23,12,11,0,9,3207507,0,1,0,633
55,20,35,11,13,1249983,932820,156,15277,472
19,9,10,4,11,118312,19052,21,1431,516
35,8,27,3,16,721648,162102,78,282,529
5,2,3,0,18,477365,0,6,0,644
9,1,8,0,9,99833,0,43,1311,532
4,1,3,1,2,2170,2170,8,0,412
50,9,41,6,10,166009,33931,223,6544,449
50,6,44,3,14,153112,11663,18,1247,533
26,5,21,5,14,42626,42626,50,18145,455
28,6,22,1,5,40797,1900,5,2322,515
11,5,6,1,19,487527,579,26,579,528
17,1,16,1,9,2422,2422,22,2422,536
4,2,2,2,8,12458,6714,44,5582,447
5,2,3,3,4,42206,10618,26,3692,507
25,9,16,0,12,194003,0,5,209,609
5,1,4,1,6,6771,2038,9,733,457
8,4,4,2,8,15936,3446,28,0,577
4,0,4,1,7,8011,8011,0,0,507
9,7,2,0,10,29293,0,1,0,628
5,0,5,0,8,0,0,9,591,516
19,1,18,1,6,1670,5198,227,0,621
5,2,3,1,6,0,5002,92,7772,546
6,3,3,2,14,347438,45937,40,37471,640
4,2,2,1,3,58251,1589,3,1589,545
16,10,6,0,9,1175832,0,2,301,598
4,2,2,2,7,9312,17510,46,0,549
7,4,3,4,8,19090,27895,21,8664,579
15,7,8,1,21,14679,4155,79,0,493
29,14,15,18,13,490882,452708,364,25018,503
27,7,20,7,5,72888,68836,66,10032,405
25,7,18,4,8,533985,5342,18,3675,449
39,7,32,4,7,123468,32348,108,11323,477
10,6,4,3,8,79791,45787,19,2537,503
3,1,2,0,7,1534,0,5,221,636
8,6,2,1,2,87844,1040,9,1040,541
10,1,9,2,6,9767,23379,38,0,488
49,13,36,8,15,143282,36817,94,26203,426
14,4,10,4,13,21902,17747,49,2267,464
10,8,2,1,3,40275,1547,24,1547,504
20,4,16,0,11,70058,0,15,1296,590
36,5,31,3,11,50005,48745,181,36932,524
8,1,7,0,13,10800,0,8,947,636
14,8,6,3,15,472115,55938,24,0,447
24,10,14,4,21,45683,14753,76,10530,433
24,12,12,9,11,243465,156772,20,5542,478
12,5,7,10,10,62906,97011,0,0,487
9,6,3,1,4,31696,477,26,477,522
23,11,12,0,12,454535,0,0,0,610
5,2,3,1,3,26279,2594,8,0,479
21,8,13,4,9,54459,14026,74,1784,532
5,1,4,1,7,0,27858,39,342,539
14,6,8,2,11,74340,434,20,10495,616
5,2,3,1,18,13323,6125,15,28957,551
25,4,21,1,13,77530,4645,1,16360,583
8,4,4,1,8,21908,1484,16,0,528
20,10,10,8,9,268639,279995,112,8632,442
4,1,3,0,6,0,0,0,0,705
8,4,4,6,9,89791,102663,128,46603,506
14,5,9,0,5,62080,0,0,0,672
4,1,3,1,10,935,227,2,230,697
7,3,4,3,7,19812,19046,30,14625,567
40,3,37,2,15,6032,5957,235,8534,493
8,4,4,1,6,15896,958,11,227,505
65,14,51,2,20,412074,10201,11,8322,472
33,10,23,8,9,203152,243486,125,94210,419
8,6,2,2,9,140111,216202,46,133336,449
226,15,211,3,12,39629,2261,63,7886,504
11,1,10,0,17,177063,0,25,2076,679
12,8,4,6,7,34226,32639,44,9004,426
11,7,4,6,9,1142835,54278,4,3733,523
22,7,15,6,20,17345,11729,59,3117,437
55,8,47,4,13,161716,24187,13,971,524
5,1,4,1,9,31092,31092,2,3494,511
38,5,33,5,13,101739,72486,113,11702,500
11,5,6,0,10,60959,0,1,3103,559
8,2,6,2,22,286843,286843,47,202106,497
19,9,10,5,5,247715,191184,66,0,494
11,5,6,4,6,69735,5839,198,2783,361
4,1,3,0,12,254923,0,0,0,649
17,6,11,3,18,312730,12409,82,3761,468
12,10,2,8,5,70238,50063,119,9026,378
27,4,23,2,7,413456,11033,56,2003,509
20,9,11,9,4,21979,9874,150,1974,440
11,7,4,3,18,616378,29674,30,20469,425
12,4,8,2,13,27805,13754,48,8212,516
10,5,5,3,8,69716,39252,85,0,513
13,11,2,9,8,62901,62901,143,14749,426
16,6,10,7,12,76546,89026,161,2440,456
4,2,2,2,8,30130,27568,64,0,507
8,1,7,2,6,10580,10580,140,9917,592
20,6,14,3,15,327991,31304,41,27045,447
5,3,2,3,7,12222,11899,53,5494,450
12,7,5,2,6,66987,6037,52,1170,495
29,10,19,0,10,837276,0,2,0,590
10,8,2,9,17,2275606,1344461,156,0,540
27,13,14,10,11,49924,10466,89,3096,426
4,2,2,2,3,7135,4831,79,2719,457
16,9,7,1,12,787739,749,6,749,483
6,3,3,6,5,12360,49377,58,0,520
29,5,24,5,16,41192,36701,301,12405,486
16,13,3,2,26,61644,16254,76,9946,588
10,4,6,3,6,10363,14402,23,7159,545
48,19,29,6,11,438655,47901,300,42450,447
25,8,17,8,13,392838,53030,108,24730,466
8,6,2,6,4,33517,37995,199,16301,450
8,1,7,0,19,0,0,0,8687,663
9,3,6,3,8,14084,14084,315,12848,493
43,3,40,2,8,28591,23221,104,15042,645
8,4,4,3,11,389517,20893,74,75672,559
55,10,45,7,17,450107,83814,143,80130,453
8,3,5,0,7,52006,0,15,0,654
12,10,2,7,12,185285,174046,106,16614,370
28,14,14,7,7,252300,17050,60,3290,444
14,7,7,7,6,246085,138965,74,40562,419
12,4,8,0,14,400650,0,0,0,661
16,10,6,1,8,368896,925,15,1157,523
7,3,4,1,10,17904,6727,25,8352,636
68,3,65,1,8,14871,1930,31,5000,462
8,5,3,0,12,14302,0,4,0,548
108,11,97,5,17,355866,69885,120,0,453
8,5,3,3,7,2957,2957,40,799,513
67,9,58,5,9,127278,52629,106,5505,432
48,18,30,18,18,258817,135554,228,130786,421
25,15,10,1,17,67371,201,22,370,520
23,4,19,0,26,37138,0,2,1100,586
4,2,2,1,7,3711,1170,125,4481,573
5,3,2,3,10,285020,15704,28,5053,458
13,9,4,2,6,115913,10545,8,2248,522
11,7,4,6,9,225920,94372,100,0,423
30,3,27,4,19,23292,31040,56,16202,458
35,14,21,0,14,134826,0,41,3431,489
25,8,17,6,8,48555,39179,197,16642,473
6,4,2,3,10,501778,16688,61,8228,446
12,3,9,3,7,9384,12310,63,1228,491
21,2,19,3,6,33033,33033,62,21615,427
8,5,3,3,8,26002,18217,67,9569,468
23,6,17,2,17,57452,7348,25,48467,457
29,5,24,5,11,50896,43814,78,10614,496
14,5,9,0,4,96694,0,4,501,574
16,5,11,1,9,20212,4056,114,7720,431
9,2,7,1,8,11677,7795,95,15590,641
19,5,14,1,7,78761,5244,37,7100,535
28,5,23,2,13,15147,5674,118,6899,546
30,12,18,1,19,371452,5806,594,5806,524
7,1,6,2,20,67626,67626,15,600,591
17,5,12,3,7,20483,990,138,727,554
34,9,25,5,17,127726,47815,132,14069,432
23,6,17,2,14,32368,9706,16,6822,436
8,4,4,4,14,326816,48023,9,13726,535
42,5,37,1,11,83449,9176,54,9176,527
12,7,5,2,11,32978,8731,4,6702,474
4,2,2,1,7,13192,8872,224,14148,536
11,6,5,5,11,24981,68019,95,8638,561
50,20,30,0,17,1426566,0,5,0,595
15,6,9,1,28,247133,654,10,654,692
10,6,4,4,11,29116,7931,27,5588,478
6,4,2,2,28,2739672,2739671,33,3300,546
11,3,8,1,14,6477,538,22,538,534
8,3,5,0,6,148196,0,9,0,629
73,10,63,1,10,147494,809,68,6447,540
6,2,4,0,8,0,0,2,105,638
33,14,19,0,8,510971,0,0,0,683
16,6,10,4,28,32137,14478,62,7250,499
21,4,17,5,7,32504,33076,143,23106,492
12,2,10,4,8,231,60154,67,0,488
18,9,9,3,9,545094,72369,63,70969,471
30,8,22,3,8,210098,65804,88,8968,406
3,0,3,0,2,0,0,0,0,613
7,3,4,3,32,198087,275561,59,0,479
15,9,6,0,9,463348,0,9,1120,586
6,3,3,3,14,972216,317253,48,272317,628
8,2,6,1,6,63910,376,26,7234,460
18,9,9,5,18,3046730,92358,36,0,450
7,4,3,4,7,77441,40970,34,17526,504
12,5,7,1,10,52820,357,4,425,563
10,4,6,3,16,272113,23963,14,6200,494
31,22,9,0,11,2301779,0,10,711,426
12,2,10,3,9,6776,8369,59,6299,512
12,8,4,1,11,85776,9750,16,9750,466
16,5,11,2,14,156869,8483,30,413,497
14,5,9,5,18,31940,34270,61,30327,456
35,23,12,20,18,543474,352989,391,82888,445
12,4,8,1,13,234799,15642,40,120,496
13,8,5,0,6,17240,0,0,0,666
7,4,3,4,8,25821,25821,223,13039,439
16,11,5,9,6,92417,93496,175,30727,435
28,7,21,3,12,152219,74236,28,2745,452
13,3,10,2,7,54179,29231,26,0,474
22,7,15,3,10,70058,35380,61,4019,512
6,4,2,2,2,46746,681,12,561,549
7,5,2,3,11,21944,7799,8,587,478
37,9,28,11,10,68140,68283,191,19699,455
10,5,5,7,8,34619,27863,81,6508,428
4,1,3,0,18,372200,0,0,0,660
21,2,19,2,6,14817,14817,8,5605,450
24,7,17,4,18,323186,51247,53,24144,500
49,12,37,0,8,568752,0,7,0,562
25,11,14,0,15,1298484,0,4,0,596
16,8,8,6,13,245816,321995,170,237373,459
7,3,4,0,8,21292,0,0,0,621
5,3,2,4,7,27656,34220,135,13224,532
21,9,12,6,12,58418,26471,37,14840,460
15,10,5,4,12,299781,26865,40,13406,518
4,0,4,0,9,0,0,10,780,600
11,7,4,1,13,522187,11061,12,11061,589
5,2,3,1,6,1317,1317,23,1563,597
15,5,10,0,13,73750,0,0,618,604
9,3,6,2,16,127240,10488,37,7784,554
12,7,5,2,5,32850,1251,47,94,675
14,3,11,0,12,10419,0,19,702,632
5,3,2,0,2,14628,0,20,467,580
14,6,8,0,9,802055,0,5,0,597
37,6,31,4,13,127285,53619,150,1280,466
9,6,3,5,6,13819,13819,56,6710,428
11,5,6,4,8,16771,16373,137,9944,613
15,9,6,1,15,94222,6248,0,0,446
9,4,5,3,8,19886,20377,0,0,453
14,8,6,4,7,68585,8610,228,3575,454
19,9,10,3,10,157374,958,57,0,550
52,11,41,2,17,281441,7661,141,41927,501
18,8,10,9,13,373362,497858,123,174583,464
7,3,4,0,8,113493,0,6,0,525
11,7,4,0,8,250018,0,1,0,668
11,4,7,0,14,33758,0,2,0,574
10,5,5,6,10,13487,12198,115,4790,463
4,2,2,0,7,1858,0,7,349,609
11,5,6,3,13,68872,64609,46,0,499
12,4,8,0,6,0,0,1,192,642
24,13,11,0,8,664445,0,0,0,595
12,6,6,0,15,249968,0,0,0,654
16,5,11,2,13,548703,31593,52,33475,410
5,2,3,2,9,9561,7020,109,5940,498
8,6,2,7,5,44793,51253,157,0,487
29,12,17,1,14,684398,502,10,0,526
15,3,12,3,11,75405,75405,47,42315,504
3,1,2,2,5,13613,21571,22,13613,611
24,9,15,7,12,157190,101660,92,17682,427
4,1,3,3,6,3423,16150,36,0,603
52,28,24,1,16,6223912,727,38,1695,452
20,8,12,1,17,622629,85,64,0,476
8,4,4,3,6,36414,26411,30,18950,521
62,4,58,2,6,8096,1781,13,1062,396
8,4,4,0,12,19153,0,0,0,607
26,3,23,3,10,77700,77700,51,0,486
22,18,4,12,17,986010,301038,151,21712,373
30,14,16,0,16,301405,0,37,1960,593
13,4,9,1,24,4347,3766,13,2359,648
12,7,5,0,23,299379,0,0,0,630
17,3,14,0,17,10846,0,0,751,590
28,6,22,3,15,33338,22846,22,8222,488
13,2,11,1,5,30085,3000,108,4895,577
8,4,4,1,6,504262,2790,2,0,596
15,3,12,4,8,21232,27777,43,0,535
19,8,11,2,6,845212,18457,38,4979,437
8,4,4,3,7,120410,35326,82,8631,555
11,4,7,6,14,30314,64339,119,6351,465
14,1,13,1,12,18765,7338,16,11982,420
28,9,19,1,14,27120,1014,14,1014,510
9,7,2,2,8,373649,29881,6,0,469
15,10,5,0,17,331372,0,12,1727,589
8,4,4,1,6,24410,10374,35,0,514
34,24,10,1,19,728536,17,15,17,600
14,5,9,1,13,218833,401,14,0,496
4,2,2,4,5,23937,27321,59,14866,470
4,2,2,2,18,513604,63347,20,0,474
11,6,5,0,11,198331,0,14,3711,481
27,9,18,4,10,64438,5316,244,835,493
12,8,4,6,4,283083,129740,135,38313,517
13,1,12,0,14,0,0,12,6291,634
5,3,2,0,5,4762,0,0,0,658
16,12,4,4,12,67094,51233,21,1407,474
26,3,23,2,10,11660,9224,138,6899,426
10,5,5,5,19,218913,12480,24,2481,446
43,10,33,3,15,203308,6022,102,15878,423
29,6,23,1,11,85908,47456,154,50230,489
31,4,27,2,15,80055,12569,37,11214,545
19,5,14,4,10,29118,28738,52,10199,473
12,3,9,2,8,25473,11553,21,11386,471
5,1,4,2,12,6447,13334,29,6447,535
24,7,17,6,15,234556,232762,133,3533,525
11,8,3,0,8,90711,0,0,0,627
6,4,2,2,21,28706,28705,37,965,477
7,4,3,1,13,15085,1087,47,1087,532
23,8,15,8,8,63474,58587,415,8942,458
3,1,2,1,2,10457,5435,6,530,469
12,10,2,10,18,478397,423313,206,7534,434
22,7,15,0,16,540565,0,1,0,597
8,3,5,1,16,230965,8511,94,15459,521
8,6,2,5,11,80902,49520,30,22793,449
33,9,24,5,10,66006,20717,0,0,442
21,9,12,8,9,993022,106531,178,53844,418
8,2,6,1,8,11312,3301,24,300,420
15,8,7,0,21,15467,0,14,11778,573
12,5,7,1,9,897952,727,27,0,602
5,3,2,2,12,5203,10406,22,0,599
4,1,3,0,3,0,0,11,0,560
25,7,18,3,15,66005,42730,112,0,447
7,3,4,0,5,4827,0,94,594,618
10,6,4,3,8,767200,767200,108,0,526
8,2,6,2,5,49392,24162,43,19811,470
15,12,3,2,10,399242,2623,30,484,539
10,5,5,0,18,256948,0,0,1855,626
60,5,55,3,14,717837,106240,86,9244,449
6,3,3,3,5,23774,21188,49,2807,442
31,11,20,5,13,765277,203996,60,7012,444
5,3,2,3,8,25694,11663,88,0,624
10,7,3,0,20,124459,0,0,0,672
4,2,2,0,21,0,0,4,11300,657
9,5,4,4,11,26752,18975,43,9109,390
19,14,5,4,22,658231,48697,49,1999,487
11,6,5,4,12,57234,54108,34,35850,427
50,4,46,4,11,314754,24663,67,1367,500
36,7,29,5,9,82655,15980,57,7802,548
20,8,12,6,14,78547,78547,325,14286,447
32,15,17,6,11,1528442,180071,154,28394,443
10,4,6,6,5,39668,39475,84,2338,566
22,15,7,3,25,347284,10631,114,922,593
17,2,15,1,17,10436,10436,28,4884,477
37,8,29,1,8,115554,1009,8,1009,492
11,2,9,1,13,30979,27079,18,27079,481
8,2,6,2,26,33622,33622,25,29561,476
6,1,5,1,12,3163,3163,16,3163,597
23,11,12,0,9,1506167,0,9,176,552
13,9,4,8,14,385022,312577,182,82860,487
15,10,5,3,13,794852,32311,27,13825,505
5,1,4,1,8,1496,1496,38,1496,644
10,6,4,5,6,21274,14111,73,5028,592
11,4,7,1,16,45508,577,20,1689,535
9,6,3,4,9,90116,88250,94,37337,460
33,7,26,0,15,45512,0,5,656,625
8,6,2,3,15,41168,4285,61,2100,532
8,6,2,2,10,416243,73639,31,364,551
34,12,22,6,21,320793,71542,19,15919,503
4,2,2,0,3,11825,0,0,0,655
51,14,37,2,18,132143,124689,46,276,616
8,5,3,1,9,2591,1421,46,2511,513
16,12,4,2,20,1159224,3856,60,250,466
14,2,12,1,9,191578,18803,8,18803,559
7,2,5,1,4,9199,1575,13,0,503
11,6,5,1,6,220708,1737,3,1737,458
4,2,2,0,7,195828,0,0,0,664
11,8,3,4,15,316703,124530,38,0,446
22,10,12,3,18,238102,14542,44,720,639
38,5,33,3,8,37105,15780,73,0,451
23,5,18,2,11,43597,10165,37,74260,425
13,9,4,7,12,273264,81564,111,0,489
30,8,22,7,8,37396,37396,183,14728,433
22,6,16,3,12,30535,23522,16,10113,555
8,3,5,0,11,41767,0,0,590,600
9,6,3,5,9,10380,30178,202,7305,387
15,9,6,1,19,353443,467,2,467,478
47,14,33,7,20,491052,416709,0,0,495
8,4,4,1,6,18082,13081,23,13081,482
30,9,21,9,15,249035,188989,111,21379,441
13,8,5,0,8,435465,0,13,0,610
5,3,2,3,5,35730,35730,47,26705,524
3,0,3,1,18,0,33881,25,1845,633
6,4,2,0,12,59959,0,1,0,578
25,15,10,7,22,405896,34925,87,11091,495
4,2,2,2,5,178423,178423,1,336,499
5,2,3,2,14,23368,46204,38,2716,594
38,10,28,2,9,161977,6104,9,903,578
3,1,2,3,2,40,13469,16,0,570
51,10,41,10,19,553692,167550,275,49387,425
10,6,4,1,9,30025,15210,31,0,590
25,11,14,0,12,4857241,0,1,2253,687
6,3,3,3,12,15478,16060,24,7739,439
4,2,2,0,5,570746,0,1,0,602
8,4,4,1,9,291536,17896,26,0,596
8,4,4,6,4,44620,53120,111,0,490
20,3,17,2,14,19449,2568,101,9081,565
4,2,2,2,5,17743,14017,50,0,647
13,6,7,6,7,45856,45083,255,13702,458
13,6,7,5,7,58914,48564,67,34916,530
23,12,11,9,20,241427,54560,91,3720,436
19,10,9,0,23,58305,0,28,3621,523
48,13,35,5,13,1041528,53257,91,8620,450
11,5,6,9,11,1137770,162024,43,20493,450
19,7,12,3,20,69446,64416,104,1132,485
16,4,12,5,16,30616,35029,72,22437,523
31,5,26,4,9,21700,24307,140,8523,583
8,2,6,0,12,123191,0,2,2454,552
55,14,41,3,19,159225,9907,42,4860,421
19,11,8,1,8,429355,382,27,876,462
33,18,15,11,17,711858,248794,69,900,497
6,4,2,3,7,34308,33078,42,18335,452
5,3,2,1,9,256165,498,8,0,520
13,2,11,0,13,362774,0,0,0,504
10,3,7,2,5,24569,13855,26,5213,520
14,7,7,5,19,18549,18549,250,5976,439
19,6,13,2,19,74725,17033,17,0,591
11,7,4,6,16,583133,188075,109,6043,502
26,5,21,2,8,20953,9433,53,5962,489
7,5,2,6,6,31666,34429,310,10343,452
25,8,17,6,12,22204,21419,37,7722,442
4,2,2,2,9,18297,18297,0,0,521
46,5,41,7,11,59889,68027,317,30425,495
20,9,11,11,16,47749,48121,275,8653,464
10,3,7,2,4,15538,6091,0,0,504
7,4,3,6,7,19110,38931,78,0,463
5,2,3,2,8,9040,9040,44,7658,479
32,12,20,10,11,61754,70371,137,14862,467
9,5,4,5,8,428197,26385,38,7232,394
8,4,4,3,11,26351,26351,71,13644,446
30,12,18,5,15,416240,71594,299,3270,451
7,4,3,0,17,0,0,10,715,520
12,8,4,0,6,300575,0,0,650,583
38,11,27,10,19,301481,44388,242,5356,466
14,8,6,4,5,327515,28431,68,11632,408
26,14,12,5,7,408182,78151,73,3154,459
21,9,12,10,18,612009,159247,192,4497,468
12,3,9,1,8,20339,4549,12,1675,640
20,6,14,7,18,292595,29850,79,17644,473
10,6,4,1,14,31981,19942,23,19942,603
59,20,39,3,23,445525,10335,37,9924,607
29,5,24,2,11,67539,1261,237,2570,551
15,4,11,4,9,24968,47479,80,9339,494
8,6,2,0,13,68769,0,6,0,594
110,12,98,9,13,211059,175266,254,55756,447
50,16,34,12,11,58896,64801,349,8913,484
17,6,11,3,13,37533,12178,61,0,486
10,5,5,0,14,851125,0,46,3134,600
22,7,15,4,17,387724,23933,47,12291,467
26,9,17,0,25,216811,0,2,300,620
19,12,7,15,23,658320,981640,275,521014,358
76,9,67,2,11,150815,7994,13,7780,532
18,4,14,4,12,73983,38828,80,15749,464
22,4,18,2,10,21312,7774,22,7300,551
15,6,9,0,15,274708,0,0,0,631
55,9,46,0,17,169727,0,96,23216,444
10,8,2,6,13,11602,11571,56,1558,439
12,10,2,2,12,182820,5137,4,17750,510
51,18,33,16,18,1374576,951404,221,320934,476
45,7,38,1,7,259172,88,52,182,581
15,7,8,8,6,46956,87823,239,17800,439
3,1,2,1,6,4061,4061,33,4061,483
43,1,42,0,6,5636,0,2,4265,659
14,8,6,0,12,156334,0,0,129,622
10,5,5,4,6,23230,17831,214,7759,534
10,4,6,4,7,61423,24896,178,11506,416
12,9,3,0,10,39166,0,1,295,609
19,4,15,0,10,321534,0,2,0,603
15,3,12,1,14,2991,2991,82,1240,493
5,3,2,2,11,27007,27007,40,7144,509
33,11,22,1,8,330667,2461,49,2461,512
11,6,5,0,10,135507,0,4,301,544
14,5,9,1,18,242714,5745,37,364,554
17,8,9,1,19,206918,1562,92,9227,501
7,5,2,7,4,45980,43166,52,11942,461
33,6,27,2,12,302316,33178,34,25040,503
11,5,6,5,8,19564,22936,94,5048,405
13,7,6,7,7,131167,82814,112,14725,482
14,7,7,7,15,176983,159935,111,0,447
128,15,113,12,6,47730,38690,74,7205,384
71,28,43,21,14,1093021,528429,478,24374,383
16,4,12,0,9,34835,0,9,644,669
19,4,15,1,17,314947,976,8,976,468
9,3,6,4,18,153918,98018,31,85944,460
5,2,3,0,12,191080,0,31,466,631
15,10,5,8,12,130788,29846,161,0,510
20,12,8,12,7,98925,106052,480,20640,418
21,7,14,0,25,225054,0,4,3343,683
18,4,14,2,18,106668,45329,20,2349,581
4,2,2,1,8,71203,9242,0,0,625
21,8,13,5,12,162629,7510,92,12706,437
16,7,9,4,12,64247,15067,43,6595,428
10,3,7,2,9,39260,37937,104,31138,557
13,7,6,6,9,272831,21469,68,13912,480
8,4,4,3,18,24705,12531,64,0,647
65,22,43,8,9,167119,40083,61,6622,487
19,6,13,3,16,258493,53914,87,3877,521
15,3,12,0,15,294905,0,6,2040,497
20,4,16,2,8,336074,17230,21,14060,509
11,8,3,5,8,30923,3158,44,1161,541
6,4,2,1,5,27506,2290,13,2290,491
14,10,4,4,13,688159,147547,0,2452,501
8,5,3,0,28,109978,0,0,0,647
28,11,17,3,12,836872,142970,77,1687,446
8,1,7,3,8,171808,171808,20,0,612
10,6,4,1,25,738079,7210,20,0,453
12,5,7,2,9,41464,38121,43,37761,563
14,5,9,2,17,1552281,154733,53,0,467
5,1,4,0,13,6391,0,2,0,584
9,5,4,4,11,21560,16808,55,8478,498
39,7,32,2,17,85886,1604,39,1833,550
13,4,9,4,12,195253,44576,54,12910,517
43,27,16,1,8,465907,41020,20,41020,523
13,8,5,1,9,194733,976,39,0,501
4,2,2,1,8,316864,6941,6,6941,534
12,10,2,11,8,189343,189706,122,39772,481
69,9,60,6,10,106298,41978,49,11984,483
6,1,5,0,12,0,0,1,3530,655
13,4,9,3,9,178243,115852,0,0,525
14,8,6,6,25,645417,531167,114,11990,401
9,3,6,2,27,175134,13595,53,11115,656
8,5,3,5,16,308531,260200,0,0,481
5,3,2,0,14,0,0,32,0,468
16,8,8,4,17,250273,3900,24,1767,412
24,4,20,1,10,162066,7215,28,369,630
15,8,7,7,7,49358,57779,129,7004,418
40,3,37,2,13,1411,5821,63,28848,531
13,6,7,6,3,204820,17725,64,6240,449
8,3,5,1,69,30300,28705,25,1000,471
35,5,30,2,19,143403,59773,46,39563,526
37,12,25,0,13,88610,0,16,4386,616
7,2,5,0,5,2899,0,0,0,614
14,6,8,2,22,777522,25817,68,1332,552
3,1,2,1,5,21315,796,9,796,544
6,3,3,1,17,2100255,63926,30,342,639
16,3,13,3,13,67647,67647,86,52996,460
10,5,5,3,12,319703,193135,36,1203,497
19,9,10,7,14,81362,69360,82,0,471
9,6,3,4,16,177652,12368,18,2935,473
46,11,35,0,21,812747,0,13,0,418
11,6,5,5,21,144951,23079,82,5835,446
11,3,8,3,14,15014,15014,53,3841,488
37,4,33,2,8,46242,3714,41,3001,532
12,10,2,1,7,12421,4067,79,1000,464
27,17,10,3,5,502594,3421,52,5075,386
23,8,15,4,11,519124,53407,81,10102,458
354,17,337,6,15,587042,82769,182,10192,509
18,6,12,8,5,46398,41461,26,10286,412
10,6,4,4,12,155581,143908,102,68991,549
10,5,5,2,7,22664,5099,24,5213,557
6,4,2,1,7,66398,58259,0,0,463
20,4,16,2,20,551024,21735,146,6423,457
34,1,33,0,14,0,0,0,0,743
16,7,9,5,15,169781,143223,118,4488,430
6,4,2,3,9,91405,80490,39,0,548
34,4,30,1,16,384525,2503,0,1966,517
15,2,13,2,15,461526,20127,5,18638,486
9,6,3,3,12,224496,5263,12,8468,439
14,5,9,2,18,19792,101126,55,0,506
24,10,14,11,15,230432,49956,348,10901,407
9,7,2,2,5,73007,3413,19,1829,465
22,8,14,4,5,48868,24149,56,13402,433
16,9,7,1,12,759493,5459,30,0,490
25,6,19,2,25,830553,29269,35,3239,505
16,7,9,2,23,359598,50646,23,49450,652
7,2,5,1,8,26105,1817,0,4366,488
11,8,3,2,21,96605,47322,53,0,503
6,4,2,2,11,90845,14464,1,173,550
9,6,3,7,10,241024,235277,163,0,520
6,3,3,3,9,11027,6547,16,517,456
11,3,8,0,5,20718,0,0,0,607
24,13,11,0,16,569935,0,3,0,613
13,7,6,4,6,67916,6673,31,945,467
35,5,30,3,13,15503,15023,35,1508,478
7,4,3,1,19,10396,9627,24,9627,600
6,4,2,3,6,17759,25175,56,0,504
19,4,15,2,18,18337,10342,15,10002,534
10,6,4,3,10,10143,9143,52,2940,456
11,8,3,8,8,419412,123246,159,5145,518
53,3,50,1,9,20220,7774,34,7774,606
16,6,10,5,11,34957,34922,73,6800,439
27,9,18,0,5,47194,0,20,2452,464
14,11,3,10,45,196382,142931,43,62522,479
4,1,3,2,7,62728,65350,0,0,588
14,9,5,2,12,499447,45947,19,0,474
61,14,47,7,12,815403,165624,93,36739,427
6,4,2,5,7,16450,27480,23,7529,393
6,2,4,1,12,481,19,1,19,443
10,8,2,6,12,275192,61416,135,17848,579
11,7,4,2,14,81291,2375,9,0,494
21,9,12,7,15,427709,64273,106,0,484
14,4,10,0,12,43266,0,6,5303,559
8,3,5,0,5,27217,0,20,259,548
39,11,28,5,10,222314,18376,45,7932,495
19,9,10,8,6,23941,39383,368,8512,424
25,11,14,9,14,81188,51069,75,54590,427
13,9,4,4,12,328805,265438,31,0,517
10,3,7,2,20,3978,3330,15,3912,496
27,11,16,7,69,38724,31091,141,13030,529
16,9,7,3,14,144730,11516,0,0,469
17,7,10,6,7,19915,21658,166,9079,451
8,5,3,3,21,577742,376496,34,183006,507
8,5,3,0,8,16237,0,2,643,590
5,3,2,4,9,1232,13136,52,11905,431
14,6,8,6,12,35957,52310,98,12963,436
67,8,59,1,16,242771,5376,24,5376,555
9,5,4,2,9,238190,9171,40,6493,465
31,5,26,6,9,119210,33297,47,6662,384
8,1,7,1,19,1190,1190,19,12282,580
73,7,66,5,9,36681,23940,79,13840,429
22,11,11,2,12,174711,2832,24,1285,519
17,11,6,1,9,249892,14668,14,0,492
4,0,4,4,7,24851,91965,33,27251,613
16,9,7,2,7,435887,13389,40,7119,403
10,2,8,0,8,48576,0,18,12488,565
26,11,15,1,9,235831,246,63,0,448
24,9,15,0,26,169545,0,0,0,647
129,4,125,3,13,30767,10400,23,7267,468
63,9,54,3,8,138238,11665,57,5841,542
15,10,5,1,12,758556,36784,1,36784,462
17,5,12,3,11,50664,50664,66,28516,446
8,4,4,1,14,55725,42977,31,2599,518
8,4,4,4,6,27766,32273,50,16150,583
17,5,12,0,8,318518,0,8,0,596
23,8,15,6,14,83526,34084,17,21226,455
51,10,41,7,8,53201,21175,107,8161,446
28,17,11,12,5,1204784,63964,308,8996,420
15,7,8,4,9,62001,21659,21,1648,444
17,9,8,2,20,601279,26429,43,0,529
4,2,2,2,7,4597,9194,39,4918,500
39,10,29,7,12,96995,27061,94,10069,432
8,3,5,4,9,69439,26290,53,56626,496
21,3,18,0,11,40270,0,16,0,644
8,4,4,0,10,56269,0,2,12825,550
3,1,2,2,14,3427,9680,82,6253,600
36,9,27,5,8,112901,16539,180,5035,580
13,8,5,4,10,61644,24307,48,13243,435
13,5,8,2,13,226881,55935,56,3276,443
17,4,13,2,10,33293,7081,35,1870,462
6,1,5,0,9,0,0,72,1728,628
13,2,11,0,6,0,0,3,0,712
5,2,3,1,11,869,869,13,869,568
17,8,9,4,8,49214,7631,13,3922,462
7,4,3,0,9,192,0,22,0,519
8,4,4,1,6,53003,476,1,476,552
9,5,4,5,8,36450,25445,48,13217,417
8,3,5,0,12,28323,0,0,3373,647
10,5,5,3,10,60882,11525,0,0,542
16,5,11,3,9,70405,18927,59,15059,536
32,18,14,16,23,966748,1058995,345,0,457
18,9,9,6,11,163261,61259,62,12739,473
6,1,5,1,13,13064,3015,47,208,645
17,5,12,3,7,238691,32581,45,1630,515
18,6,12,5,11,223080,25951,66,9174,536
14,7,7,5,17,305450,16259,138,4979,465
7,5,2,6,19,584594,58087,62,6528,465
11,7,4,5,12,21842,22558,0,0,451
9,7,2,4,7,19212,7733,43,9922,443
22,8,14,4,19,407196,13971,47,8130,468
13,4,9,0,16,104724,0,8,0,700
22,11,11,3,20,183513,55439,46,28520,464
12,6,6,1,25,351547,1520,33,0,496
12,6,6,1,15,9377,8418,15,1618,513
62,11,51,4,19,92632,53100,164,27846,460
29,11,18,6,12,231843,23436,78,9230,482
9,6,3,6,7,26209,25729,100,11737,381
13,8,5,0,9,288519,0,0,0,604
6,4,2,2,16,71271,70147,32,43070,614
12,5,7,5,13,83731,73713,0,0,478
10,7,3,3,14,137771,49061,41,3567,566
12,4,8,0,25,240273,0,69,100,590
17,9,8,6,14,1150006,137825,169,8400,508
31,8,23,3,18,321017,12941,13,574,480
9,4,5,2,8,52639,18646,0,497,454
12,6,6,6,7,26594,25163,67,6743,442
7,5,2,2,11,448149,14946,52,3307,505
12,5,7,1,17,269817,23652,23,23652,581
110,23,87,4,15,660263,25453,67,8305,500
5,2,3,2,5,16732,16732,10,2696,401
17,6,11,5,16,155260,244969,11,70912,485
11,6,5,0,14,98725,0,5,4655,578
88,5,83,4,13,148052,134802,80,53315,549
18,6,12,5,9,55569,20118,430,13390,504
46,18,28,6,13,2061888,180632,180,18568,481
23,7,16,5,7,41798,32674,43,10186,485
13,9,4,4,14,191555,12799,25,1400,470
13,5,8,4,9,16711,33237,77,4228,493
37,9,28,8,17,55163,50474,169,18907,384
8,5,3,5,6,39919,11787,59,5233,490
13,10,3,9,18,676229,198784,0,0,457
15,6,9,3,5,17099,14432,66,5563,515
10,4,6,5,8,115768,118683,28,19891,370
8,5,3,0,27,513919,0,23,0,615
21,5,16,4,5,66121,10941,38,4050,443
30,10,20,10,11,110060,177052,131,126847,459
14,7,7,6,11,37826,35458,64,19129,403
96,7,89,4,13,29612,12306,80,7626,505
4,2,2,3,6,9844,10769,13,5515,441
34,13,21,2,15,830593,12351,9,9985,408
16,5,11,9,12,86500,172589,134,67743,508
9,6,3,6,9,226688,150343,111,266,476
12,4,8,3,5,8110,8110,56,8275,514
9,5,4,5,7,252114,254542,103,1279,462
9,3,6,1,12,225913,8184,0,8184,644
29,10,19,4,13,1399674,37363,58,1060,453
5,0,5,2,5,0,12041,23,0,570
8,4,4,3,10,40436,48418,49,946,541
12,9,3,8,7,169330,167067,149,9376,493
8,5,3,1,12,34531,12253,38,0,594
30,5,25,4,9,42251,76898,298,9396,462
21,9,12,6,11,44374,36463,347,20084,442
17,12,5,1,13,402886,1065,1,52,569
22,12,10,0,17,3265764,0,0,0,681
8,6,2,3,4,10267,732,128,1513,528
44,7,37,4,6,35661,12507,117,4007,448
13,7,6,7,6,22730,22730,116,8380,400
18,5,13,6,9,23226,40820,78,21794,493
7,3,4,1,14,11854,11854,32,11854,591
13,7,6,0,9,6673,0,3,0,683
20,9,11,7,14,38435,13009,41,9438,503
5,2,3,3,6,6146,6146,28,4960,523
14,9,5,2,10,209919,10015,27,9341,454
15,6,9,7,14,60266,70873,116,28095,447
10,7,3,5,13,18631,21891,84,7162,436
17,9,8,8,6,72641,58238,220,14535,406
39,6,33,3,10,560105,44739,27,1000,582
8,5,3,3,8,46265,46265,46,39757,463
63,11,52,5,18,95153,36355,380,23484,410
20,8,12,4,7,183589,28286,42,4957,529
8,2,6,0,11,8999,0,0,0,628
8,4,4,5,11,10993,26734,66,0,493
54,13,41,1,10,48012,8861,132,8861,471
40,7,33,4,13,384848,33146,103,7112,547
57,19,38,12,15,758201,86380,279,11105,399
21,7,14,6,25,564788,102895,10,3807,481
18,8,10,5,15,657823,493026,123,0,450
14,11,3,8,9,159206,86616,109,5705,451
9,5,4,0,5,285483,0,0,0,617
7,4,3,2,6,279556,1632,8,0,476
13,3,10,3,20,55713,76806,77,0,492
34,8,26,0,20,526128,0,33,88961,647
11,4,7,1,19,7222,7222,26,4370,549
56,4,52,4,12,15454,15088,86,3137,439
15,5,10,3,6,111419,23185,79,1330,462
4,1,3,0,14,0,0,0,0,625
9,4,5,1,9,39178,15,27,0,590
9,3,6,2,13,424499,4868,7,3606,613
23,10,13,0,7,31131,0,7,812,682
13,4,9,1,10,4009,3790,23,4388,516
20,11,9,4,18,215028,5665,44,3663,462
32,8,24,8,14,124273,109780,262,44175,375
26,11,15,7,10,385390,189785,21,4378,439
29,7,22,2,9,183198,21565,60,14864,603
12,5,7,3,5,11568,10950,30,9474,417
9,7,2,2,9,1307203,16404,8,9243,477
25,4,21,4,7,355973,23645,48,6151,455
12,7,5,2,13,74954,567,15,1562,547
16,3,13,1,5,373899,2605,169,0,445
20,9,11,9,15,157203,155743,21,1159,480
17,7,10,4,13,28570,16142,23,20171,487
11,6,5,5,5,103706,52293,232,31888,475
8,3,5,3,11,462835,26603,122,27086,486
20,14,6,7,7,894940,175883,57,19809,462
12,4,8,3,12,44697,77537,21,13514,458
9,6,3,6,12,102545,100196,110,598,455
12,7,5,0,6,201322,0,0,0,671
15,9,6,10,6,152146,117758,441,10820,405
32,10,22,4,12,159201,10570,49,2393,519
12,7,5,1,14,318567,11,11,9745,488
9,5,4,3,17,58579,33639,132,18016,455
62,9,53,1,8,184122,363,37,13790,421
3,0,3,1,4,20818,20818,7,0,498
15,2,13,3,7,797,10601,55,1800,605
24,8,16,3,17,77371,23893,17,584,450
20,6,14,0,8,91697,0,7,2284,512
52,11,41,5,26,154831,29178,78,2267,442
25,2,23,1,3,17915,1181,7,1558,485
4,0,4,2,4,79691,79691,16,0,477
18,6,12,6,8,32242,40004,347,12702,430
8,1,7,2,14,3375,6839,36,3464,624
8,5,3,1,13,59078,10211,14,1020,595
9,5,4,6,8,242214,274837,60,19592,481
61,12,49,8,6,242668,119773,54,50752,460
34,9,25,0,12,42108,0,20,120,725
10,2,8,1,10,6915,3765,10,3765,625
14,6,8,2,12,919294,3766,0,0,679
14,7,7,4,19,86476,41086,82,6353,421
13,7,6,2,15,524496,8522,43,11547,469
10,6,4,4,6,335305,18812,88,9361,454
7,5,2,5,9,62889,38665,62,4823,455
13,3,10,0,12,23215,0,12,5042,495
9,1,8,1,13,2007,2007,95,4007,489
25,4,21,2,10,20150,6289,88,0,457
30,7,23,3,10,53536,16064,87,7552,414
26,12,14,12,18,43269,60738,521,10760,384
8,4,4,4,13,61545,69487,65,31777,424
13,6,7,5,14,43742,39007,27,9868,450
16,2,14,2,10,14504,17834,29,17914,582
33,3,30,1,15,21702,18500,4,18500,478
10,5,5,1,13,502782,1621,125,14896,357
10,2,8,3,18,30441,30441,69,8270,481
12,4,8,3,12,53584,29960,20,28236,459
64,7,57,4,15,86988,43789,286,37130,463
18,4,14,5,24,219279,172847,65,72540,567
19,4,15,1,20,80374,80374,35,4326,578
3,1,2,2,3,6237,6237,21,4675,418
27,6,21,6,11,25123,19494,25,8100,446
98,18,80,1,19,640552,8640,22,1290,489
8,3,5,1,4,17137,478,5,478,484
31,4,27,1,16,16771,2955,25,2955,515
12,6,6,0,14,281532,0,5,0,615
13,4,9,0,5,2727,0,0,0,650
20,15,5,3,13,484731,18546,51,11928,462
19,11,8,1,7,457994,634,16,0,595
5,2,3,3,7,42327,42327,36,297,580
10,3,7,1,18,23381,26117,7,990,503
8,3,5,0,7,24671,0,1,0,707
15,4,11,2,16,13840,10369,45,1440,608
53,9,44,5,9,66568,40434,140,19150,478
4,2,2,1,5,10780,2949,3,2949,432
5,2,3,2,5,104598,98459,12,0,471
44,16,28,1,9,295780,7262,5,7262,500
10,6,4,0,9,232511,0,11,0,476
13,9,4,3,16,353123,25406,58,13102,464
11,6,5,3,10,56460,2885,62,2047,531
22,15,7,12,10,1994262,427025,71,9998,412
15,6,9,5,8,72363,71010,114,2364,548
18,10,8,0,14,63760,0,7,0,620
13,8,5,0,10,8324,0,19,2746,612
7,5,2,4,11,52603,40563,88,34948,495
8,4,4,2,8,22562,6929,13,5559,521
21,8,13,6,19,485911,16251,251,6505,447
14,4,10,2,10,51215,34203,11,22932,536
35,16,19,13,16,643855,187054,160,40475,478
8,6,2,0,11,1091542,0,5,0,678
16,1,15,0,11,2999,0,0,0,607
11,9,2,5,10,41875,15350,114,4375,436
21,12,9,8,22,687247,251326,194,60661,405
22,10,12,6,9,123214,72352,81,22600,482
8,3,5,3,7,53849,52109,46,0,467
23,12,11,1,12,799164,5653,7,754,512
11,4,7,4,9,75702,63883,6,24216,438
7,5,2,3,5,21686,9275,48,5497,485
23,5,18,6,8,47179,30439,86,12535,411
12,7,5,0,11,484665,0,7,0,646
8,0,8,0,14,0,0,0,0,517
6,3,3,0,7,619,0,0,0,694
5,2,3,0,7,0,0,3,0,620
6,4,2,0,4,82266,0,0,0,550
7,5,2,4,7,360748,70333,56,490,411
75,12,63,5,30,722052,39924,433,21087,477
24,7,17,8,17,268831,226495,115,128984,475
10,7,3,7,49,67659,77106,64,9745,457
5,3,2,0,7,11802,0,0,0,671
5,2,3,1,8,0,11760,13,11760,569
22,9,13,5,17,365017,22261,110,1041,573
21,6,15,2,14,24182,11295,168,8345,613
25,14,11,6,15,459990,36046,124,18955,456
14,8,6,3,26,243414,50000,101,28704,457
18,12,6,0,9,263207,0,6,0,594
9,4,5,3,12,12692,11692,34,4796,432
8,6,2,3,11,397676,31598,38,477,469
12,7,5,8,15,70712,37168,153,16834,439
12,8,4,7,6,97512,91506,105,9143,448
22,5,17,0,6,12992,0,168,39113,442
5,3,2,2,4,12326,12326,183,7051,474
27,14,13,8,23,100579,46068,149,12260,413
5,1,4,1,19,0,4707,25,88,662
4,2,2,1,12,1,1,47,6270,585
60,5,55,2,13,158728,160954,11,0,455
17,11,6,1,11,836503,22949,38,22949,516
13,6,7,8,17,110769,167124,18,4500,427
19,4,15,3,8,15244,12849,48,8923,467
3,1,2,1,8,7533,7533,25,516,485
6,2,4,0,8,10605,0,18,165,662
10,3,7,1,6,26868,1395,25,1395,612
6,1,5,0,7,0,0,0,0,617
16,8,8,8,20,94033,89029,100,45676,422
11,6,5,3,8,52695,24915,26,18381,465
6,4,2,1,23,37919,2230,2,0,652
11,3,8,0,14,22782,0,0,0,665
28,18,10,17,19,194956,199766,600,45524,425
6,4,2,2,7,63553,8795,13,8421,581
10,5,5,5,6,216058,216058,113,16760,477
18,10,8,6,19,390291,75609,184,31295,453
18,10,8,2,7,367173,6323,16,0,499
12,8,4,7,11,92744,58727,111,632,496
52,11,41,8,19,256230,51106,259,13454,453
10,7,3,2,5,582806,6771,0,0,455
13,6,7,1,15,912137,29799,17,0,555
27,10,17,3,10,244767,6056,72,2323,646
23,10,13,0,10,302707,0,15,70,675
10,7,3,0,13,280242,0,0,0,514
10,8,2,5,8,54699,31581,189,9720,413
71,12,59,3,14,120280,4802,143,3669,408
13,5,8,3,11,76228,44562,6,2123,525
92,17,75,6,15,314358,11608,47,2792,535
71,13,58,5,17,1158155,76906,43,10934,480
14,9,5,1,23,238976,367,0,0,632
23,5,18,0,19,109448,0,22,874,584
37,14,23,4,26,371033,140699,223,170895,435
6,3,3,4,7,6719,104487,52,3875,515
21,5,16,2,8,26547,25642,154,21099,590
13,0,13,1,8,0,9077,0,0,570
13,6,7,8,19,838580,294207,96,0,450
8,5,3,4,15,27567,13094,31,3585,494
4,2,2,1,11,3821,3624,0,0,636
21,4,17,3,6,29381,12561,19,2745,630
20,5,15,1,13,286648,11717,22,11717,614
8,5,3,6,9,33058,30798,118,6836,513
11,8,3,9,6,90298,87428,164,2980,506
17,9,8,12,9,198650,256591,249,95711,442
19,7,12,1,13,452512,2580,1,2580,524
23,6,17,1,6,65054,6263,55,6263,526
21,8,13,3,20,349339,8623,58,2387,615
34,12,22,14,15,314209,278445,288,0,452
7,2,5,1,13,3898,2258,22,400,522
12,7,5,2,8,1998613,32574,12,0,489
10,7,3,5,12,75511,81316,81,21054,455
16,5,11,1,20,770510,810,12,6009,514
4,2,2,0,3,7557,0,46,637,582
8,3,5,0,14,184036,0,0,8225,644
23,10,13,5,7,249097,1562,74,945,425
6,2,4,3,8,18588,18588,46,1440,449
5,3,2,3,17,25417,25417,192,13116,481
10,4,6,2,9,7991,14270,69,3155,474
4,2,2,4,4,17844,22181,34,8192,481
8,4,4,6,7,47053,70958,90,21637,386
119,7,112,1,7,67344,313,166,1296,552
10,6,4,4,19,258956,258956,165,12077,607
31,14,17,12,14,528756,225650,203,31992,340
45,16,29,0,18,476817,0,5,98,655
12,5,7,4,8,10392,12504,47,6583,428
14,3,11,2,10,70316,110237,0,1223,566
11,6,5,3,14,38156,36070,28,13392,592
26,18,8,0,10,1391287,0,1,0,571
16,8,8,4,13,477824,15752,54,6810,497
26,7,19,0,11,576577,0,5,1371,561
9,4,5,4,5,351292,18222,53,0,515
14,10,4,0,14,747691,0,3,1837,608
21,11,10,15,19,182579,256712,266,66714,469
16,3,13,3,8,91705,11581,44,680,462
8,4,4,5,5,59113,59494,36,53850,456
20,7,13,2,13,254229,72112,8,0,470
25,9,16,1,10,88206,390,14,4721,589
7,3,4,0,8,73224,0,0,0,610
11,6,5,6,19,174236,173110,118,30131,539
3,1,2,1,2,19787,4108,10,4108,594
10,6,4,4,7,27582,14122,102,3296,533
20,6,14,4,8,108798,16371,77,3000,488
19,8,11,5,15,1685919,129198,81,77079,447
12,6,6,2,13,250810,138079,49,0,474
12,3,9,0,17,1904,0,19,1643,535
9,7,2,4,13,873931,485111,104,20651,481
12,5,7,1,9,9861,952,2,1110,528
12,6,6,6,14,104998,104540,64,5382,428
7,4,3,2,6,11198,7784,45,10160,460
8,6,2,2,8,283357,17256,9,158,605
33,7,26,5,9,28843,18376,192,14744,492
8,4,4,1,11,118215,118215,28,10809,551
49,8,41,7,16,204061,44662,139,19055,461
19,10,9,1,21,28447,7723,50,5306,469
14,5,9,1,10,376395,15078,41,0,604
36,12,24,9,14,638678,86558,92,2586,454
10,6,4,6,5,24066,19282,209,12550,372
26,9,17,0,21,1747334,0,0,0,513
32,10,22,0,14,152394,0,11,3410,667
8,4,4,2,23,69139,24912,28,15922,527
12,7,5,1,10,326752,11442,35,0,514
17,6,11,0,18,447060,0,34,4257,541
135,20,115,3,14,348925,56049,82,2526,447
7,2,5,1,13,115094,1980,8,0,505
23,9,14,6,9,59672,47955,230,22170,428
5,2,3,3,13,10820,10820,32,5806,537
7,3,4,1,9,72843,2020,2,0,681
11,5,6,3,14,54466,11773,26,6731,392
7,4,3,3,10,89817,63730,53,62659,494
6,4,2,4,8,13409,13409,30,8488,453
110,6,104,1,15,63145,2883,15,2883,567
9,4,5,0,16,112317,0,0,0,702
20,8,12,3,22,222965,9158,19,8006,561
29,6,23,3,12,81959,8341,115,5049,445
36,6,30,7,32,21457,53134,250,7436,489
12,6,6,3,12,541889,29835,45,6234,489
18,8,10,6,15,173696,30322,88,4212,523
14,5,9,5,21,30442,37786,77,13603,451
6,3,3,1,7,10879,750,13,1662,484
17,1,16,2,14,0,16419,39,504,658
31,6,25,2,7,126022,22960,75,9800,438
4,2,2,3,6,9844,10769,13,5515,441
13,8,5,1,15,325764,12854,32,12854,547
27,16,11,9,9,765635,401027,188,16843,488
21,2,19,3,8,1745,5479,158,3612,475
4,2,2,1,9,11226,6263,31,0,499
16,6,10,7,13,41890,43896,126,4760,375
8,4,4,0,22,262385,0,2,0,635
31,7,24,6,15,403188,22094,64,15000,438
15,5,10,2,14,634997,13679,19,9805,563
44,38,6,2,6,70297,14700,37,0,464
65,11,54,10,13,94415,65962,166,18746,471
4,1,3,0,12,3878,0,0,6050,682
34,13,21,1,18,1798834,5373,42,5373,604
24,3,21,2,14,6688,6688,170,6119,540
18,6,12,7,7,30508,32234,119,13670,447
9,4,5,4,9,497367,211456,95,98009,494
24,10,14,9,11,601512,114458,148,30362,403
15,4,11,2,10,60004,47491,92,14238,408
22,6,16,0,11,331019,0,0,0,635
23,16,7,0,16,1385677,0,17,912,517
16,11,5,7,18,521785,651380,186,4420,501
14,6,8,1,21,374755,781,49,5448,480
17,6,11,2,9,112603,858,31,4690,466
5,3,2,2,3,62726,35617,17,24985,526
21,12,9,13,14,414964,488030,193,168814,395
7,3,4,5,9,57307,61553,0,0,450
18,10,8,0,7,86492,0,146,1956,517
20,9,11,5,6,186556,57088,33,41851,442
10,4,6,4,17,0,50753,1,5721,505
4,2,2,2,4,277418,25765,34,0,524
21,6,15,4,13,58942,11129,24,3816,383
12,5,7,1,7,29495,800,83,335,529
33,5,28,4,10,132771,115661,95,0,451
20,7,13,5,14,75987,35445,63,8316,460
5,0,5,1,21,0,7233,23,0,501
7,3,4,2,10,29707,9742,38,5998,597
52,20,32,12,10,732695,99995,503,15922,406
7,5,2,3,6,19522,41433,51,0,480
9,7,2,1,17,522365,3085,4,7399,492
7,4,3,4,5,15983,24040,48,9439,497
4,2,2,2,3,2170,2170,6,1085,536
13,3,10,0,13,2751,0,0,2848,637
17,4,13,3,7,8760,8174,58,6348,569
29,7,22,2,10,45198,2751,97,1300,489
43,7,36,2,11,40198,7279,21,4443,426
6,2,4,0,8,195,0,0,0,564
5,3,2,0,11,23216,0,4,3103,648
5,3,2,1,7,597,597,14,597,569
9,5,4,5,8,14433,11769,66,4794,484
12,6,6,3,10,316778,17127,42,0,491
9,3,6,1,9,47863,768,5,0,550
14,8,6,4,10,386111,16218,149,527,455
57,15,42,2,11,510186,7380,112,8436,498
13,2,11,3,13,5705,5897,117,5513,508
8,5,3,0,4,53094,0,10,2205,507
5,3,2,0,2,11154,0,3,195,672
17,5,12,3,20,285358,19090,73,11215,414
10,5,5,0,11,33441,0,2,379,639
16,7,9,9,12,67806,66921,106,22680,415
26,13,13,0,7,682031,0,0,0,584
17,9,8,1,16,1096380,298,18,0,574
71,5,66,3,10,22963,11763,19,2200,481
8,1,7,0,6,4927,0,0,0,665
9,5,4,5,9,22644,21640,38,0,512
25,11,14,1,14,707052,210,48,6273,648
25,5,20,4,8,113339,33644,65,16986,504
13,4,9,3,8,23342,16599,207,14699,474
13,9,4,0,18,240412,0,12,0,612
17,13,4,8,8,1133040,929938,27,266067,449
62,8,54,2,11,325611,2490,95,4242,444
8,4,4,4,17,36536,28014,37,14400,433
13,9,4,0,10,304688,0,3,0,496
13,9,4,6,6,18583,28561,96,10546,388
9,7,2,5,9,225701,19954,49,8604,392
12,10,2,1,16,499662,419,4,1894,517
13,5,8,3,12,74947,27360,32,9997,590
6,3,3,3,3,26288,20175,59,18473,455
4,2,2,1,21,8152,29834,15,0,558
18,12,6,7,26,53960,12021,92,3608,449
26,10,16,4,14,26044,10573,32,4140,543
13,6,7,5,6,284835,24818,8,3173,471
18,4,14,4,19,51223,27576,61,7869,511
25,18,7,13,19,161704,22388,90,13125,460
29,13,16,1,24,202470,2924,120,1066432,449
19,5,14,0,19,339493,0,0,451,604
23,6,17,1,11,20222,101,54,2833,560
14,7,7,5,8,61808,45186,158,18591,378
11,4,7,6,12,134691,159625,124,33818,525
10,3,7,3,10,10329,13912,70,3499,522
8,3,5,0,9,25664,0,0,0,587
11,7,4,0,4,52188,0,0,0,625
12,9,3,8,21,245049,116546,95,0,517
38,4,34,4,4,16390,12903,15,7280,525
36,14,22,4,22,1067721,4318,45,6822,448
10,4,6,3,16,446205,19898,76,11432,499
14,8,6,8,11,141477,29179,1,5085,462
11,5,6,2,12,283641,22515,21,0,527
12,7,5,8,7,69858,105743,127,29422,464
10,5,5,3,13,844636,20891,48,7716,446
10,4,6,0,17,335731,0,0,0,690
7,5,2,5,8,585210,21905,116,4581,469
17,7,10,3,18,336448,22898,3,3429,453
9,1,8,1,7,3934,10731,0,0,638
10,4,6,3,8,5387,9334,29,0,578
67,5,62,7,15,80436,68400,69,9999,511
8,6,2,2,5,14882,4139,83,2077,621
6,3,3,2,4,412037,33069,100,7724,472
11,6,5,4,11,420148,14207,97,5744,467
8,2,6,1,10,272762,6213,7,6213,580
7,5,2,2,13,20129,19407,57,16927,525
20,11,9,6,12,562283,27055,106,10335,394
27,7,20,4,9,88292,34762,91,0,486
27,9,18,2,10,15509,1500,106,1268,504
5,3,2,3,8,17737,17737,95,4487,506
6,2,4,4,9,24333,30753,58,1628,525
7,2,5,0,12,12792,0,12,0,507
22,7,15,5,19,22246,20057,62,4500,417
4,2,2,1,15,205809,20987,25,0,647
8,4,4,5,4,134037,97137,78,7225,445
27,8,19,8,9,101446,41361,128,7918,561
21,8,13,3,14,359668,10693,74,7393,436
25,8,17,3,12,33295,5359,140,3942,499
13,9,4,2,31,10633,6454,0,2328,554
10,2,8,1,10,79051,52438,33,1363,537
45,11,34,6,8,51941,32687,207,9098,478
8,4,4,2,6,380689,20775,33,1162,514
110,5,105,3,11,40976,52401,13,19836,576
211,9,202,2,10,64345,5028,97,4592,454
15,5,10,0,5,81032,0,35,0,509
10,4,6,3,7,39141,33861,72,17012,478
8,5,3,1,11,164331,4421,25,4421,629
66,15,51,10,18,2667127,395484,275,21586,456
4,2,2,0,16,395742,0,0,0,571
20,12,8,9,8,56753,41624,205,6812,411
32,21,11,13,26,247406,402321,212,19104,489
39,8,31,1,12,58497,50,75,855,510
4,1,3,0,14,0,0,0,0,654
17,3,14,4,8,18218,14946,130,8816,449
10,2,8,0,14,15474,0,1,1774,620
14,6,8,5,18,856787,59498,99,41221,394
7,3,4,1,6,8810,8068,24,8068,635
31,5,26,3,8,11132,19095,104,2245,488
4,2,2,2,5,5591,5591,27,3153,597
7,2,5,4,9,10729,57241,0,0,535
7,4,3,3,9,131478,13348,22,8595,505
9,7,2,0,18,2811900,0,1,0,699
23,6,17,4,69,459550,96251,279,12533,391
14,10,4,4,13,232810,27955,64,16708,353
16,6,10,0,13,593264,0,33,0,592
12,5,7,1,4,50395,362,1,362,520
5,2,3,2,15,13624,13624,46,7763,640
17,4,13,0,9,69174,0,22,272,563
144,7,137,0,11,19814,0,7,1603,543
8,5,3,1,18,67286,3501,3,3501,519
15,4,11,1,9,30094,23360,10,0,560
7,3,4,2,11,23529,1332,21,666,443
12,8,4,0,69,356517,0,7,1147,468
14,7,7,3,15,74703,2678,45,2269,440
17,11,6,0,8,437953,0,0,0,637
15,11,4,10,12,92826,109925,172,36252,416
24,8,16,1,13,230993,32859,54,2798,635
7,5,2,3,6,44778,10059,30,958,464
12,8,4,1,5,578033,501,10,0,616
17,8,9,5,11,325819,50139,80,108979,446
16,4,12,6,20,509827,585612,133,139318,535
19,7,12,7,12,23241,29500,75,9539,415
2,0,2,0,5,0,0,1,0,687
10,2,8,0,9,17854,0,4,3133,574
16,9,7,0,4,115166,0,0,1207,576
5,1,4,0,5,9694,0,184,3536,621
21,3,18,3,11,4316,4316,21,5312,513
6,3,3,3,16,879242,946535,61,611336,522
17,3,14,5,21,95806,58856,147,4743,506
13,9,4,8,9,73059,70407,393,21224,498
10,2,8,4,9,47588,49186,66,0,473
10,4,6,2,11,8672,26490,76,0,516
41,9,32,0,13,72737,0,24,998,555
10,5,5,4,18,154450,30294,97,57831,523
18,7,11,4,16,213953,96453,60,25844,469
13,4,9,5,12,71114,21983,9,3649,515
5,2,3,3,18,6488,46930,98,0,651
12,10,2,0,8,295717,0,3,0,538
4,1,3,1,19,7934,4114,20,4114,609
3,1,2,1,12,5943,1057,25,0,510
10,6,4,6,8,96897,88386,4,959,437
29,13,16,0,16,960345,0,27,52274,645
11,4,7,3,7,19138,19138,322,9453,490
12,6,6,1,14,178239,2037,18,6705,609
9,1,8,3,8,22443,23754,0,0,511
5,3,2,3,9,14525,16519,30,2360,459
19,8,11,0,6,105511,0,0,0,579
18,9,9,4,9,299657,20303,373,17700,517
10,4,6,2,12,292983,4471,12,2504,520
7,4,3,4,18,20674,20674,85,12502,530
9,5,4,0,8,1130804,0,0,0,678
7,5,2,3,12,66223,44434,67,15176,412
11,7,4,1,10,323661,1403,3,3043,443
17,4,13,8,8,142864,217912,209,17886,521
35,7,28,4,13,27628,16570,83,10950,460
9,5,4,3,5,49575,48156,43,559,489
22,14,8,0,14,569814,0,0,10,586
9,3,6,2,11,649637,11323,26,11223,430
18,10,8,9,12,121171,100837,186,5337,472
16,9,7,0,8,1111283,0,2,0,506
20,5,15,1,12,33226,9770,103,15570,535
8,4,4,3,5,22145,21023,31,4164,464
18,7,11,5,14,218198,172858,67,53903,486
6,1,5,0,6,0,0,4,0,657
24,15,9,10,11,87854,84973,19,14163,418
40,7,33,1,13,125989,23924,48,2896,554
19,4,15,3,13,18800,6544,32,3190,446
8,6,2,1,19,502570,10257,0,0,489
4,1,3,1,11,110966,33566,9,0,459
23,16,7,0,28,938026,0,13,0,547
16,7,9,6,10,438390,90628,93,19046,450
13,3,10,1,11,63109,300,9,3886,523
19,12,7,2,14,64358,6212,40,11205,509
79,11,68,9,9,47525,38364,459,12580,431
8,6,2,5,25,8730,5892,101,971,426
30,18,12,2,21,860221,96039,90,5654,504
9,4,5,2,13,270511,27341,3,17097,459
20,3,17,3,7,17014,5407,105,5021,452
3,1,2,0,14,0,0,0,871,669
11,6,5,6,9,376630,30647,32,3050,442
17,5,12,3,17,258399,13054,42,6372,549
5,2,3,3,9,5742,9742,39,25084,465
19,9,10,1,12,587643,26775,67,26775,519
11,7,4,5,7,472698,42665,207,26755,556
7,3,4,2,7,3903,3021,0,0,522
9,6,3,5,12,428330,127526,24,22136,428
10,4,6,3,5,43286,7013,61,4874,443
5,2,3,2,6,1076,1076,26,0,492
7,1,6,1,6,28317,18153,14,112005,515
17,9,8,5,13,225211,66147,40,14783,483
10,6,4,2,13,536129,15138,1,9263,475
18,11,7,9,8,444029,99904,259,24275,441
6,3,3,0,8,76164,0,7,0,619
13,7,6,8,8,35811,35645,151,12234,452
10,6,4,4,15,549830,73159,137,29832,366
10,4,6,4,10,16822,11182,42,3429,621
36,12,24,12,22,401585,110489,332,35779,399
7,5,2,3,16,437895,80849,0,0,527
30,6,24,1,16,27342,3652,70,6938,512
16,9,7,11,12,163048,170581,202,59847,455
32,8,24,6,7,95908,19131,182,4627,455
14,6,8,5,12,123262,86126,81,2089,433
17,8,9,4,17,359076,49923,94,31588,346
23,15,8,11,17,521216,460998,106,3773,469
6,4,2,0,18,34466,0,29,0,544
17,2,15,2,8,4508,11343,30,834,539
9,7,2,7,12,37430,51731,0,0,448
13,8,5,6,5,70637,36342,92,932,460
22,5,17,5,4,19267,19267,214,8926,473
9,4,5,2,4,206025,6775,77,2226,444
6,4,2,1,17,478978,14067,22,10047,606
9,6,3,2,10,886809,48038,123,42868,518
22,4,18,2,14,810297,210879,90,3042,512
10,3,7,3,10,4433,9135,41,1845,570
10,5,5,2,3,29833,1499,57,707,517
20,10,10,1,27,452149,3513,1,0,688
9,4,5,3,7,11851,15326,32,6747,600
12,9,3,4,12,128318,55093,0,0,496
12,3,9,2,10,5676,6421,138,3363,425
27,8,19,0,10,418520,0,34,15510,412
16,4,12,2,8,5122,650,16,1481,676
70,18,52,5,15,307596,33343,84,6737,486
56,11,45,9,14,62808,159400,127,63786,412
33,10,23,5,17,126786,14340,66,4143,499
10,5,5,3,15,319731,3791,78,8405,498
10,7,3,6,7,54429,56036,111,23986,447
12,6,6,6,20,99332,99332,102,30778,367
157,5,152,1,16,21189,5467,34,1615,608
8,6,2,6,8,6372,6372,52,1892,445
65,10,55,1,9,431314,14107,21,14107,517
12,8,4,7,12,13946,20526,0,0,514
12,9,3,4,11,180346,33698,95,1229,521
18,8,10,8,19,44176,65290,371,25612,477
8,6,2,4,6,21571,17172,42,12736,472
17,8,9,0,8,319649,0,1,1624,664
16,1,15,2,10,58733,81194,46,0,481
51,17,34,3,10,89847,13171,45,10948,525
6,3,3,2,4,148004,4560,21,0,520
6,3,3,3,14,82301,89076,47,80301,534
23,10,13,8,19,3026631,977903,0,0,491
8,2,6,3,7,19911,23390,58,13281,474
51,32,19,1,21,2244344,51,8,450,542
7,4,3,2,4,227744,19638,75,734,444
8,6,2,5,4,31207,9799,64,4276,530
12,8,4,1,4,31939,850,1,744,442
12,3,9,2,7,91922,24774,40,9698,474
27,7,20,6,9,63311,46008,79,8887,387
18,7,11,4,9,41698,28623,96,14098,417
11,6,5,5,10,83740,81127,31,34749,434
8,3,5,2,8,43568,12207,103,11045,641
18,11,7,2,17,451155,8335,62,2820,480
38,7,31,7,8,103713,81093,119,25350,434
15,5,10,5,11,105781,28546,130,7468,385
8,5,3,0,4,48741,0,0,0,657
9,4,5,4,11,49368,59506,38,6470,482
13,3,10,0,13,19010,0,4,1775,453
34,18,16,3,15,380717,54198,47,46933,510
23,4,19,6,37,376296,23538,70,9255,451
42,7,35,2,12,140993,79503,33,79453,496
12,3,9,5,9,15477,21661,91,9098,512
53,7,46,7,10,25881,28892,424,15246,412
74,13,61,1,14,229206,1057,8,2275,527
34,12,22,10,21,367882,352361,135,0,501
7,4,3,4,9,9147,9147,93,2422,523
21,12,9,6,13,83776,46574,80,18865,446
26,8,18,1,14,367446,441,18,0,508
3,1,2,1,8,3095,3095,55,5400,517
10,8,2,2,8,19069,5431,4,5184,633
12,1,11,1,16,143906,1051,17,1051,610
8,3,5,2,9,83408,44164,71,2930,462
7,3,4,3,9,18353,7944,36,4380,525
15,12,3,12,21,640235,634787,281,22992,507
11,3,8,2,9,6792,5903,28,5600,395
17,11,6,9,14,109154,98037,110,31856,373
20,8,12,2,14,538751,24673,0,2208,524
10,5,5,1,15,39578,196,21,0,558
19,12,7,1,27,2126180,2681,3,469742,503
13,7,6,6,13,72287,54511,102,625,455
11,8,3,4,11,84601,40325,81,21661,474
11,7,4,4,12,223862,217231,65,116004,518
4,2,2,0,4,10201,0,5,0,604
15,4,11,0,13,93294,0,15,1200,640
12,6,6,1,3,48289,230,2,239,462
26,7,19,1,17,58714,102,27,3201,494
14,5,9,7,13,301467,64028,0,0,478
4,2,2,0,11,218005,0,0,681,559
6,2,4,2,6,17033,16827,24,16581,443
20,6,14,1,12,323377,2402,18,0,605
30,8,22,0,11,492828,0,11,359,612
10,4,6,2,7,201172,2384,25,8116,576
29,9,20,4,12,76152,26220,74,11949,481
5,2,3,4,3,24147,16637,17,9696,567
10,5,5,4,11,8562,8979,22,4961,438
14,3,11,3,7,8155,6940,25,5983,456
21,4,17,2,69,30875,56657,41,168,529
7,4,3,3,12,8187,8187,161,6218,501
54,13,41,13,16,336276,330646,379,51008,468
19,12,7,9,7,166508,183927,124,60930,396
7,4,3,5,10,274553,12991,47,1653,441
7,5,2,5,4,10140,10234,51,2489,443
14,5,9,0,5,62080,0,0,0,672
28,9,19,12,10,93731,112898,228,24467,465
8,5,3,1,10,341426,262578,24,262578,663
15,1,14,0,7,1749,0,2,987,677
12,7,5,5,4,50285,32899,36,18545,473
8,3,5,2,14,6166,6166,42,1826,439
8,4,4,2,8,97321,52356,9,10064,501
31,13,18,11,6,1420120,2357898,130,547017,484
12,5,7,7,10,35938,44164,113,12872,514
10,3,7,1,18,484,21597,34,0,644
25,12,13,5,15,1604027,110097,83,26884,408
23,6,17,2,14,44006,1891,36,1206,483
14,5,9,2,12,29298,5498,39,4421,553
19,6,13,6,18,104662,93998,116,40235,452
9,3,6,3,7,28184,28184,234,19538,485
10,5,5,4,11,37350,28187,95,24262,450
17,7,10,5,14,280256,83196,17,64162,446
17,6,11,3,14,62963,10779,29,4207,532
34,9,25,0,12,71584,0,0,0,581
25,14,11,5,13,297096,15417,79,4319,397
34,4,30,4,9,17795,19452,41,5784,451
10,8,2,7,6,121330,121330,93,37515,371
5,3,2,0,18,106176,0,1,24,584
24,12,12,1,16,387826,1088,19,322,583
29,2,27,2,19,297376,27186,26,17777,502
15,6,9,1,11,378506,1785,106,3828,543
9,4,5,3,18,77236,8929,63,3841,540
16,10,6,0,69,129518,0,1,230,561
16,5,11,2,10,401502,16870,48,3190,475
7,4,3,3,6,29882,30585,64,0,514
5,3,2,5,7,14455,62448,0,0,496
46,14,32,2,9,176330,2560,284,2100,485
19,8,11,0,8,316750,0,0,0,671
19,13,6,0,5,195976,0,0,0,587
50,10,40,4,12,136377,7439,8,4661,494
9,3,6,0,11,84596,0,12,0,595
10,4,6,0,13,33960,0,9,0,684
8,2,6,3,8,50522,77902,26,9514,451
8,2,6,1,9,5736,4443,14,12864,455
7,2,5,1,25,22856,15967,21,15967,678
10,7,3,5,11,60616,41499,39,5360,439
12,9,3,2,17,231218,2711,39,2204,450
34,8,26,2,17,100444,634,32,3050,521
8,6,2,5,8,49810,40802,0,0,451
5,3,2,1,11,7307,4885,56,0,566
7,3,4,1,11,136095,6982,19,3978,396
9,5,4,6,8,60071,52930,113,21102,447
10,5,5,0,17,70195,0,0,610,507
13,9,4,2,14,73728,5583,30,4758,446
7,2,5,0,18,206677,0,1,0,725
20,8,12,7,22,40746,36893,125,10767,445
6,3,3,2,12,121661,14777,46,7910,603
4,1,3,1,9,0,4950,0,299,620
15,5,10,0,16,27871,0,25,299,561
3,1,2,2,6,548,8372,0,0,506
34,5,29,3,9,334376,55497,75,3388,458
6,3,3,5,10,56354,57832,36,5619,499
7,3,4,2,8,56928,30117,29,477,461
60,36,24,1,24,5435943,2804,14,613,477
8,1,7,0,7,2576,0,20,0,654
11,7,4,4,5,66031,17308,55,11734,529
14,7,7,1,11,427712,7913,17,0,495
11,8,3,8,6,62045,59960,81,24007,417
5,3,2,3,7,20491,58730,51,0,501
5,3,2,2,3,11890,10572,15,0,465
7,4,3,3,15,18266,19725,21,0,546
20,8,12,4,18,713478,333701,87,155901,496
39,21,18,2,12,204819,3777,52,0,522
15,8,7,3,22,315376,19107,89,9170,436
18,5,13,0,11,1247,0,5,0,709
22,9,13,8,28,215263,49964,128,855,515
14,6,8,3,16,118586,19560,114,14500,400
27,7,20,1,8,74212,8006,56,8006,440
40,8,32,4,11,23839,13876,44,7532,427
3,0,3,0,6,0,0,3,7540,637
31,18,13,1,38,870547,2077,35,2540,523
6,4,2,5,12,30885,37356,96,15071,423
12,6,6,0,7,140348,0,3,0,661
82,8,74,3,26,48977,23772,149,26820,420
30,7,23,4,4,38011,31808,51,7669,437
3,1,2,1,11,8458,8458,40,8458,511
18,5,13,3,11,360147,844,0,0,511
7,4,3,3,7,47735,66602,53,0,528
17,5,12,3,16,30218,11697,79,5115,470
9,5,4,3,13,22043,11802,52,3990,489
9,7,2,1,12,124939,1245,2,0,572
5,3,2,1,7,13097,13097,32,13097,660
40,12,28,8,14,253615,189125,237,52664,505
21,9,12,1,17,477981,4439,41,0,465
5,2,3,3,3,10934,10316,29,7047,615
7,5,2,5,8,18119,18119,101,5298,439
7,4,3,3,9,40548,40664,17,16992,412
16,7,9,3,8,107779,16896,58,2265,515
10,5,5,3,9,12523,2717,21,3089,501
14,7,7,0,8,172111,0,6,0,640
21,9,12,1,12,1034214,1338,25,1499,507
23,5,18,3,19,79497,68955,25,37757,511
9,5,4,5,11,18424,18424,37,5167,427
4,2,2,1,16,404886,7014,16,1652,554
23,4,19,2,15,6941,4801,4,901,500
6,4,2,4,7,54286,56692,33,18033,537
14,4,10,1,9,73667,70867,19,2034,522
8,6,2,1,14,9242,7338,6,7338,664
8,6,2,6,14,11946,5707,99,1910,423
5,3,2,4,7,46983,18071,9,5022,468
38,4,34,3,8,55902,22996,47,21069,570
4,1,3,1,8,195958,195958,10,0,589
19,12,7,3,9,306394,15666,61,2508,462
28,11,17,9,15,309457,42518,136,7465,539
39,8,31,1,12,45771,2302,4,4694,619
20,3,17,0,16,648,0,1,7111,540
31,9,22,4,11,39074,14044,66,7122,462
36,11,25,6,13,474658,46748,462,9798,437
4,1,3,0,7,240,0,3,0,442
7,4,3,0,3,7472,0,0,0,636
11,7,4,0,11,229931,0,2,0,556
19,3,16,4,14,97425,102997,49,82126,481
27,8,19,0,8,186666,0,1,3000,563
54,12,42,5,13,165752,33176,241,13533,464
23,13,10,13,12,398423,349731,248,232768,468
11,5,6,6,12,27208,30769,24,5053,465
16,2,14,1,8,83298,8334,14,8913,540
16,13,3,1,19,619122,2317,1,14449,484
21,13,8,0,8,598218,0,25,4212,599
5,3,2,2,5,2851,2851,96,2771,582
22,6,16,0,5,101957,0,0,0,622
30,16,14,7,14,155734,39613,141,1345,476
9,4,5,3,16,60483,14818,53,2300,464
24,7,17,2,13,52470,11629,49,3818,570
13,5,8,1,15,495,247,6,526,730
27,7,20,1,6,179266,53024,16,0,519
7,2,5,3,8,10820,10820,55,5619,530
9,3,6,4,9,19317,61701,113,6903,479
46,15,31,10,13,186405,6596,63,1376,480
7,4,3,4,11,1606630,253772,147,8617,545
8,1,7,0,8,56807,0,2,2739,558
20,9,11,7,9,88659,85403,123,38448,415
40,10,30,2,6,272280,5997,17,495,566
9,7,2,0,11,1005577,0,24,0,677
13,4,9,0,13,125399,0,1,183,641
30,5,25,1,7,19867,10074,240,10074,463
8,5,3,6,10,85384,52604,122,0,497
7,5,2,4,6,12359,4416,20,3117,491
8,5,3,0,12,34349,0,27,3090,421
8,4,4,4,6,10896,17020,46,6322,545
10,6,4,2,7,32869,1251,38,1023,522
15,7,8,0,19,44633,0,12,716,518
8,5,3,1,9,88909,1187,14,0,545
10,4,6,0,5,28978,0,0,90,578
14,3,11,3,13,26624,26125,129,11938,444
42,10,32,2,11,383514,48892,131,6466,494
77,22,55,15,15,283327,263502,375,12016,413
71,7,64,6,15,383507,64274,295,33534,432
19,4,15,1,20,80374,80374,38,4326,578
11,7,4,4,12,157348,726262,70,43328,494
28,20,8,19,6,112062,67672,221,13909,431
102,21,81,10,17,219498,52381,366,15880,459
13,7,6,1,5,385783,1068,12,1068,471
9,2,7,1,13,0,10590,39,783,619
10,5,5,4,8,171677,27332,19,0,462
2,0,2,1,5,7588,7588,9,0,617
30,9,21,2,16,525381,8112,33,5718,449
9,5,4,3,10,15508,14788,24,4628,474
7,4,3,2,11,297120,24677,15,0,588
5,3,2,2,12,26050,10017,40,1167,441
11,4,7,7,9,559941,95139,132,13235,439
13,3,10,0,7,81598,0,42,3779,463
10,7,3,8,11,61163,59066,108,22814,411
10,7,3,7,15,31599,36670,18,4171,422
31,14,17,18,7,573514,459000,401,77490,459
15,8,7,5,4,31696,7333,22,2425,528
13,8,5,1,6,816864,917,26,0,512
32,11,21,12,8,124511,140530,165,61474,418
11,5,6,6,10,293005,385820,128,140366,447
5,2,3,3,8,24273,30060,0,0,499
9,5,4,5,13,11093,11093,24,7356,466
21,11,10,8,13,303823,103717,88,1301,459
20,5,15,4,15,310712,28090,79,6807,559
32,18,14,0,18,718004,0,30,310,500
19,9,10,2,13,444295,18729,77,7090,450
12,2,10,5,8,12349,32064,126,8758,541
13,5,8,1,12,398558,17623,0,0,524
48,14,34,2,11,2213174,3801,40,2509,531
8,4,4,3,12,292682,13740,59,4949,494
23,11,12,8,14,128678,42482,151,14413,433
11,3,8,1,5,157491,997,5,4384,440
32,8,24,7,21,338381,47436,78,19281,550
12,3,9,1,7,75032,14744,17,14744,491
8,3,5,2,11,360504,9926,4,7138,587
20,7,13,6,8,12814,7041,141,0,503
29,18,11,22,8,151640,158393,628,15450,463
21,8,13,6,7,25412,21988,101,8309,467
49,10,39,0,10,287914,0,5,0,579
28,9,19,6,16,110083,57507,108,16705,514
35,10,25,7,13,332687,74606,264,24938,478
31,11,20,8,17,140347,64058,216,15488,455
25,8,17,6,16,60988,51006,100,17620,388
16,6,10,2,15,686165,10951,1,8166,497
36,2,34,2,13,9009,5146,23,4843,568
11,6,5,0,16,40873,0,0,5576,571
17,10,7,0,33,859048,0,2,0,647
17,5,12,3,27,57831,56119,42,0,509
6,3,3,3,6,36508,35675,43,1250,414
11,9,2,5,8,67026,58541,0,4815,534
17,15,2,3,12,186471,50070,0,0,510
14,4,10,6,15,27037,43320,47,12557,419
54,11,43,1,14,192879,1300,49,4200,460
37,9,28,6,7,92994,44118,87,9378,446
23,13,10,1,14,360010,7292,30,7292,575
14,5,9,3,11,285128,204935,79,99680,529
44,8,36,1,15,151465,17786,115,17786,640
27,7,20,0,13,246349,0,3,647,580
23,12,11,6,15,458933,72815,103,19992,440
9,5,4,0,16,129951,0,16,25500,674
5,1,4,0,7,19614,0,0,0,732
12,9,3,0,11,314465,0,2,0,604
38,8,30,1,14,96682,30787,6,733,522
18,9,9,1,19,389238,10029,26,6682,578
7,5,2,1,10,24181,17358,0,0,550
23,15,8,0,20,1289002,0,10,6386,582
13,9,4,1,14,39869,199,30,199,683
22,7,15,5,21,25027,23937,108,14100,450
13,8,5,0,21,538094,0,0,0,680
15,11,4,7,11,184175,72880,0,0,486
8,5,3,4,13,259825,259825,63,135277,502
10,4,6,1,7,4143,939,106,15027,611
5,3,2,2,4,12932,11318,49,0,557
9,5,4,1,13,561240,416,9,416,573
8,3,5,2,11,5338,29873,34,360,612
24,11,13,9,24,468923,693682,161,33147,461
8,4,4,5,4,14035,11287,79,0,476
15,7,8,6,9,584402,194857,228,17112,480
11,2,9,2,11,56967,27279,43,0,518
6,4,2,2,4,19665,1830,5,8,454
12,10,2,7,7,89023,39267,76,10086,418
13,7,6,4,11,34641,4646,16,1492,421
18,8,10,7,13,441451,74437,108,5511,432
13,10,3,2,26,273053,3969,36,700,503
18,8,10,7,19,691513,1206328,133,2462,476
5,2,3,2,6,18290,18290,195,13349,505
3,1,2,1,11,3259,3259,22,3259,581
8,6,2,0,15,935337,0,34,0,595
9,5,4,5,3,26205,24499,40,6178,507
28,7,21,1,6,37097,229,25,5011,469
24,8,16,2,17,219983,5333,2,4253,503
17,4,13,0,19,11112,0,1,495,719
14,5,9,5,16,31767,23692,39,13317,463
5,3,2,3,6,16713,10045,60,197,546
32,12,20,5,11,28174,17039,109,4905,659
20,7,13,6,6,30775,24722,93,9175,504
13,7,6,9,15,67393,72013,161,19210,500
7,3,4,0,12,3660,0,2,20,679
10,4,6,4,15,71301,136956,134,58044,427
11,5,6,2,17,33237,2879,0,0,484
18,6,12,5,6,19830,20272,0,0,449
6,4,2,1,6,14207,6151,31,238,595
10,3,7,1,9,30648,29716,63,2006,474
5,2,3,0,7,36609,0,0,0,557
12,5,7,2,12,31914,1471,50,1339,471
6,2,4,1,4,12543,2550,17,2550,549
14,12,2,2,4,1177227,1898,12,850,490
14,5,9,4,9,27268,21027,33,11262,568
7,4,3,2,3,134192,82598,42,41299,534
10,4,6,2,12,12069,3777,16,2461,459
7,3,4,4,10,474270,48608,24,0,489
13,4,9,1,7,22449,3070,70,3070,544
9,5,4,2,11,522284,6416,81,1301,511
6,2,4,2,7,29360,29360,49,27510,533
39,8,31,7,15,126433,71336,164,13713,450
21,6,15,2,17,266754,44401,51,0,538
15,9,6,1,14,832518,97350,26,97350,527
17,13,4,0,5,1163595,0,0,0,651
17,6,11,5,3,63114,22716,46,1962,500
8,5,3,3,13,82257,51262,75,0,455
9,7,2,2,3,512626,3097,4,0,456
8,3,5,5,7,91972,103871,60,24373,440
4,2,2,0,2,7899,0,5,1402,480
7,5,2,5,8,15294,12511,72,6323,414
25,8,17,6,19,155569,127711,126,74875,448
7,2,5,1,8,5049,790,0,0,569
12,4,8,3,22,15869,93738,55,8428,594
22,9,13,1,15,1844056,13604,92,0,456
106,22,84,9,6,158393,13561,39,15912,415
9,3,6,0,13,33106,0,23,0,638
16,8,8,8,15,214679,214679,216,28200,436
33,12,21,2,8,274342,4178,30,0,526
45,8,37,4,18,233132,15169,141,9900,440
12,3,9,2,15,9503,4674,9,10226,463
29,4,25,1,10,64534,20141,7,20141,537
20,7,13,4,9,25049,26120,55,15545,605
11,5,6,7,6,23239,23239,122,11238,432
13,9,4,9,14,85418,91611,132,82778,414
8,3,5,2,13,13699,13683,30,2576,527
11,7,4,3,13,333187,87069,115,44268,483
24,7,17,0,19,71278,0,5,3038,674
11,3,8,2,22,27066,9348,39,2763,461
31,6,25,0,17,294752,0,153,1888,507
7,4,3,1,12,20029,4350,14,4350,571
10,6,4,2,9,6469,4339,26,7,601
12,7,5,7,8,289787,145993,134,21900,436
71,21,50,11,9,129406,60294,223,31008,417
37,16,21,7,11,318775,29354,51,2483,477
11,4,7,1,14,45717,5798,31,5798,468
23,13,10,1,17,1221196,2605,17,0,470
4,2,2,2,3,16189,15735,93,14249,381
8,6,2,2,8,242835,869,18,477,443
2,0,2,0,6,0,0,11,740,617
9,5,4,0,12,25144,0,30,3841,504
22,5,17,1,14,177978,59836,0,0,520
15,2,13,1,16,24523,12960,23,2860,565
15,10,5,0,18,261837,0,8,8768,584
18,9,9,12,17,554371,185617,224,19874,405
72,13,59,0,11,29455,0,6,1680,446
15,8,7,3,11,52523,13492,85,6444,496
8,4,4,1,6,81967,8341,26,4429,560
5,3,2,1,9,269166,3787,0,0,686
36,19,17,6,14,146751,31068,42,9928,509
18,8,10,0,29,553588,0,2,0,692
5,3,2,0,2,18960,0,30,863,557
27,3,24,0,6,1770,0,14,1795,664
40,15,25,6,8,207012,82855,133,7100,497
8,4,4,4,8,38048,56140,64,16883,497
25,5,20,5,20,209237,165739,71,1942,693
3,1,2,3,6,93516,152876,34,93516,461
22,5,17,1,10,44575,18928,40,5340,469
53,8,45,2,15,254654,5079,148,1429,463
4,1,3,1,9,4139,4139,21,4139,591
5,3,2,1,18,26471,1811,1,1980,549
21,11,10,15,11,223955,278312,246,32512,484
5,3,2,3,11,29044,29044,57,12801,466
24,17,7,0,13,204051,0,4,235,517
15,7,8,6,9,346765,69582,190,15915,537
8,2,6,1,4,11690,2492,2,0,525
14,7,7,8,15,51075,55577,80,9487,417
2,0,2,0,4,0,0,0,0,678
2,0,2,1,3,4151,4151,0,0,396
4,1,3,1,9,272848,14091,11,0,651
21,9,12,0,12,236168,0,30,437,653
8,3,5,2,3,5669,2471,12,2460,467
13,7,6,3,11,23975,11722,43,4908,459
4,1,3,4,7,9602,16180,64,0,504
31,7,24,3,7,57345,3630,44,1458,462
18,6,12,5,6,34335,24226,0,0,476
4,1,3,0,9,0,0,2,4651,607
7,5,2,3,15,23108,25230,5,19307,395
38,5,33,2,7,89803,10868,96,25218,413
14,3,11,3,9,6041,9348,77,4963,416
20,4,16,2,12,59091,55535,39,0,588
35,17,18,9,20,204151,119791,106,8202,405
13,7,6,5,10,34847,27167,74,10390,439
8,1,7,2,16,31313,26525,70,1206,505
6,4,2,0,8,26367,0,8,9585,529
15,3,12,1,7,49835,760,35,750,534
47,10,37,9,19,232109,261541,72,145706,425
28,14,14,5,9,321008,44713,52,7221,398
9,7,2,1,5,27746,438,47,200,606
15,7,8,3,8,212844,118824,96,10792,474
11,7,4,4,12,32920,36940,51,14532,452
9,5,4,2,14,270935,24564,84,27308,485
4,0,4,0,6,0,0,5,0,707
7,2,5,1,17,10007,6070,10,6070,428
30,6,24,1,7,30428,970,25,1250,484
15,7,8,5,9,81081,31482,72,27093,425
49,7,42,6,17,462025,28634,78,2325,453
20,7,13,2,4,31841,2202,23,1419,508
6,3,3,2,6,17795,26941,31,20639,565
12,6,6,0,10,361882,0,1,0,594
9,7,2,2,7,3256,4295,18,3256,650
5,2,3,2,8,15518,15518,48,2624,468
20,6,14,5,9,60596,60124,68,8966,437
22,8,14,2,16,421929,22790,22,21680,587
9,5,4,4,7,8728,3859,135,2322,491
20,8,12,2,27,135098,20492,1,300,543
28,9,19,3,16,118095,48767,49,12331,444
13,9,4,0,5,139095,0,5,0,491
36,11,25,6,11,592667,60701,80,8645,425
9,6,3,8,5,38750,44824,272,9313,418
39,8,31,5,18,57143,17959,292,12517,448
4,2,2,1,7,30303,14196,99,14196,622
3,1,2,2,5,2272,3457,0,0,471
9,6,3,4,11,22716,13461,34,13167,644
5,2,3,0,6,0,0,0,0,739
24,6,18,4,7,71910,91339,127,14161,461
15,6,9,5,8,108558,100635,34,16167,519
14,8,6,1,12,1985382,68150,37,0,516
223,15,208,7,13,165561,137163,201,33182,469
5,2,3,0,8,0,0,0,0,748
12,3,9,0,10,12221,0,57,2220,644
52,16,36,0,15,94913,0,38,1297,575
30,10,20,1,8,164821,37443,30,4745,619
11,9,2,7,25,721236,119607,74,41798,470
24,6,18,2,14,103345,2126,19,1623,555
28,12,16,4,11,413155,130900,68,98579,443
16,10,6,4,15,171776,8959,25,5011,494
8,6,2,6,8,49443,44442,97,24588,536
23,8,15,2,28,1099731,35295,21,1902,593
3,1,2,0,4,0,0,36,1844,540
22,16,6,0,20,762815,0,10,0,585
6,4,2,1,6,51057,2026,8,2026,396
20,9,11,9,21,1227580,1197538,568,644333,524
49,3,46,1,7,247327,9630,10,9630,491
36,11,25,5,8,51285,22076,75,7267,435
49,19,30,6,11,2120332,276671,0,0,439
12,5,7,4,12,579281,34465,48,11217,514
11,6,5,1,8,185770,7759,23,0,486
4,2,2,0,4,304285,0,0,1502,497
14,6,8,8,8,52274,68772,128,16948,457
8,5,3,0,8,10601,0,23,3333,466
8,4,4,4,8,144556,108151,103,8754,521
34,6,28,4,15,344314,14298,204,5792,443
10,8,2,7,9,118862,105893,150,1085,466
14,9,5,8,10,178100,76506,0,0,466
9,6,3,4,10,19042,10818,94,12115,563
28,11,17,5,12,429183,198876,138,4238,440
10,6,4,4,10,526462,35018,53,0,469
8,4,4,3,11,40828,31892,16,25397,460
31,15,16,1,28,150915,15567,40,1117,571
28,21,7,4,13,1473683,258881,25,12061,499
12,4,8,2,13,206272,5942,37,5346,523
15,13,2,13,11,100747,98089,279,23526,464
12,1,11,1,21,20514,20514,9,6374,591
31,5,26,4,9,36958,7068,107,1671,534
5,3,2,3,7,11915,11915,299,10560,543
20,8,12,0,17,617459,0,1,840,575
3,1,2,2,7,4084,9461,95,8168,622
4,2,2,2,15,348557,104208,57,0,556
25,8,17,0,19,42153,0,5,1951,652
8,6,2,0,3,201973,0,6,0,581
13,8,5,8,16,382016,54288,103,1588,409
23,6,17,5,18,72910,61203,98,26479,479
11,7,4,6,5,291544,237457,189,12476,440
25,9,16,9,17,1943333,269024,90,0,495
80,31,49,1,22,3752022,16449,39,0,577
8,4,4,6,7,83785,102096,131,42489,452
17,13,4,3,22,412867,122710,122,132823,459
34,9,25,1,13,87894,31893,32,253,540
15,7,8,7,19,338796,599471,110,26978,536
7,4,3,2,7,27944,6408,0,0,460
66,11,55,5,26,281336,145657,51,20,487
15,4,11,1,12,286343,7070,46,1967,491
32,9,23,4,20,25127,20231,327,16645,412
22,15,7,5,24,1582120,598997,140,500851,469
5,3,2,0,7,10334,0,4,290,679
15,2,13,1,15,4658,1329,10,611,517
17,4,13,2,7,78351,6346,55,5833,508
17,9,8,10,9,487849,1508407,15,119861,508
17,7,10,2,15,4514711,29440,54,213027,466
5,3,2,0,9,45596,0,0,0,679
4,1,3,2,9,8793,12299,42,0,506
19,7,12,6,7,20796,24208,161,18773,455
31,19,12,2,7,404600,201,55,728,588
2,0,2,0,7,0,0,0,0,654
7,5,2,5,4,27591,9612,60,2144,486
8,3,5,0,10,416546,0,32,4415,563
8,2,6,1,7,4068,3868,30,0,641
7,4,3,0,4,65615,0,10,0,549
43,17,26,2,7,99570,5298,0,0,437
3,1,2,0,8,0,0,12,0,679
8,2,6,2,27,107020,610394,4,122020,501
12,6,6,2,19,329651,31174,70,24603,480
7,3,4,2,11,147463,11415,9,0,473
18,7,11,0,13,111333,0,6,1408,496
13,11,2,1,13,472060,1210,4,0,528
44,25,19,7,11,1446565,152895,36,0,473
32,9,23,3,8,34603,5971,100,3649,478
26,10,16,10,16,129642,97451,92,20684,452
29,6,23,5,7,62803,57954,303,46894,449
6,3,3,2,7,179457,8789,50,0,550
40,5,35,5,14,18437,14076,124,3410,483
33,9,24,4,18,492058,44471,129,26913,370
17,6,11,2,12,181238,46166,0,30813,557
4,1,3,3,7,4090,21724,0,0,700
15,6,9,1,7,43307,71460,44,5570,465
6,4,2,0,4,11034,0,1,1113,636
7,5,2,0,4,19067,0,0,0,622
9,0,9,0,3,0,0,2,0,531
9,5,4,0,19,7600,0,8,3662,679
42,10,32,4,14,276662,211719,67,105725,600
6,3,3,2,8,15225,6497,10,4329,428
16,4,12,0,16,770111,0,18,7260,575
11,8,3,2,7,175367,17815,22,0,444
9,6,3,3,14,24814,22029,46,6712,478
11,2,9,1,4,2007,1374,3,1250,509
94,20,74,2,26,688969,138435,17,19762,501
9,5,4,2,7,21216,3694,50,1757,521
8,4,4,3,8,428680,10314,42,0,542
11,8,3,6,10,69274,38418,25,3265,516
25,9,16,4,10,89044,22744,7,2767,435
10,5,5,1,17,15867,1339,32,1339,604
13,6,7,7,18,130887,328719,145,0,528
5,3,2,0,9,14556,0,26,1886,673
21,15,6,1,16,1047842,940,10,1414,674
14,1,13,0,13,0,0,33,1728,724
11,3,8,5,8,8018,46012,60,2284,447
11,6,5,0,11,483424,0,0,0,718
21,7,14,3,17,92813,92193,76,34000,580
13,5,8,3,3,78895,3561,6,1165,436
15,4,11,3,9,33314,16608,40,2172,538
20,4,16,5,7,22714,38535,154,11413,535
12,2,10,3,18,51544,53944,57,27058,546
54,13,41,1,11,520029,1611,0,751,460
14,7,7,7,14,563331,94562,168,2350,451
24,5,19,3,5,14023,17298,99,2380,601
12,10,2,3,6,21039,2498,9,795,460
33,6,27,3,20,286292,18719,70,5562,440
6,4,2,5,8,43002,43002,47,14991,446
19,6,13,0,5,265550,0,18,2698,499
15,5,10,3,15,17137,13535,49,6596,547
29,9,20,7,9,465381,146877,444,54386,512
11,2,9,1,7,27490,24220,29,24220,551
20,11,9,5,11,383646,15933,64,336,470
7,4,3,1,19,25641,3169,27,3169,511
6,4,2,4,14,19983,24280,194,10309,481
7,1,6,1,10,278,278,7,4568,532
12,5,7,4,8,24067,17111,30,3943,486
12,1,11,2,13,24178,18579,2,2647,637
12,4,8,0,8,66068,0,11,0,606
4,1,3,0,7,1000,0,0,1000,632
5,3,2,2,16,62775,21889,35,19062,565
17,8,9,3,12,166732,69843,19,10388,497
15,7,8,5,12,311864,36530,246,27070,421
50,12,38,6,10,69384,32450,137,12916,492
3,1,2,0,7,0,0,3,0,667
5,3,2,2,4,156133,22248,20,2403,476
5,3,2,1,9,78728,6078,0,0,489
13,8,5,0,9,88062,0,13,0,573
6,3,3,4,8,63195,21583,12,9495,498
3,1,2,2,16,16429,22065,1,5636,499
23,6,17,3,8,280414,95736,72,182,540
13,6,7,2,9,322108,4646,36,0,672
13,5,8,6,7,38363,30359,87,11105,378
12,7,5,3,20,507146,23312,9,150,600
36,7,29,7,14,375260,147936,161,17701,424
8,1,7,0,16,39839,0,1,4655,590
88,10,78,6,19,420112,203640,60,2160,412
5,1,4,1,11,2807,2807,10,2807,626
13,4,9,3,12,122895,52010,33,6644,459
34,12,22,7,11,142118,50187,152,11434,447
130,18,112,12,20,447409,54030,176,21965,453
22,11,11,10,15,521695,151604,48,15610,474
115,13,102,7,17,111464,9282,187,4088,424
23,10,13,6,8,326740,42152,60,16494,447
14,4,10,5,16,40493,44815,46,11647,468
16,2,14,0,7,127009,0,243,5189,632
19,6,13,0,22,304540,0,0,477,586
12,5,7,0,17,55476,0,3,1402,660
7,5,2,1,4,60855,714,9,714,528
14,5,9,3,7,31071,16155,60,0,469
18,10,8,0,12,259396,0,19,354,548
9,6,3,0,29,4905,0,4,0,625
9,7,2,3,7,436073,32470,40,30454,446
8,6,2,3,17,171994,49335,63,35747,476
33,7,26,3,11,473186,9383,15,6875,528
12,7,5,5,11,477985,73636,60,2275,490
6,3,3,0,11,27766,0,0,0,648
9,7,2,0,9,1868678,0,25,7892,512
20,2,18,3,13,16430,16430,68,1652,544
3,0,3,0,4,0,0,4,1957,631
15,12,3,15,9,260798,270180,279,44887,448
7,5,2,3,7,228147,10463,49,589,519
8,4,4,4,9,50352,46237,60,40405,555
11,7,4,2,10,395862,195135,36,0,495
47,4,43,1,13,12132,109,46,1689,539
71,11,60,3,11,233167,1392,97,2189,438
14,3,11,2,7,4470,4470,17,3286,598
14,8,6,0,11,137257,0,4,3510,553
26,6,20,3,14,41824,53473,375,16131,449
7,4,3,3,17,18792,18792,24,6478,491
11,5,6,2,8,28824,4181,9,2756,452
19,7,12,9,17,88949,93376,202,4422,436
39,14,25,2,18,7096833,179023,14,13897,443
8,6,2,6,11,361339,21333,123,2278,511
7,4,3,3,15,47576,32531,72,3513,478
13,6,7,4,17,39180,32444,89,12482,450
17,9,8,4,11,842893,47015,131,17741,489
11,9,2,3,13,654058,263195,15,3165,446
12,5,7,3,9,23268,4591,6,1367,443
10,6,4,0,6,51417,0,0,0,657
24,7,17,4,12,230459,19913,54,4298,459
8,4,4,0,2,44480,0,6,464,553
27,10,17,0,11,805853,0,0,1553,594
22,2,20,0,19,362391,0,0,1319,524
7,4,3,2,12,278355,33418,50,0,522
7,4,3,1,16,305166,3544,6,3544,555
33,7,26,0,8,44488,0,0,1282,597
7,2,5,0,12,2949,0,0,0,633
66,13,53,1,10,399470,5030,5,1031,492
18,8,10,6,8,75079,67297,235,2843,503
7,5,2,2,17,7839,7839,0,0,536
18,10,8,1,20,123292,6094,14,0,470
4,1,3,1,4,20374,20374,18,0,540
10,6,4,4,8,38382,18974,87,3459,511
25,9,16,8,8,175511,138625,101,7673,415
11,2,9,1,6,9079,444,96,700,585
12,8,4,6,5,12304,27410,40,13846,427
8,5,3,2,4,15688,2270,31,1800,528
57,10,47,0,19,277610,0,0,2708,636
11,5,6,5,8,15035,13025,89,6075,379
15,6,9,0,14,8449,0,3,0,649
7,5,2,1,11,462983,1620,12,4860,509
6,4,2,2,5,523529,35926,41,28507,574
12,4,8,3,14,41182,38768,68,19973,466
6,1,5,0,12,281822,0,2,1699,518
11,2,9,0,25,16773,0,70,20654,518
8,5,3,0,10,386422,0,0,0,555
28,16,12,0,13,1333101,0,8,0,539
59,11,48,2,14,239411,4947,19,5201,391
14,5,9,3,14,374365,55446,47,1854,508
12,6,6,4,10,200130,89451,52,0,450
23,13,10,8,3,113341,81394,87,12322,537
24,10,14,8,14,218837,88147,10,47980,471
4,2,2,0,21,0,0,4,11300,657
4,1,3,0,5,4734,0,0,0,618
16,4,12,5,10,25026,30438,338,17471,498
17,5,12,3,14,47501,47471,132,25238,433
28,8,20,7,7,75735,72989,101,19105,454
9,4,5,3,11,15245,15245,150,4913,507
20,6,14,2,14,55276,12870,16,10705,428
7,1,6,1,11,1580,1538,25,312,540
12,8,4,6,7,85460,79160,138,14652,406
4,2,2,2,3,13898,13416,37,0,568
12,8,4,2,9,58498,276,4,3868,581
9,4,5,8,24,199989,317745,31,15954,498
19,7,12,0,14,804814,0,1,0,608
13,6,7,6,12,33561,35704,34,14484,395
20,11,9,6,11,141130,108673,65,12912,443
19,9,10,6,13,164934,151275,146,146675,439
7,5,2,5,6,90595,75716,63,23923,417
10,6,4,0,13,245012,0,12,2806,628
21,12,9,7,19,993594,184303,31,3152,418
5,2,3,3,13,266789,418863,73,262011,504
11,6,5,3,8,415914,15068,6,2219,418
45,18,27,5,17,443860,85154,76,3947,552
33,5,28,3,6,21273,18379,208,7665,502
15,5,10,2,8,301146,11629,16,9726,575
64,13,51,6,11,99728,50229,187,5051,516
7,4,3,2,13,25310,4785,26,0,513
22,9,13,1,11,76300,6591,21,6591,555
15,7,8,4,19,1443749,145089,49,0,450
20,5,15,0,7,19276,0,7,1859,629
7,4,3,6,7,28766,49950,98,4482,507
41,26,15,3,31,3077030,32319,59,6577,465
21,12,9,11,13,340065,166316,111,17129,423
36,14,22,1,10,459428,7857,65,9536,654
7,4,3,0,8,362841,0,0,148,627
8,4,4,0,7,107715,0,3,0,513
12,10,2,8,16,427739,71096,203,6400,375
5,1,4,2,5,8090,5670,34,0,498
4,2,2,1,9,206629,986,14,14541,532
110,10,100,7,17,56931,65526,319,27650,516
9,3,6,3,9,171766,9632,22,415,465
20,12,8,5,7,41908,8471,48,6355,505
10,6,4,3,8,382282,22386,312,14226,523
27,8,19,8,28,77243,46328,248,8870,430
17,7,10,4,14,56052,18273,157,14873,449
13,8,5,0,16,300639,0,1,0,687
7,5,2,2,10,1790,988,10,512,450
19,7,12,4,7,64619,4285,13,5658,456
9,5,4,1,15,260859,5395,30,3520,528
26,16,10,1,13,875496,3270,15,3287,657
29,18,11,1,17,1321179,5325,15,0,635
8,3,5,2,14,297174,5893,32,1166,626
7,5,2,3,9,339384,6860,135,4851,446
21,12,9,12,23,82371,127941,138,4348,450
17,10,7,1,9,200326,5760,32,0,669
23,12,11,1,11,338627,2564,3,0,526
14,10,4,0,11,529539,0,24,0,686
10,7,3,3,7,418587,6064,52,4028,470
9,5,4,4,4,11677,11676,32,4744,476
26,12,14,8,15,168092,129239,145,41201,504
6,3,3,1,18,37946,23610,29,0,635
14,6,8,0,7,92984,0,30,0,669
41,9,32,3,12,109783,931,76,3084,548
29,10,19,3,8,419531,18704,232,16892,512
14,6,8,6,12,71829,92083,0,0,448
7,4,3,0,18,20867,0,0,0,690
39,10,29,9,14,1035009,103782,235,41201,419
13,4,9,6,7,170322,152611,1,1169,549
11,7,4,3,13,303303,15282,73,14760,443
20,8,12,0,16,745696,0,5,0,529
8,5,3,1,7,224630,7400,11,7400,533
15,4,11,3,13,132030,56026,50,9038,477
30,10,20,5,11,382591,79661,193,25298,442
12,7,5,9,22,224646,197601,164,12213,465
26,12,14,13,16,589755,609373,285,318571,433
8,4,4,3,14,328658,8961,35,2238,683
13,7,6,6,5,34922,20803,21,4980,453
20,6,14,7,18,79466,30773,118,9560,542
59,13,46,4,15,111737,68966,59,39037,505
2,0,2,1,5,3770,3770,49,1250,602
18,10,8,0,19,369036,0,0,0,680
17,2,15,0,13,19837,0,73,3103,512
6,4,2,3,7,39955,4752,29,0,539
49,2,47,0,14,65000,0,65,6639,649
5,3,2,3,8,16028,6368,16,3758,478
20,8,12,5,11,35942,31445,23,13046,472
10,3,7,1,7,24433,725,32,1692,511
11,3,8,0,10,440088,0,0,0,547
12,5,7,3,6,16998,5933,94,2079,557
5,2,3,2,11,223039,1209,0,0,456
16,14,2,2,4,166172,572,49,1198,579
9,7,2,1,10,521307,2987,8,3173,682
24,16,8,0,16,100206,0,0,1166,683
8,6,2,2,14,31760,1852,0,21227,474
32,16,16,10,13,331514,45507,367,24455,426
19,12,7,10,7,1015143,945996,130,365125,432
29,8,21,8,13,75990,61203,123,15946,435
6,2,4,2,12,16705,16829,0,0,454
7,4,3,3,13,16461,16461,55,10093,441
39,9,30,5,8,43079,23655,74,11979,462
10,1,9,1,11,18077,18077,23,18077,558
32,3,29,0,13,0,0,3,1458,655
13,4,9,2,7,13391,7223,117,4508,535
143,13,130,5,11,139367,55411,210,32625,445
51,11,40,3,12,82096,37988,67,22405,576
32,5,27,1,15,154648,134078,0,0,496
29,5,24,2,10,21554,2339,14,14928,455
8,4,4,4,6,3141,5217,70,1350,449
12,4,8,3,11,20887,19516,50,3181,514
17,8,9,2,17,27135,21044,65,0,474
36,8,28,4,22,431129,220534,65,10605,434
5,3,2,1,7,0,559,73,1250,626
6,4,2,2,14,413238,2490,40,2428,511
3,1,2,0,9,0,0,29,0,717
31,9,22,4,13,485628,11934,107,4442,432
13,9,4,1,13,201421,267,12,0,609
24,12,12,9,10,185402,91962,220,42214,438
6,2,4,3,9,15453,22440,191,12002,488
25,5,20,6,14,58839,42124,92,6744,473
7,5,2,2,12,196173,11409,24,7590,495
26,6,20,3,13,8392,14150,35,5544,466
6,3,3,2,11,7644,2200,4,4075,477
12,8,4,7,6,105613,93135,42,173223,427
17,6,11,1,8,381305,2855,23,2855,548
9,3,6,1,14,15114,863,23,1899,668
9,5,4,5,17,1942576,388696,26,27993,367
70,6,64,6,16,19004,17484,441,11611,453
7,3,4,2,10,53874,35382,86,7550,487
4,2,2,3,3,13957,13098,37,0,487
17,14,3,5,6,1933166,114523,62,86648,478
5,2,3,3,7,12765,23700,40,14629,477
8,3,5,1,6,46589,296,5,296,662
19,11,8,0,18,333283,0,0,0,579
8,2,6,1,15,16334,16334,33,16334,474
11,8,3,1,5,495331,3747,13,3747,517
82,3,79,1,7,7769,1350,46,1350,563
5,3,2,4,9,12645,16607,70,0,531
6,4,2,1,7,22723,15215,29,15215,542
14,5,9,6,5,16539,9827,38,4142,460
8,4,4,4,4,369771,145473,23,0,459
20,5,15,2,8,14816,9464,8,15297,522
20,5,15,5,17,35347,33851,32,10672,481
6,4,2,0,17,19900,0,0,0,572
10,3,7,1,3,50744,1960,24,10625,435
5,3,2,0,6,13674,0,24,5024,557
40,7,33,3,15,140829,4087,60,7867,435
20,6,14,3,10,63361,27209,43,887,492
38,12,26,5,10,89419,25505,87,4253,407
14,6,8,0,20,398595,0,34,0,624
17,10,7,1,7,198086,1030,3,1030,406
16,5,11,5,6,14800,14800,126,12227,485
26,4,22,2,11,47647,1368,4,2214,513
13,5,8,2,14,81881,25437,0,0,499
15,7,8,7,15,97907,67278,56,14179,462
9,7,2,5,7,21187,21187,211,4840,459
18,10,8,12,8,325524,65585,90,3223,429
29,11,18,10,19,604019,421625,167,30072,415
5,2,3,1,11,471519,471519,0,0,597
6,2,4,0,7,58748,0,71,12238,614
101,14,87,11,16,207463,52010,271,37740,455
14,2,12,1,12,5114,545,4,545,504
16,6,10,6,19,2980040,712655,36,552664,492
20,7,13,2,21,83727,29495,95,0,674
15,6,9,8,8,35159,35159,94,9376,405
3,1,2,2,13,4575,4575,30,2704,525
22,7,15,2,22,127369,38252,71,1416,476
16,8,8,3,10,194143,10543,60,3111,488
37,7,30,6,9,106305,97134,110,16469,480
9,1,8,1,8,4614,4032,12,0,616
16,6,10,6,7,9854,14246,70,4423,415
56,9,47,8,17,263103,70261,58,34291,447
4,1,3,0,16,0,0,0,0,753
18,4,14,4,8,30366,31782,247,14100,455
7,2,5,2,7,3076,3075,81,2369,535
12,7,5,1,10,94324,1746,19,6110,475
55,24,31,2,10,266144,486,29,450,474
27,4,23,0,11,43486,0,1,8119,556
15,4,11,1,15,27273,7775,11,7775,597
9,4,5,3,6,27208,16838,73,0,515
11,8,3,3,14,371293,33211,162,14836,479
16,5,11,7,5,262320,289316,131,0,454
24,3,21,3,8,135150,60894,82,1832,529
39,22,17,7,15,219781,66637,91,25827,433
10,7,3,6,19,38029,25732,70,14557,429
9,7,2,1,15,49403,6932,25,0,615
20,9,11,9,17,69086,77860,89,16253,441
15,4,11,3,11,349575,10668,53,4156,458
13,6,7,2,6,113485,36315,48,0,579
10,6,4,3,20,759360,174444,60,1395,511
12,7,5,7,8,47364,50143,80,17877,601
8,3,5,0,9,38695,0,133,1415,578
20,6,14,0,9,128383,0,0,0,463
14,11,3,1,7,241184,31837,0,0,500
24,5,19,8,13,115108,161582,149,0,446
8,3,5,7,8,77304,119519,18,39720,434
74,13,61,7,9,647380,20484,280,4378,516
8,6,2,5,16,23853,17571,80,1507,488
10,5,5,6,7,87313,92010,115,35233,402
16,6,10,1,7,196975,190,79,227,528
6,2,4,2,9,10092,34552,37,111,478
10,5,5,0,4,98619,0,0,0,640
38,10,28,5,11,303918,39384,66,18322,486
6,2,4,0,9,0,0,0,148,669
17,11,6,0,20,1017525,0,28,0,565
9,4,5,0,19,90675,0,0,760,604
73,20,53,12,14,176425,116636,65,2770,419
18,8,10,2,9,291202,11195,18,0,512
4,1,3,1,12,1850,1850,43,3666,491
7,4,3,1,11,174565,6249,44,0,552
13,10,3,3,13,449564,67516,35,44067,443
28,4,24,2,13,458000,25837,29,21948,622
7,3,4,2,10,513992,18752,18,11114,560
13,2,11,2,3,17693,15848,22,10312,526
88,9,79,1,9,77380,10407,36,1390,547
10,7,3,5,14,208827,208827,118,107807,479
185,6,179,0,9,340836,0,7,4947,598
6,1,5,1,69,0,4308,13,4308,607
6,4,2,0,4,17050,0,0,0,594
14,3,11,3,16,21698,21698,97,22649,548
24,9,15,12,15,451454,749401,13,296447,419
31,5,26,3,14,42162,33797,73,23975,512
8,4,4,1,17,127512,942,22,0,531
14,4,10,1,15,1379,1379,10,1379,547
10,4,6,3,20,372997,11154,24,3790,526
35,5,30,0,14,7890,0,5,415,557
8,3,5,3,13,78572,73441,52,0,474
7,3,4,3,8,25894,21458,33,11029,548
15,9,6,7,13,168133,156524,82,29844,418
33,2,31,0,15,389248,0,10,34036,386
12,7,5,6,9,19162,17704,108,4837,454
70,12,58,5,12,355197,126999,60,72623,486
10,7,3,2,20,348939,16608,30,16054,551
14,1,13,3,14,531,55028,26,531,557
150,8,142,9,7,69381,75505,74,20243,469
17,6,11,4,13,78420,57180,23,13777,466
6,4,2,0,5,61238,0,1,2580,621
23,7,16,4,9,28555,13052,152,5702,521
10,5,5,6,12,18023,22967,238,12960,471
68,9,59,6,14,622590,46189,76,29530,400
21,14,7,0,9,461062,0,5,604,675
7,4,3,1,10,9478,1767,2,1767,510
13,4,9,0,19,125615,0,0,0,697
3,1,2,1,6,8633,8633,105,8633,617
65,4,61,0,9,38937,0,0,0,591
42,17,25,2,22,1850413,5552,41,7083,453
19,8,11,1,9,227320,2463,7,566,541
7,2,5,1,9,14776,14776,38,3122,526
20,6,14,4,7,90048,47995,108,43199,502
10,6,4,6,7,22889,25833,91,3397,437
7,5,2,0,9,39794,0,3,2588,683
15,11,4,0,4,973465,0,0,0,634
44,11,33,8,13,42707,29967,174,4947,459
16,6,10,6,14,553360,513158,104,284225,416
26,13,13,5,19,301036,315228,79,535,471
5,2,3,1,7,19939,19690,145,19690,641
24,8,16,7,11,97957,89800,84,5119,475
16,4,12,7,12,303381,580525,108,161712,451
17,9,8,5,12,85415,85061,45,13530,492
13,7,6,0,5,56048,0,2,0,609
4,1,3,1,10,2867,2867,0,0,625
6,3,3,0,9,60370,0,0,719,636
12,6,6,3,8,290744,3724,38,0,454
22,13,9,3,11,131122,15119,68,5447,474
60,21,39,13,6,118540,37378,521,8815,408
10,6,4,7,14,340651,66855,58,5848,457
13,4,9,3,9,144208,23752,38,5034,459
18,9,9,7,8,237422,72339,73,0,460
22,6,16,0,25,58764,0,0,0,616
5,2,3,0,9,16379,0,1,0,718
97,18,79,8,14,328792,24304,297,2705,410
20,7,13,0,16,27710,0,14,13989,533
15,5,10,8,16,76681,87163,143,29565,441
21,7,14,5,13,175847,41466,55,2720,474
5,2,3,1,2,46552,1559,2,1559,429
28,1,27,0,11,8182,0,22,961,681
27,4,23,3,13,57017,32080,19,16050,487
14,8,6,7,7,99221,97976,0,0,489
12,7,5,3,18,107668,97960,81,606,461
5,3,2,0,16,341005,0,16,10234,488
4,1,3,1,3,3257,3257,13,0,492
3,1,2,0,8,7067,0,0,0,546
17,10,7,4,6,212562,3895,0,0,479
32,6,26,5,8,99047,46741,140,10028,455
5,3,2,0,8,1457,0,0,0,675
14,8,6,4,6,243383,13599,0,0,455
13,5,8,3,9,13573,14250,57,2537,605
19,6,13,6,7,38651,15854,157,9773,423
3,1,2,1,15,512,512,30,721865,463
6,3,3,3,9,74721,32141,59,0,537
71,16,55,5,11,415073,45291,108,13089,489
10,5,5,1,7,79925,1259,1,1259,658
7,5,2,0,13,38351,0,0,0,664
5,2,3,3,3,34629,34629,46,2965,487
9,7,2,4,8,47240,10627,64,7796,497
19,10,9,1,16,323597,1536,29,1536,523
17,3,14,3,16,41321,41321,52,22303,436
41,11,30,4,14,88975,72774,25,4968,450
9,4,5,4,5,218321,28947,39,3447,436
31,15,16,6,19,374394,37419,69,12406,451
17,2,15,3,7,178001,47595,3,1250,474
10,7,3,1,14,0,160862,18,2188,670
9,5,4,0,13,556916,0,8,416,596
20,12,8,8,7,474971,44060,73,15583,498
12,5,7,7,7,38112,49900,12,5730,484
74,20,54,8,16,373892,59697,313,15899,475
15,12,3,5,11,128182,57917,88,1752,508
11,7,4,5,12,410670,33367,21,10066,481
21,8,13,9,28,129264,144391,162,50893,445
22,7,15,2,11,44382,1803,5,0,553
6,2,4,3,9,57946,49429,19,8973,465
14,5,9,6,13,342623,362054,23,74908,482
16,13,3,6,4,106739,14071,47,3300,375
28,7,21,0,13,258306,0,2,1628,646
15,9,6,5,12,233382,48171,93,47,460
79,6,73,1,3,17260,938,11,938,545
7,4,3,0,16,400863,0,3,4238,635
44,7,37,5,9,81013,77057,68,47786,456
33,16,17,8,12,456403,191822,172,43815,439
34,5,29,1,14,36359,6305,148,6305,563
8,3,5,4,10,8771,17939,62,8166,474
19,7,12,1,14,994609,3928,12,0,456
52,8,44,3,35,124834,17503,58,7174,466
17,1,16,2,7,4309,15900,0,0,507
16,11,5,9,19,243692,205463,94,11562,393
8,3,5,0,8,641,0,0,0,690
12,8,4,0,29,232869,0,3,0,760
30,13,17,8,21,533627,303728,156,6391,435
7,3,4,3,8,17950,15697,83,0,564
32,13,19,0,32,339495,0,8,57,623
6,2,4,2,5,9653,9422,41,0,636
9,3,6,2,8,38222,33818,44,1212,462
37,10,27,0,15,714604,0,63,882,610
12,6,6,3,5,279486,8609,70,2647,459
7,5,2,4,6,8437,5263,222,2791,449
21,9,12,6,4,48371,3376,34,1138,464
5,3,2,3,6,4318,4318,50,2318,480
10,5,5,1,10,427876,9698,8,30279,518
23,6,17,1,9,554479,2660,5,6569,438
5,3,2,1,6,0,7186,28,0,505
7,4,3,5,25,75621,112333,88,0,495
3,1,2,0,6,0,0,0,0,582
7,5,2,0,21,3000,0,2,429,580
10,5,5,0,27,840,0,10,4979,700
7,3,4,0,3,21095,0,1,910,559
37,7,30,0,13,97256,0,142,1510,496
14,6,8,4,8,371976,15176,316,13216,506
6,4,2,1,7,500038,1550,20,19588,604
18,7,11,1,11,88537,3794,45,4148,523
16,2,14,2,8,113755,77373,0,0,477
6,4,2,3,8,22285,12305,92,1273,482
6,0,6,0,6,0,0,18,11989,519
19,5,14,2,17,26149,20330,50,3000,647
10,6,4,3,9,33522,22231,76,18495,504
16,6,10,10,9,87255,123987,149,28685,442
14,7,7,6,7,32657,28771,77,11306,427
6,3,3,1,17,40335,39737,46,0,488
10,4,6,0,7,8316,0,24,6944,587
7,5,2,2,7,58276,32049,39,558,496
14,3,11,6,9,6510,23626,63,5100,444
11,5,6,1,15,11612,9625,11,9625,555
6,4,2,0,5,6936,0,8,0,618
207,15,192,2,8,81984,10910,91,10620,497
7,5,2,0,10,265926,0,4,0,634
9,5,4,7,9,51195,71081,45,14006,370
10,6,4,2,21,101361,132853,37,101361,472
29,12,17,7,10,29717,100595,88,5228,418
28,7,21,4,13,52836,7862,46,6292,545
10,7,3,2,5,16305,3922,44,2739,536
10,3,7,0,9,4063,0,119,4065,540
4,1,3,2,20,235312,22128,12,13246,522
71,9,62,3,14,81459,14565,60,10212,428
9,6,3,5,11,19128,19128,77,3818,423
10,7,3,5,10,27072,27064,82,3878,384
3,1,2,1,8,12099,12099,14,12099,510
32,11,21,10,14,71460,47527,86,8258,449
9,6,3,4,7,76983,75044,43,0,439
31,9,22,7,10,57244,50936,630,14318,359
10,7,3,0,10,96337,0,0,854,620
26,5,21,7,7,122216,122216,227,2542295,461
8,3,5,4,12,123299,123299,96,0,544
39,3,36,1,7,72512,1988,32,11196,511
26,14,12,6,14,292024,40652,93,4402,471
6,3,3,1,5,11191,1729,3,1729,573
19,13,6,0,6,449988,0,0,0,670
67,8,59,2,10,161268,30993,16,16485,520
10,7,3,3,12,13828,3814,3,2398,519
20,8,12,4,15,41415,12581,218,1960,476
15,3,12,4,8,117362,114631,89,69354,509
7,3,4,2,11,3775,3701,24,1321,414
18,11,7,1,6,139132,616,9,0,487
5,3,2,0,14,8417,0,2,969,693
10,7,3,0,2,19110,0,1,0,619
21,5,16,2,7,221951,109010,46,93432,600
17,10,7,6,32,945497,937615,20,909784,511
12,7,5,4,8,438926,79204,82,0,459
7,5,2,1,16,59149,23758,25,5051,503
90,10,80,10,10,71090,60767,298,15742,393
5,2,3,1,13,0,1162,29,0,643
14,4,10,2,17,18297,2161,37,1532,547
63,8,55,5,12,73922,18167,89,12706,540
41,16,25,2,7,369681,331,43,3698,465
21,7,14,4,13,201506,41730,54,15430,529
4,2,2,4,5,28525,47664,0,0,509
14,11,3,11,9,189593,238944,45,1347352,414
21,13,8,3,15,267652,31160,110,26833,512
22,4,18,0,17,3564,0,0,215,742
25,6,19,1,8,57458,624,29,284,545
34,16,18,1,22,1084473,10600,93,11500,400
8,1,7,0,4,8054,0,4,0,674
11,7,4,6,18,61097,63854,101,26844,413
16,14,2,2,17,564833,11683,106,13624,463
19,9,10,3,7,370523,87188,34,1375,460
25,7,18,4,9,27528,12591,43,2489,493
15,7,8,8,9,125408,324752,116,39427,521
20,2,18,5,9,23853,18612,14,4305,443
12,10,2,1,6,1083222,647,18,0,552
8,4,4,4,5,150457,189082,40,75662,462
9,6,3,7,6,12200,14227,48,3504,443
20,6,14,0,12,237052,0,20,3018,543
7,5,2,4,12,34215,35612,48,631,497
26,7,19,0,20,538211,0,0,2679,689
15,7,8,7,17,27678,32882,121,7600,450
24,10,14,0,8,92259,0,21,4941,541
46,6,40,0,13,371920,0,0,0,625
18,6,12,2,13,781794,19078,50,3300,463
12,4,8,4,14,93420,85090,60,222,552
33,7,26,2,18,39563,649,32,948,520
87,3,84,2,8,100126,96372,20,92254,513
29,4,25,1,12,156881,7719,17,7719,625
16,7,9,8,4,114056,123226,119,13530,440
14,6,8,2,26,51367,51367,23,40162,474
8,3,5,4,12,322129,45230,1,497,448
17,6,11,10,17,537401,633015,176,60112,433
22,6,16,2,16,243893,1952,82,3052,457
46,12,34,6,6,422447,25712,21,1753,445
21,7,14,4,8,56692,40930,145,14369,528
38,7,31,2,14,442889,8481,48,4460,498
5,2,3,4,6,11573,20441,48,1539,626
44,13,31,7,9,246967,60746,105,25954,421
8,5,3,1,5,38163,9,32,555,607
8,5,3,3,4,30464,392,32,251,506
13,7,6,3,19,94298,11480,29,8400,442
16,5,11,3,9,37485,29087,56,18749,425
31,5,26,3,8,48378,12134,152,5432,469
13,3,10,3,10,140674,84880,49,0,470
32,17,15,15,12,524807,415320,298,163036,429
12,6,6,9,15,4775164,5028654,16,743303,515
12,8,4,2,12,79181,22668,63,19494,562
13,8,5,4,15,87796,78083,64,59289,469
12,8,4,0,9,324239,0,17,0,560
21,8,13,5,15,25169,9488,177,24940,523
31,15,16,10,11,393204,365263,409,70405,440
31,1,30,1,18,971,971,2,5125,528
6,3,3,2,12,48407,11377,9,9378,487
32,13,19,14,18,758474,167638,222,37421,511
18,4,14,2,13,37591,22859,11,2534,466
28,17,11,7,15,1307011,680500,131,400933,425
11,9,2,5,34,516428,29342,81,3016,549
8,3,5,0,6,10785,0,12,909,645
9,7,2,6,4,23266,21788,210,6476,445
14,8,6,5,15,23691,34240,30,9134,462
5,3,2,4,6,9244,9244,56,3291,381
7,2,5,4,9,17396,20888,29,14277,455
5,3,2,3,33,12048,9626,16,5177,445
11,2,9,3,19,127517,49671,57,142,643
9,7,2,7,7,57156,51223,190,28151,484
4,1,3,4,7,9402,33872,54,9402,515
17,13,4,0,8,246591,0,0,0,692
39,4,35,5,9,114623,76199,77,38927,492
16,7,9,0,5,337957,0,96,394,609
13,9,4,0,9,84066,0,2,1220,566
17,3,14,0,5,15394,0,1,0,671
104,9,95,2,14,95610,20139,46,13020,609
7,4,3,2,7,36401,9836,83,6347,457
9,5,4,2,19,222878,85551,13,36605,503
7,5,2,6,5,21674,24071,160,7550,511
8,3,5,0,6,23837,0,9,320,587
5,3,2,2,14,271291,8045,40,1754,487
22,4,18,6,9,39098,63958,62,0,500
9,7,2,8,5,25066,28177,225,9931,433
22,4,18,3,19,20620,12535,22,10565,431
21,6,15,3,14,153479,8353,42,5560,559
17,9,8,4,16,1434543,243822,90,0,524
7,5,2,0,9,41530,0,1,0,550
13,5,8,3,10,583372,104360,78,0,494
14,6,8,7,9,40532,42153,162,7057,494
27,8,19,7,16,203982,191994,473,86346,472
23,15,8,0,37,2452522,0,2,1085,578
11,4,7,2,6,7171,5457,36,1703,482
6,4,2,4,9,479003,18012,64,10812,493
19,9,10,8,9,137728,90392,369,67342,519
9,6,3,2,14,84061,23494,0,4519,518
17,4,13,2,13,6666,2786,14,4130,494
17,11,6,0,30,115614,0,3,0,556
20,8,12,6,8,340238,17520,101,7631,450
13,3,10,2,10,6621,6621,69,4310,635
17,12,5,4,14,457640,91572,41,520,546
9,7,2,0,14,207783,0,0,315,587
18,8,10,8,15,290760,278157,156,8495,434
11,9,2,8,7,61398,51575,113,17134,410
14,7,7,3,3,24131,14404,0,0,467
5,3,2,2,11,13273,13074,0,0,453
4,1,3,0,13,355227,0,7,0,731
31,11,20,7,14,395901,41215,257,39779,427
6,2,4,1,7,12406,12016,39,11500,477
4,2,2,1,7,7278,7278,6,7278,555
11,9,2,3,5,149987,3259,8,1491,460
8,5,3,3,18,23132,23132,217,14252,473
10,6,4,3,13,553872,515495,26,7622,544
10,5,5,5,10,5986,5986,49,2689,591
25,19,6,11,7,43701,25735,389,10956,412
23,5,18,2,17,734430,34594,45,1735,605
5,2,3,1,18,1443,582,9,0,652
7,4,3,0,7,9324,0,11,239,634
13,8,5,6,29,202977,207778,57,1008,488
7,3,4,1,12,6184,6184,24,6184,573
15,3,12,1,8,8447,8447,112,10000,596
10,5,5,5,12,719048,46696,14,598,446
30,10,20,8,15,953223,157330,187,28062,451
42,7,35,1,7,178632,1736,92,8612,535
28,12,16,2,9,200132,5278,10,741,675
23,4,19,4,9,29972,29972,331,22964,490
16,8,8,4,13,32292,28031,269,30646,413
16,7,9,1,14,44017,6343,0,0,532
7,3,4,2,5,43114,47027,35,0,462
8,5,3,1,15,32892,830,24,0,572
14,7,7,0,8,183703,0,5,1111,643
30,7,23,1,4,51325,794,83,6237,452
38,15,23,0,7,130997,0,3,1949,618
10,4,6,0,10,522523,0,23,41295,524
37,27,10,12,6,538862,112182,111,45475,420
83,6,77,1,5,155571,120159,4,228,394
15,4,11,0,11,383400,0,139,29455,573
11,3,8,2,9,370986,7431,12,4060,461
23,12,11,6,8,282285,41727,77,2570,438
1124,5,1119,7,9,284422,331794,139,0,538
11,7,4,5,7,30467,29507,140,20515,485
5,2,3,2,6,245,245,43,1485,623
9,5,4,4,19,14321,12701,61,5394,519
20,7,13,8,7,81326,64672,163,7225,415
4,1,3,0,2,2582,0,2,884,399
15,9,6,6,17,938926,132069,73,0,515
6,1,5,0,8,497,0,14,1320,713
4,1,3,1,16,7534,7534,12,179,673
6,3,3,0,5,11273,0,0,0,649
9,6,3,8,11,19161,31410,85,5874,422
27,7,20,9,13,60330,148920,161,19338,429
17,7,10,5,9,65017,54041,29,26452,425
4,2,2,0,3,11356,0,29,341,672
12,5,7,0,7,43476,0,5,607,566
4,2,2,0,6,0,0,76,2684,684
4,2,2,3,17,23267,164437,38,0,670
17,4,13,1,5,26044,2063,2,2063,510
12,5,7,1,6,34025,487,1,0,550
7,5,2,5,9,41080,41080,110,6725,425
72,33,39,4,8,491144,14688,18,519,419
12,4,8,0,8,786512,0,0,0,592
6,4,2,0,6,122999,0,0,0,673
10,8,2,6,9,421987,28608,113,9515,458
19,9,10,8,8,22054,21661,174,5474,406
13,4,9,3,11,115600,32664,82,0,550
34,17,17,16,18,901079,292556,31,37421,511
30,13,17,7,13,1147214,426990,54,1102,450
7,4,3,1,20,296217,14954,44,14954,528
7,5,2,0,9,8195,0,0,949,626
6,3,3,4,7,8664,12495,44,8101,587
25,14,11,6,14,765940,110035,16,23603,440
63,12,51,3,14,302377,1832,76,29701,453
17,6,11,3,13,628292,35240,58,15647,507
23,9,14,8,8,270976,32330,129,5194,490
27,6,21,7,16,71327,147296,93,42243,423
14,9,5,6,11,47357,30218,95,2710,517
13,10,3,8,7,62027,52427,232,27743,469
14,10,4,10,9,49523,24838,150,7689,444
8,3,5,2,7,292845,3447,14,775,507
37,24,13,24,17,73342,83153,504,27335,414
22,5,17,1,16,35799,6724,97,6724,565
5,3,2,2,3,56168,22709,14,22172,552
28,10,18,7,12,1459969,359581,175,126944,423
10,5,5,2,12,17023,15125,22,14882,466
28,6,22,3,14,41658,32769,21,59654,557
20,6,14,2,15,67550,5920,36,1185,520
4,2,2,0,11,22779,0,0,1578,632
40,11,29,2,17,67013,8128,43,7671,465
19,4,15,5,12,130849,130849,75,57322,484
9,7,2,1,3,212938,442,14,0,511
9,6,3,5,14,24603,24601,107,10342,486
15,9,6,8,12,424196,53371,68,20433,455
12,2,10,1,13,61899,11186,18,0,644
21,9,12,8,15,1390374,609855,124,171204,438
10,6,4,1,35,176320,166331,24,166331,600
3,1,2,1,9,8097,8097,31,468,571
20,1,19,1,11,1214,1214,2,1899,591
8,1,7,1,11,124883,12997,70,1533,573
7,3,4,1,14,185898,36277,25,0,545
24,8,16,1,13,632493,1826,49,1826,503
44,20,24,3,14,305419,12949,372,4856,475
27,11,16,6,16,73721,47317,178,15681,427
7,4,3,0,12,10252,0,0,266,646
4,2,2,1,9,26115,9840,23,0,593
7,4,3,2,8,148841,21545,100,14790,508
33,6,27,5,8,35230,35230,223,16439,457
55,17,38,8,11,378613,292588,221,2924,516
6,3,3,2,4,84995,1732,43,738,541
26,6,20,4,10,21321,12866,21,6240,451
8,6,2,6,3,76103,70561,273,23264,540
5,1,4,1,8,9072,9072,24,815,628
42,5,37,3,18,32526,22097,28,13258,499
13,6,7,3,26,174881,152867,0,2680,529
24,10,14,3,15,485921,78941,10,1750,497
7,5,2,4,19,81216,36531,94,0,515
6,2,4,3,13,13768,13768,43,10723,560
12,7,5,1,6,20439,876,23,1051,468
8,6,2,5,9,27617,10001,44,9201,444
9,7,2,2,11,216732,7931,6,0,640
19,7,12,4,15,32144,26357,69,14852,493
11,5,6,3,5,52476,23701,71,9372,499
12,1,11,2,28,686595,690082,103,686595,525
11,5,6,0,9,29410,0,34,1551,428
10,4,6,2,6,146352,2253,0,0,470
14,6,8,1,13,16372,215,1,1137,627
17,7,10,4,14,32523,28898,98,19557,564
27,5,22,1,9,141310,957,60,3542,568
7,3,4,3,16,18989,23268,71,14710,495
29,9,20,1,11,284476,28919,19,21054,637
10,6,4,3,7,18853,12059,61,3670,492
11,8,3,0,7,201532,0,0,0,548
29,11,18,10,7,134832,119248,144,51690,412
10,7,3,0,14,295294,0,30,0,548
33,7,26,8,12,148270,222355,194,83455,423
11,6,5,2,69,9423,5114,16,4979,515
10,4,6,4,8,18999,26218,298,15574,521
16,7,9,0,9,710000,0,0,0,668
8,3,5,2,19,382422,99528,33,4600,463
16,7,9,3,10,10115,15130,60,5100,529
3,1,2,1,7,5355,5355,94,5355,546
12,8,4,7,16,786329,473584,30,15467,459
16,10,6,2,11,48843,5195,0,0,513
10,7,3,2,13,229726,61542,20,0,532
28,8,20,3,13,50435,4691,16,4342,522
21,11,10,8,12,211629,79232,147,8110,407
17,9,8,10,14,42522,40140,164,10126,473
18,5,13,0,14,70900,0,4,351,629
10,6,4,1,14,51870,5458,15,5458,607
12,6,6,4,9,24000,14887,107,0,484
12,7,5,4,7,26919,64709,33,27354,488
12,5,7,1,9,46094,1897,60,6664,452
11,6,5,2,9,6110,5862,196,8014,510
6,4,2,2,11,2170,2170,5,2640,512
14,5,9,3,15,35116,22114,44,0,498
40,2,38,2,13,106189,106189,37,42842,607
9,6,3,1,11,36467,4905,7,0,466
15,8,7,3,7,37838,11922,33,5654,454
34,7,27,5,11,605382,42144,66,38154,454
4,1,3,2,12,39418,39418,21,39010,629
13,4,9,7,7,25500,44360,195,13951,491
11,5,6,3,12,255639,23651,26,7320,478
24,13,11,3,9,544760,14411,64,16656,441
4,1,3,1,7,490,490,9,490,544
13,8,5,7,8,38127,38127,98,11581,445
7,2,5,0,9,430000,0,7,20,634
10,6,4,0,7,267339,0,35,0,524
39,7,32,5,8,12889,3321,23,6266,455
18,10,8,8,7,216415,19502,160,6013,423
30,11,19,6,11,180369,24296,85,10499,586
9,7,2,3,7,34712,2893,19,327,482
28,14,14,1,22,450334,202,49,19359,587
45,6,39,5,4,1175785,246412,54,2648,427
13,5,8,5,13,248102,36800,30,15541,397
11,6,5,4,9,26677,5561,57,5464,511
9,3,6,1,14,2126,13796,0,0,643
8,4,4,3,11,36971,14257,60,14541,468
4,0,4,0,4,0,0,1,0,638
43,11,32,8,17,68192,60076,214,18248,475
16,5,11,4,6,124417,17813,89,61602,422
64,2,62,1,7,4720,361,16,361,641
12,5,7,4,13,39005,34346,79,15311,488
15,7,8,1,10,172547,4966,32,1805,602
5,3,2,1,10,121706,120706,0,0,611
19,8,11,0,10,218826,0,0,0,583
5,3,2,2,6,45328,31766,50,900,515
11,5,6,2,4,370607,323620,20,0,526
19,10,9,9,10,65148,64533,456,11646,399
4,2,2,2,4,14490,3915,6,2994,436
17,12,5,0,9,115163,0,1,255,512
10,4,6,3,9,152296,38193,48,0,596
5,3,2,2,5,13472,8917,17,3627,442
49,17,32,1,21,401556,306558,45,4565,503
4,2,2,2,5,13228,8728,19,4268,491
14,8,6,1,8,157271,52106,0,0,540
18,6,12,4,13,33196,13219,25,3685,474
11,2,9,0,6,62005,0,2,1296,520
5,2,3,0,7,1243,0,4,711,659
10,5,5,5,8,6677,10298,28,2259,478
17,2,15,1,19,15583,15583,7,11102,479
21,5,16,2,18,298839,103931,223,101587,567
30,6,24,1,14,194950,81276,22,81276,405
21,9,12,0,13,755802,0,4,0,591
13,9,4,6,8,20837,17803,17,1798,432
8,6,2,5,7,134242,51282,43,2813,409
18,10,8,0,14,540077,0,3,0,712
20,15,5,3,69,736131,47536,43,0,453
9,2,7,0,7,295489,0,98,7329,443
10,8,2,0,12,194546,0,0,0,698
7,3,4,2,6,72286,65740,27,0,464
13,4,9,1,24,205879,829,43,1665,653
28,8,20,6,15,714917,98817,282,50899,443
8,4,4,2,22,536006,13331,29,0,528
20,16,4,14,11,500079,38278,133,4370,398
6,4,2,4,8,5359,5359,44,1929,583
10,6,4,5,5,22831,21102,92,3438,443
27,14,13,15,7,526257,93416,132,15400,447
52,15,37,4,12,207431,96643,145,7601,449
12,7,5,0,2,415493,0,0,0,627
11,9,2,1,8,107810,880,33,880,561
25,11,14,1,18,5557307,4704,16,0,575
16,4,12,3,11,53888,40162,23,15999,469
25,10,15,1,17,694592,7648,46,0,635
23,17,6,0,24,128034,0,68,2211,560
34,14,20,9,29,177465,148158,466,55208,508
13,6,7,2,9,177521,23108,0,0,457
23,4,19,1,14,40368,301,0,357,637
154,9,145,1,8,609877,11,25,1322,512
21,14,7,10,10,562536,250310,190,54545,391
10,4,6,2,9,282578,57666,26,872,507
35,7,28,6,12,38437,12887,78,3687,451
21,10,11,1,14,596678,5183,8,5183,388
30,5,25,3,9,20874,8232,62,643,482
24,12,12,8,22,387234,46545,160,7994,421
15,10,5,0,8,406258,0,13,2435,579
18,8,10,7,6,140916,62053,55,8547,434
19,11,8,10,9,344294,101746,241,26086,496
61,10,51,3,17,472293,247663,84,188046,435
25,3,22,2,18,6925,53066,27,1548,697
4,2,2,0,2,8450,0,0,0,625
10,3,7,2,25,497854,9479,61,12300,544
11,6,5,1,4,35981,3576,17,3576,583
8,6,2,3,7,39710,7765,31,747,464
10,7,3,2,13,686159,80480,39,32540,526
13,11,2,4,7,82481,29886,54,307,442
5,3,2,3,21,68448,65396,71,31844,466
35,5,30,4,9,6258,6258,332,19501,433
4,2,2,4,7,13875,22479,285,7789,521
20,10,10,0,7,392530,0,0,0,627
11,5,6,0,8,52541,0,2,0,642
63,8,55,9,7,161064,149273,124,5482,472
50,14,36,9,13,112338,43183,90,5480,426
14,10,4,10,8,773820,486598,182,0,504
15,5,10,4,13,39555,4722,47,2200,497
13,5,8,0,18,0,0,40,2940,669
11,3,8,0,11,1129493,0,0,2509,644
42,8,34,6,16,142594,65058,253,5130,474
10,3,7,4,11,296196,18367,76,3015,536
15,4,11,3,10,7209,64795,60,10566,555
53,14,39,3,14,75589,39381,38,31615,459
17,4,13,2,6,20520,9896,36,3400,472
12,9,3,11,14,321518,529589,200,2437,450
92,9,83,1,12,80801,1568,10,2643,513
14,2,12,1,8,12364,12364,123,12364,665
15,7,8,1,22,398115,5455,15,591,589
8,3,5,1,13,4727,723,86,6822,385
47,24,23,25,20,861691,590503,283,76659,349
36,11,25,5,22,140788,8095,114,2597,487
17,2,15,4,11,1203678,241308,77,0,637
12,6,6,0,17,129404,0,12,0,506
24,8,16,0,8,235207,0,134,2134,592
12,7,5,8,15,117897,187935,33,9720,478
20,15,5,0,12,667538,0,20,1534,579
9,1,8,1,11,0,7310,0,0,705
72,56,16,48,13,266378,93810,1100,14722,394
8,6,2,0,6,48556,0,0,0,507
8,4,4,0,9,905400,0,14,301,717
21,8,13,6,18,41913,33588,3,1550,498
28,8,20,4,18,165374,36607,138,11281,481
55,8,47,8,17,62737,50749,441,21522,498
12,3,9,1,5,1245,1245,22,2051,507
19,8,11,4,12,60070,26832,17,10848,446
7,5,2,4,3,167149,100109,134,15785,532
9,6,3,2,17,39882,33312,15,22092,432
8,6,2,4,5,207459,41884,17,5155,427
15,7,8,6,14,594238,107176,75,46765,422
32,9,23,4,30,1281865,316656,82,204352,581
24,9,15,6,10,167289,38285,50,13177,432
26,11,15,7,18,528328,96800,124,33636,430
30,22,8,23,6,71907,1513724,505,48645,456
4,2,2,1,11,1783,1709,3,0,503
12,6,6,2,11,15115,8682,48,8498,546
12,4,8,2,10,272340,14303,58,10214,525
9,4,5,0,9,47875,0,0,0,634
9,5,4,3,10,4398,3474,40,5259,394
41,5,36,3,19,157043,107722,81,63738,534
10,5,5,3,19,29929,24209,56,17126,400
9,6,3,5,7,42652,35920,72,11200,475
21,10,11,2,5,368662,3225,13,3045,489
15,9,6,8,19,51488,54294,25,9224,421
17,9,8,10,7,122777,119752,287,45780,462
9,4,5,3,8,15720,15720,32,9848,523
10,8,2,9,5,68997,71335,72,16959,458
13,9,4,6,12,81930,37335,40,17089,460
20,4,16,2,5,32279,8638,6,5011,449
6,2,4,1,7,152914,1420,16,1420,579
30,13,17,7,14,114784,45211,83,18976,452
35,8,27,5,9,302365,5602,115,5647,486
5,3,2,3,3,10381,7558,36,125,486
23,9,14,8,7,64942,50890,149,16999,439
8,6,2,5,12,633408,29251,89,11987,447
8,3,5,2,6,10814,3517,46,1140,623
31,12,19,0,12,438540,0,37,5179,443
12,4,8,3,28,106312,50114,50,41242,504
2,0,2,0,4,0,0,3,1250,669
10,4,6,2,13,294368,10189,33,3549,561
15,5,10,4,5,24630,11689,26,4678,459
17,9,8,4,11,412996,24802,32,5283,461
18,8,10,4,21,1257909,33800,87,5113,527
21,7,14,7,11,19326,37121,164,19680,502
11,6,5,3,8,17083,17083,48,3414,502
11,6,5,0,6,149771,0,0,0,641
16,7,9,4,22,27300,27300,101,5877,488
7,4,3,3,14,33635,9092,30,5560,471
10,5,5,1,6,21805,876,79,876,392
16,6,10,3,12,29208,28464,20,11556,405
13,10,3,5,8,83137,865,16,261,464
18,4,14,1,7,79630,12677,40,0,492
15,5,10,2,3,43211,8390,18,7299,457
42,14,28,6,11,372516,216220,177,5971,462
8,6,2,3,9,482579,48449,122,62568,451
18,5,13,6,10,460909,58363,105,5838,468
10,6,4,3,8,522125,27146,94,6603,490
3,1,2,1,8,0,16364,28,447,588
6,0,6,3,10,0,6232,52,0,575
20,8,12,6,18,37466,26242,0,0,464
10,7,3,8,18,51292,49012,64,16119,466
16,6,10,7,15,88846,100019,103,28809,479
8,6,2,2,12,217410,18052,16,12184,447
18,7,11,5,7,72141,49842,57,40930,451
16,9,7,9,4,54957,59782,330,11912,440
6,3,3,5,4,8015,11506,29,3491,452
25,9,16,4,10,373237,28802,13,5369,501
8,4,4,0,12,604612,0,1,3583,665
15,7,8,2,7,102118,51787,99,1269,444
14,7,7,4,12,800316,508868,52,460479,427
9,5,4,2,7,14702,55255,40,0,598
5,3,2,0,3,29963,0,15,55,634
9,6,3,0,16,13850,0,10,0,614
18,12,6,2,13,432161,866,23,831,458
6,2,4,4,12,105209,105209,31,0,432
20,12,8,1,31,419570,10630,11,0,567
4,2,2,1,6,16819,6785,25,19418,505
7,4,3,4,7,12308,7710,78,0,556
14,6,8,5,16,28466,25738,62,8802,452
45,7,38,2,10,375188,56885,224,56595,483
11,3,8,2,11,43000,2315,14,0,600
12,8,4,3,11,347089,25258,69,1047,526
18,13,5,1,14,510955,13350,17,207,517
37,11,26,1,14,586454,47692,58,1923,578
6,3,3,0,6,16571,0,17,1725,542
9,7,2,4,4,10003,9676,165,5582,376
21,7,14,0,5,6238,0,15,2774,656
15,4,11,2,17,202550,58633,54,1018,532
3,1,2,1,9,4579,4579,3,4579,628
15,11,4,5,14,456190,71314,145,20024,427
12,7,5,2,8,234984,33233,5,0,469
17,10,7,5,9,39704,36031,65,16620,414
14,8,6,3,8,151876,85689,51,46827,544
8,3,5,2,16,565865,30556,99,39515,489
30,10,20,8,15,45466,61349,203,20812,377
18,9,9,0,5,680386,0,4,0,517
5,2,3,1,8,122626,1421,19,1421,641
11,6,5,1,5,258821,872,23,0,573
6,2,4,2,9,23656,23656,91,22648,522
7,3,4,4,6,13793,5919,23,3923,419
123,14,109,16,22,165812,193709,709,32811,402
11,3,8,1,11,117427,26065,28,26065,687
25,3,22,3,18,12657,10721,71,6800,575
10,3,7,3,11,7088,8407,50,3959,484
3,1,2,1,8,5581,5581,31,5581,646
14,10,4,0,8,286619,0,10,0,630
13,9,4,8,16,47733,59938,60,12014,414
27,10,17,2,17,3401960,47287,20,0,497
7,3,4,3,13,101249,58823,76,0,497
16,14,2,8,12,770351,151888,10,43009,408
17,5,12,3,7,341827,179224,46,6205,466
22,11,11,15,8,214030,303040,223,583,442
22,8,14,4,10,29309,11595,38,3194,383
15,6,9,3,8,41187,5970,34,4549,511
20,13,7,4,7,113534,19958,17,9468,466
69,4,65,1,8,9773,208,34,740,558
24,10,14,1,11,250142,4651,8,658,612
38,12,26,6,11,197360,117494,57,17553,496
10,2,8,1,13,19985,17820,26,17820,608
9,7,2,0,10,36124,0,0,0,578
39,17,22,6,13,363219,43683,133,719,468
12,7,5,7,9,19079,19078,88,6658,477
33,12,21,10,12,89699,100031,595,39345,549
18,7,11,7,19,72984,18291,58,5578,477
6,4,2,3,11,243370,58475,48,541,522
12,3,9,2,8,20036,6912,0,0,525
24,12,12,0,7,511292,0,0,0,669
13,4,9,2,11,270271,5660,57,6897,454
20,9,11,4,7,394093,13550,10,10400,502
10,5,5,4,11,14252,85052,218,12403,481
7,4,3,2,6,29544,22210,0,0,595
7,5,2,5,7,5133,5133,67,2231,540
12,8,4,6,7,20560,19363,78,5170,431
7,3,4,2,9,15350,1074,108,805,474
25,9,16,6,9,95567,36975,99,14435,515
18,7,11,5,13,348589,31023,117,13574,476
24,14,10,2,17,185527,11043,89,9784,572
28,4,24,1,13,115328,1139,4,4952,471
8,6,2,6,7,27789,36051,68,13086,522
8,3,5,5,5,35832,27665,0,0,478
21,10,11,0,7,105977,0,3,0,547
9,2,7,2,11,25642,25735,0,0,455
38,12,26,7,17,339835,21341,65,4950,448
28,14,14,14,7,316294,311894,338,55808,416
12,4,8,2,2,20344,6948,7,7654,490
15,4,11,4,10,683859,43307,27,4004,423
18,3,15,1,19,7913,348,11,6366,522
10,5,5,0,16,352253,0,4,0,608
20,7,13,0,21,279377,0,2,27,652
16,5,11,7,11,29519,60067,143,4819,494
35,3,32,1,6,299367,8834,36,0,519
16,11,5,4,12,329213,16296,49,38014,418
9,3,6,1,38,239875,23712,39,28723,502
23,6,17,4,10,32410,46192,240,41625,446
5,2,3,0,6,111394,0,22,0,607
34,12,22,3,38,577685,33323,47,3898,450
12,2,10,0,20,159942,0,0,0,629
14,6,8,0,7,647190,0,14,0,608
11,7,4,6,8,16702,16702,200,13570,504
12,10,2,6,22,84326,82002,110,888,479
52,12,40,4,8,190745,11458,117,7314,417
5,3,2,1,3,113364,2652,4,0,580
18,7,11,2,11,334438,13603,78,0,491
41,11,30,8,11,940848,369368,388,56446,450
26,2,24,2,5,21938,19696,28,4428,491
8,3,5,3,13,27486,27486,35,13549,444
6,1,5,4,9,534,10963,34,534,545
18,16,2,14,7,262857,259492,56,18138,442
18,2,16,4,10,19750,23934,160,6241,473
10,4,6,4,14,478281,61578,57,5985,536
9,4,5,0,10,27788,0,2,228,514
18,6,12,2,11,409752,27101,51,2921,528
39,20,19,12,9,209018,166174,383,9439,414
8,3,5,2,4,22281,20933,57,20633,577
10,3,7,2,15,415839,415839,55,24083,500
13,8,5,9,11,75490,89632,72,20185,474
39,10,29,5,10,202517,126325,0,0,481
10,3,7,3,8,1845,17197,82,2440,540
6,3,3,0,6,4472,0,0,0,711
23,6,17,3,8,37037,19929,54,7962,454
3,1,2,1,6,8379,8379,46,0,510
20,10,10,2,14,400819,12849,26,7510,408
9,3,6,3,8,29117,41072,20,5432,515
6,3,3,4,9,3999,12461,15,1350,482
9,6,3,0,8,183319,0,0,0,688
18,11,7,2,22,1600525,914392,90,874134,430
15,2,13,1,17,5616,5420,20,5420,501
12,2,10,2,8,19330,21399,39,12256,581
15,4,11,2,15,59795,14242,14,3986,495
8,2,6,2,9,8127,8127,49,7087,503
13,5,8,4,14,9347,32964,68,0,584
11,3,8,0,3,27366,0,0,0,553
19,2,17,0,8,10286,0,52,1852,605
27,5,22,0,11,16132,0,183,1808,500
29,13,16,9,9,111052,80894,307,10226,458
10,2,8,0,12,225252,0,8,0,649
14,8,6,5,8,103401,42695,26,551,518
12,8,4,2,11,65212,22787,0,0,504
79,13,66,13,10,394701,122549,282,46453,423
9,5,4,2,10,36668,35465,56,5352,518
18,3,15,2,10,1697474,257205,49,0,675
11,5,6,4,14,196251,35019,24,2264,456
27,6,21,3,8,68457,11068,86,4373,466
12,2,10,2,12,8151,4664,34,4169,478
10,8,2,6,5,58471,12135,24,0,448
21,9,12,12,11,65632,93486,239,20382,339
20,8,12,0,8,112231,0,1,0,621
6,3,3,2,6,91553,38267,40,0,523
22,13,9,0,13,1881841,0,9,52,503
7,3,4,2,15,4603,4603,14,2489,509
5,1,4,3,7,30452,37333,61,286,488
6,3,3,4,9,30303,46871,54,28626,440
55,6,49,4,8,344222,316400,1,6270,439
36,9,27,1,16,119912,1122,92,20333,469
4,2,2,0,3,18271,0,0,0,607
14,7,7,8,10,52497,50448,84,13800,477
17,10,7,1,12,90030,195,3,2615,476
25,5,20,0,9,94023,0,36,3583,549
15,9,6,8,26,37165,36126,114,1149,527
7,3,4,0,6,5711,0,24,2008,644
13,10,3,8,14,1041119,336379,138,216,460
29,8,21,0,16,44414,0,0,450,644
21,13,8,9,10,588241,233836,220,38416,478
19,8,11,3,19,219886,30740,46,18841,495
9,5,4,0,10,189277,0,74,0,444
5,3,2,0,4,17411,0,20,382,598
5,2,3,2,14,32211,32211,51,25000,559
6,3,3,1,14,18141,1059,27,860,548
25,6,19,6,14,270826,197752,123,145230,594
6,2,4,1,14,26170,4647,6,236,493
18,8,10,1,7,330613,973,18,0,549
12,6,6,6,15,523660,45779,118,10249,459
26,7,19,3,29,552681,13119,89,24036,453
26,11,15,1,11,212379,169,20,1009,551
27,6,21,2,9,127483,4683,95,3388,451
18,6,12,4,16,29232,31152,90,26254,412
18,5,13,0,10,43365,0,0,0,696
3,1,2,1,19,13203,4401,10,0,639
35,17,18,15,12,732710,377801,218,46465,375
22,14,8,13,9,2027114,1101994,241,0,415
28,12,16,7,16,2669989,292138,13,545,443
23,10,13,6,12,461278,112886,224,52483,463
9,6,3,6,13,82621,37218,102,19889,474
19,8,11,5,13,71774,66774,10,18082,492
27,8,19,5,18,197719,24267,77,19287,526
11,4,7,1,20,27931,10030,12,138,528
6,4,2,4,11,3228,3228,87,1250,536
49,4,45,5,7,37763,60281,70,28243,464
11,4,7,2,8,24807,13923,58,5264,534
8,5,3,3,14,213055,4855,24,8090,447
23,3,20,2,12,7835,1530,51,790,544
12,7,5,7,15,68627,73818,188,30395,453
12,8,4,7,8,34483,20485,14,2988,468
8,4,4,4,10,41084,40865,30,20536,473
35,17,18,12,14,639988,332327,191,73026,449
34,14,20,7,18,170740,26077,145,2657,514
14,7,7,0,12,12724,0,0,0,692
11,7,4,5,10,17611,20683,95,10415,492
12,10,2,0,4,43221,0,0,0,642
43,11,32,4,11,375636,18412,52,7968,443
9,7,2,6,9,342210,62774,90,0,442
25,8,17,7,12,361336,42470,182,22464,413
40,9,31,1,12,80617,219,96,1109,520
7,4,3,0,7,75088,0,2,1230,629
11,5,6,2,10,2384,1628,20,577,433
13,4,9,2,16,37944,33086,11,16543,471
13,9,4,1,2,86407,1431,1,0,621
13,6,7,6,15,84435,101660,22,2550,457
7,4,3,4,12,389455,46880,59,9093,411
73,8,65,4,17,181633,109836,319,52625,585
24,2,22,2,11,8840,8840,54,6850,575
22,5,17,4,12,205884,21539,15,6320,515
7,3,4,2,13,89966,89966,51,71707,446
8,2,6,2,12,21438,31395,0,0,691
62,15,47,6,7,212471,21678,62,18584,550
9,6,3,5,5,16143,15850,40,3174,482
5,3,2,2,15,555977,102649,13,12594,560
5,3,2,0,8,0,0,0,0,770
4,2,2,3,12,22965,42054,24,19586,426
17,9,8,9,8,346084,97406,244,10640,488
14,5,9,5,16,32026,43590,162,13914,454
8,2,6,1,19,834709,302011,25,3683,554
8,4,4,1,22,86721,2984,4,2984,575
18,3,15,4,13,13165,16975,45,6367,438
12,3,9,0,13,4465,0,0,0,756
21,7,14,5,12,29591,33900,0,0,481
43,13,30,1,12,542725,1869,25,600,477
19,9,10,0,27,683232,0,18,10216,521
6,3,3,4,7,11706,26068,43,14362,428
12,6,6,4,8,59769,59043,89,6737,482
38,7,31,8,14,47945,49954,190,9097,468
11,2,9,4,16,6709,12642,69,6709,587
5,2,3,2,5,1202,1202,237,2194,470
29,5,24,1,12,11446,21913,19,468,569
21,9,12,7,8,59196,58950,120,3618,400
14,6,8,3,10,76017,71521,55,0,553
16,12,4,13,14,143031,96781,342,13600,418
58,17,41,13,7,291322,83182,313,18605,465
9,6,3,1,9,28351,2816,15,8410,494
21,10,11,7,16,481802,102744,91,6650,498
29,8,21,5,8,109603,114204,118,10973,466
7,4,3,4,4,42485,38361,72,1141,487
19,8,11,0,9,577625,0,6,0,559
10,7,3,5,12,668105,212609,77,1210,400
5,2,3,1,11,25091,15347,11,15347,465
8,6,2,0,11,112358,0,0,0,557
36,10,26,3,14,801431,2805,174,2204,450
59,18,41,14,12,454741,400391,337,14603,426
16,11,5,13,6,71222,96827,295,14799,376
20,13,7,13,18,687084,235872,184,6305,425
6,4,2,1,6,37396,7699,25,0,539
19,6,13,3,21,158177,16029,75,1413,462
23,12,11,16,12,348684,49826,107,17442,485
4,2,2,3,7,20134,15381,11,11743,484
12,7,5,6,8,74126,77664,115,13905,550
11,4,7,0,11,339873,0,0,4952,677
17,8,9,4,13,209890,66117,82,24757,435
17,9,8,1,15,712438,7997,23,5712,578
13,9,4,9,11,164010,91596,0,0,445
14,4,10,1,5,31882,4499,36,1090,528
9,6,3,9,9,159438,209500,203,7988,423
37,2,35,2,10,6318,6318,12,2075,427
11,4,7,1,12,34973,468,57,4071,586
28,12,16,2,22,254647,25136,44,2415,568
83,10,73,3,6,143890,28580,34,13925,513
5,2,3,2,7,369697,52684,28,13887,482
27,3,24,2,7,21178,21178,51,324,460
16,5,11,3,6,139596,13190,80,61602,422
10,8,2,1,6,20315,1695,0,0,500
50,14,36,9,16,333868,78800,577,10890,382
15,8,7,0,11,259843,0,1,0,556
29,5,24,8,15,234876,245743,85,88536,509
11,7,4,7,7,43476,43401,123,18120,381
6,4,2,4,21,9712,38512,22,3510,542
21,6,15,5,8,299243,6986,34,2827,478
6,1,5,1,9,686,9559,19,0,572
12,5,7,0,5,11114,0,46,486,584
18,2,16,0,3,25542,0,0,0,636
26,7,19,5,9,29833,13263,123,4340,508
26,10,16,14,9,469270,138058,257,31914,414
14,3,11,1,12,113544,10835,18,0,633
36,5,31,5,18,60865,60744,132,28886,507
32,5,27,5,12,18006,27091,240,10954,443
19,10,9,3,9,1028968,19695,105,13416,480
46,9,37,6,12,34887,16117,61,3840,481
20,11,9,3,9,361957,13668,67,3720,466
13,8,5,2,8,351519,131129,23,10409,463
3,0,3,2,8,15988,15988,0,0,652
29,4,25,1,21,22619,250,17,0,616
6,4,2,0,5,62886,0,3,0,606
5,0,5,2,5,0,3947,36,3500,552
21,9,12,9,12,52563,61277,202,10016,422
13,9,4,6,17,61614,42430,109,11195,453
63,20,43,18,14,409663,225119,335,70200,439
2,0,2,0,1,0,0,0,0,606
7,5,2,5,8,40971,52162,93,3266,499
39,11,28,0,8,189958,0,1,8791,571
58,4,54,2,13,16202,5265,82,5071,519
29,2,27,0,10,33272,0,15,947,607
8,6,2,0,7,339094,0,1,0,608
38,11,27,3,8,146268,12800,45,9864,496
8,5,3,2,8,410056,39379,51,0,547
12,8,4,3,13,531038,177626,64,19994,492
11,2,9,1,13,2719,2719,31,3539,523
79,12,67,8,15,449415,123163,504,56854,473
15,5,10,2,8,26614,69913,75,66741,568
18,9,9,7,15,127359,43584,82,15171,446
30,6,24,2,14,267764,5890,45,4350,520
21,6,15,6,10,115885,115885,412,66035,451
25,4,21,0,69,6346,0,6,410,664
26,4,22,0,14,21095,0,72,0,620
7,2,5,0,28,0,0,0,0,683
10,2,8,2,69,21644,130268,14,0,640
10,2,8,3,8,34234,17994,63,4002,446
37,20,17,8,18,766597,180336,63,11286,433
7,4,3,2,18,24816,3376,8,1643,561
28,14,14,0,13,671717,0,22,0,541
13,8,5,5,11,37260,32524,98,41133,480
15,3,12,0,4,116164,0,1,6400,548
21,9,12,0,16,242473,0,0,0,612
8,6,2,4,5,267877,34865,0,0,449
89,22,67,1,15,240956,6898,51,8160,469
88,14,74,6,20,367262,103465,34,8401,501
14,4,10,5,10,17166,15347,90,5606,490
7,2,5,1,5,17151,11960,103,11960,639
26,8,18,5,13,67049,59475,55,20133,536
33,10,23,8,11,127659,161865,220,15573,453
12,5,7,0,10,467755,0,9,0,662
9,5,4,2,10,18296,726,7,582,507
27,14,13,6,8,208700,115855,133,44489,410
12,7,5,2,8,35955,14470,127,11078,449
19,7,12,8,9,111026,162771,159,13400,445
11,5,6,5,13,35435,32439,320,19579,492
2,0,2,2,7,0,68509,19,0,682
4,2,2,0,5,5546,0,2,1001,598
14,8,6,4,9,304770,11649,31,4987,477
16,6,10,1,13,41508,16594,25,16594,488
21,9,12,0,8,226350,0,4,10193,594
25,5,20,2,12,28245,30017,30,20330,586
6,2,4,2,10,6711,4879,26,0,518
24,6,18,3,16,71782,21169,52,22404,398
41,7,34,1,13,41370,1499,39,2214,541
8,2,6,1,11,313777,1928,68,3067,503
20,5,15,1,5,25809,5085,21,3317,489
3,1,2,1,9,0,776,5,0,688
10,6,4,1,8,446775,3305,2,3737,494
18,10,8,7,6,84631,50431,125,1506,433
60,26,34,6,13,1216377,4683,26,6030,513
28,7,21,2,8,97098,8015,183,5614,475
19,5,14,5,10,397564,48745,75,3698,462
47,17,30,12,11,170274,30563,180,4847,457
12,5,7,6,15,421221,426758,158,178854,444
18,8,10,1,13,704653,3116,16,0,513
18,5,13,0,9,133940,0,1,1028,672
22,10,12,0,13,354095,0,8,0,626
22,8,14,6,7,29812,21125,172,6960,449
7,2,5,1,7,5529,4882,0,0,627
20,9,11,13,20,675456,1081124,237,292477,493
5,3,2,2,7,201162,22574,17,0,522
41,17,24,9,9,102873,39878,371,16355,429
8,3,5,3,17,72861,110339,59,62902,472
4,0,4,0,3,0,0,0,0,615
14,8,6,4,10,224766,108126,48,45917,584
27,9,18,7,11,405945,54896,213,21011,404
5,3,2,0,5,18060,0,0,0,679
29,16,13,9,15,138792,80740,142,11689,443
21,2,19,3,13,4697,31663,24,0,660
10,7,3,1,12,79937,313,8,0,498
15,8,7,0,6,603365,0,8,0,575
21,12,9,0,5,281095,0,17,504,486
293,18,275,8,12,285360,53478,233,2975,451
18,9,9,10,8,187411,164204,164,3406,457
22,8,14,6,14,276129,49130,238,17136,474
10,5,5,0,9,693990,0,0,437,676
23,18,5,20,11,460747,546891,496,0,496
12,3,9,0,11,13050,0,4,532,625
12,3,9,0,13,40967,0,0,1948,631
5,2,3,0,8,12488,0,0,0,644
46,22,24,19,10,1813513,1107167,64,20085,484
5,0,5,1,7,0,3603,0,0,517
25,5,20,4,13,48897,24012,80,4998,523
26,13,13,12,10,1076808,288718,0,0,439
139,6,133,2,13,45088,38887,171,24014,506
8,4,4,7,6,46942,77485,144,18100,449
10,7,3,2,6,24065,9103,0,0,515
48,19,29,0,24,846479,0,33,5870,495
8,2,6,4,10,51764,94775,53,29877,493
9,4,5,1,12,290300,12684,20,27670,592
21,8,13,5,10,49229,47737,42,28003,469
19,2,17,3,9,52418,55199,68,0,597
23,13,10,3,11,83256,11991,164,2318,514
22,7,15,2,19,37777,5641,57,11565,463
7,3,4,5,7,108431,154552,58,98946,486
17,4,13,0,12,50931,0,1,1000,688
19,6,13,5,16,148483,55463,115,21640,433
22,8,14,0,9,210248,0,0,0,598
10,7,3,2,12,272593,1579,0,8733,471
27,11,16,5,17,61609,3782,45,997,431
4,2,2,0,8,31906,0,0,0,654
10,7,3,5,18,964899,115092,113,0,522
18,4,14,0,13,151601,0,22,2394,628
13,10,3,6,7,59629,44611,214,17400,457
10,4,6,3,8,359458,14608,40,1805,451
23,11,12,5,10,78683,47322,95,5053,442
20,11,9,4,8,263603,34716,71,0,489
9,7,2,0,25,776918,0,8,0,611
4,1,3,0,10,1,0,5,3054,641
10,2,8,0,14,394311,0,5,51449,633
9,4,5,0,6,10704,0,36,0,547
20,6,14,1,12,315882,2378,20,0,549
10,6,4,2,14,706995,407921,30,0,470
17,8,9,7,16,37822,34826,26,10249,377
8,5,3,0,6,432153,0,0,0,526
23,2,21,3,9,9321,8460,158,3230,580
13,8,5,3,13,414507,13391,81,5694,520
9,5,4,2,10,21746,21746,132,18480,528
4,2,2,2,16,17710,482,6,652,601
25,10,15,8,6,54595,28248,339,8727,427
31,3,28,5,9,140222,20981,50,8022,527
21,10,11,2,45,87270,14824,43,1818,480
13,2,11,0,12,24463,0,0,16563,629
4,2,2,1,11,20078,10579,11,10579,545
8,5,3,1,12,353135,29277,0,0,523
7,4,3,0,6,80215,0,11,0,667
19,12,7,9,8,317096,270076,118,164555,407
26,2,24,0,2,8745,0,1,2406,573
6,3,3,0,11,203878,0,1,0,632
21,7,14,4,13,31300,25797,35,10204,466
6,3,3,4,12,159461,195343,85,117276,468
26,10,16,4,12,78677,79055,143,11929,489
5,2,3,1,9,30871,3241,48,0,524
42,7,35,3,5,58462,13753,415,9197,464
40,5,35,6,13,75236,70768,150,28778,444
4,1,3,2,7,38180,38180,29,4475,488
28,4,24,2,6,14004,12004,244,7530,468
16,7,9,5,31,806684,140897,90,577,490
6,2,4,1,44,7935,7935,17,7935,570
12,6,6,0,10,85981,0,0,0,668
8,4,4,4,14,66319,64894,107,1620,491
19,6,13,2,8,40564,4984,66,838,543
17,8,9,6,11,35291,34941,99,9914,459
15,6,9,3,16,192934,8201,330,6286,443
26,15,11,13,9,166682,120456,784,47259,420
14,7,7,3,11,549902,39840,48,1929,474
24,8,16,4,16,617629,33369,144,3222,527
15,5,10,1,10,475651,7867,8,9469,547
11,6,5,3,8,70356,4412,44,3354,463
6,3,3,2,12,218111,6474,40,6164,550
22,9,13,1,14,447683,30906,3,5271,409
18,2,16,4,10,17873,28852,61,15437,548
19,6,13,4,8,173807,188724,148,113603,509
25,6,19,4,9,101667,73211,25,26989,453
4,2,2,0,8,19206,0,2,0,624
11,7,4,6,13,29471,40796,99,6200,508
14,11,3,0,8,1060447,0,10,0,669
48,21,27,8,9,153555,26508,148,19099,565
10,3,7,0,18,202235,0,12,2803,646
16,6,10,5,11,3554,3554,25,1796,418
6,3,3,0,8,5063,0,17,0,699
6,1,5,1,7,6888,328,73,656,565
13,3,10,2,8,9528,6723,59,2548,551
10,3,7,0,8,5611,0,1,0,631
9,7,2,2,11,813503,18808,70,0,624
5,2,3,1,13,50034,50034,97,50034,655
21,6,15,4,9,26524,18610,79,0,537
14,9,5,5,12,360552,28388,119,7627,455
19,9,10,8,7,43457,43457,393,14825,445
106,10,96,4,14,87040,46440,66,17612,469
13,7,6,8,9,58516,61158,142,4943,465
8,3,5,1,15,6862,1728,25,0,539
24,8,16,6,14,92291,67329,114,23394,536
16,12,4,1,28,195504,62,2,610,641
16,9,7,5,6,51863,8160,50,4309,463
14,10,4,6,17,43671,33985,135,13841,425
19,8,11,0,6,28736,0,0,3004,626
11,4,7,4,12,37144,46935,82,0,514
15,8,7,4,9,83159,29648,47,1,486
28,8,20,2,5,101328,12908,16,10561,437
10,4,6,2,15,932713,171994,41,20813,460
16,9,7,9,11,59370,52559,85,17566,426
37,7,30,6,20,160722,120805,54,8514,446
22,8,14,3,16,53469,7269,50,5147,487
11,5,6,4,19,58354,43444,69,6238,499
7,3,4,2,6,0,21275,33,235,488
22,7,15,4,9,46163,101014,82,8826,469
8,5,3,0,3,21346,0,0,0,503
12,8,4,6,9,54353,67053,91,34832,440
14,7,7,0,19,1067504,0,0,775,688
9,3,6,1,10,38230,1499,3,2617,445
24,15,9,7,21,213107,56152,101,3300,384
18,6,12,3,3,23488,3596,51,6639,449
7,5,2,0,3,21631,0,14,292,580
19,5,14,4,14,335359,129071,195,24568,494
11,9,2,2,14,336899,208495,2,0,608
5,3,2,4,8,13154,17320,69,1488,473
16,3,13,1,9,88340,20161,14,4420,525
10,7,3,6,11,26421,21930,283,6407,469
8,5,3,0,15,361032,0,0,1682,620
9,2,7,1,9,17559,2672,25,0,564
7,3,4,0,12,0,0,138,23347,423
6,4,2,2,10,298293,3045,28,2639,591
12,5,7,5,13,43583,51247,125,0,516
12,6,6,3,17,33064,29742,23,12872,456
13,8,5,6,30,268915,55069,135,20438,500
8,5,3,3,13,38847,46780,67,13555,437
28,2,26,0,15,222326,0,200,38367,511
9,2,7,0,2,1179,0,0,0,637
22,2,20,0,11,382,0,100,771,541
8,4,4,2,8,45411,6599,31,3691,504
7,5,2,4,3,10767,9930,23,1410,494
7,4,3,1,14,24255,19656,27,19656,514
18,9,9,2,11,280120,41321,14,1350,526
14,11,3,0,7,373305,0,0,0,615
9,3,6,4,6,13377,13377,65,10112,424
28,10,18,2,11,71988,7021,14,5129,559
17,15,2,0,5,40872,0,0,0,684
15,3,12,2,14,274769,47950,27,0,643
27,6,21,1,11,88968,29006,0,0,520
17,14,3,2,13,921232,709,12,14038,493
17,3,14,0,7,179425,0,5,0,613
9,3,6,1,14,9228,7676,92,14997,572
26,4,22,2,6,36400,231,2,3631,560
35,7,28,3,69,26604,21773,40,1484,433
7,1,6,0,8,13585,0,3,3368,667
25,8,17,5,11,750239,265973,88,1645,488
20,13,7,1,8,329698,728,0,0,575
19,10,9,0,17,124210,0,34,0,590
22,6,16,6,7,20332,19408,140,7820,415
19,5,14,5,8,103224,53978,36,27068,415
3,1,2,0,8,9005,0,2,176,586
21,14,7,1,12,604469,28112,25,1506,518
65,15,50,2,22,471073,50412,46,4487,479
6,4,2,0,2,41678,0,0,0,617
4,2,2,1,3,29149,15764,18,15764,537
30,10,20,4,10,459043,74695,36,0,496
12,3,9,1,4,18021,1434,3,1434,490
30,4,26,6,13,37915,40319,105,120,526
15,10,5,1,15,204219,1221,2,6670,474
27,14,13,7,14,722827,79698,107,63102,474
19,16,3,2,12,451771,2087,25,464,522
2,0,2,0,17,0,0,13,0,709
20,12,8,10,16,80555,80136,63,10323,426
10,4,6,1,11,35373,2784,65,5848,519
17,7,10,5,15,469787,20905,289,16306,429
13,4,9,3,11,15421,13519,30,9169,511
3,1,2,2,7,64243,101450,44,17151,597
13,6,7,0,8,728390,0,0,0,544
37,16,21,7,25,156892,80019,40,13425,449
25,1,24,0,14,447660,0,97,1277,560
6,2,4,3,4,2961,6634,35,2456,614
128,12,116,6,11,288602,63491,175,23935,467
16,2,14,3,14,279784,279784,49,171401,433
25,15,10,9,14,64853,53148,80,11101,419
12,5,7,5,7,23191,31509,114,14334,469
9,7,2,5,8,350126,67517,188,21334,384
10,7,3,8,7,65512,74846,233,8427,526
7,4,3,0,7,51602,0,0,0,687
24,7,17,7,12,298986,60914,151,14091,503
10,4,6,1,14,102103,101528,25,20049,508
5,3,2,1,14,237350,3366,25,0,655
7,2,5,4,10,5777,51124,58,0,618
14,5,9,2,13,301057,8503,67,6314,481
9,4,5,5,20,119248,123460,69,14155,491
3,0,3,0,4,0,0,12,0,632
12,8,4,0,4,176462,0,15,3946,552
4,2,2,3,18,690197,105394,35,84427,461
7,4,3,2,8,366913,14937,22,1793,436
11,3,8,5,10,38747,35073,14,9644,457
29,16,13,2,21,342136,1643,100,66850,477
23,10,13,0,8,47183,0,26,811,547
11,6,5,5,14,38888,29071,44,16022,454
10,2,8,1,19,610133,50134,0,0,608
8,4,4,1,8,412966,16123,37,16123,476
5,2,3,1,6,0,3994,4,0,661
18,3,15,2,10,390134,13927,30,12357,628
13,6,7,4,4,58964,34120,47,11848,452
24,15,9,5,19,378746,165003,78,1,529
8,2,6,1,4,1760,760,29,760,549
58,3,55,2,7,121981,10513,25,4818,497
4,2,2,1,8,974,484,23,484,555
37,20,17,0,8,106121,0,25,3675,474
29,13,16,2,19,249731,1688,30,1498,400
6,4,2,2,11,355186,14101,11,6567,501
38,3,35,1,10,22296,10507,33,10507,558
10,7,3,0,7,334608,0,34,1872,440
8,1,7,1,13,6530,6530,0,0,687
6,4,2,0,17,28806,0,1,3034,524
7,5,2,5,4,297612,297612,91,0,514
5,1,4,3,14,29238,29238,16,6694,557
31,10,21,7,5,42788,39649,32,12135,466
40,2,38,0,6,4921,0,0,0,566
20,6,14,2,9,107471,8848,24,8432,633
17,8,9,2,7,42642,1119,11,505,488
14,7,7,6,10,248168,120947,125,14420,486
9,6,3,4,11,40877,9423,195,7480,379
9,2,7,0,15,45,0,8,1748,649
22,15,7,10,13,198346,30369,144,6559,447
8,3,5,0,6,3460,0,54,1097,537
35,20,15,1,27,775805,244639,34,4670,507
6,2,4,2,5,15968,15968,116,14155,578
7,5,2,1,11,538954,9274,10,19120,512
10,5,5,6,7,93938,135953,146,28081,466
20,7,13,6,6,56930,26368,37,14570,459
17,9,8,0,14,432353,0,8,0,662
5,3,2,3,7,23020,16911,47,16183,419
4,1,3,0,7,0,0,0,0,672
5,1,4,0,10,12455,0,0,0,625
11,4,7,4,4,8324,163386,91,8191,459
9,3,6,1,10,18385,944,24,0,456
31,12,19,4,22,2834717,47608,56,38357,437
39,23,16,4,8,246943,1338,32,2500,522
8,6,2,5,5,19768,7550,214,4681,429
7,4,3,0,4,58989,0,1,139,674
13,7,6,6,13,286865,286865,217,298514,439
10,5,5,6,12,155177,154688,121,123113,448
8,6,2,7,6,49382,39757,78,11630,468
4,2,2,2,5,34457,8342,40,2385,549
6,4,2,0,6,59808,0,6,0,686
9,5,4,7,8,42102,49202,64,14754,558
449,25,424,1,15,204594,2192,258,16999,414
10,4,6,0,13,5008,0,78,11222,521
47,5,42,4,6,51942,50559,47,48219,526
22,12,10,0,15,175422,0,12,1060,500
16,8,8,7,19,21506,21506,89,9386,446
9,6,3,1,19,9393,2409,45,3520,693
13,6,7,3,7,598017,8055,51,6079,452
6,3,3,4,8,35670,44417,25,24541,478
23,9,14,0,28,169444,0,11,362,551
22,4,18,5,15,532243,150506,86,9723,455
37,15,22,3,7,168648,7155,21,6236,497
8,3,5,2,18,254872,17702,0,0,466
7,4,3,4,14,100804,100804,58,46846,532
6,4,2,4,5,6752,6752,55,3553,421
24,8,16,7,12,78523,62147,71,52558,424
16,10,6,0,27,758633,0,5,9110,543
8,4,4,1,8,187565,10889,14,0,682
29,14,15,17,8,371841,502387,274,177216,455
10,0,10,1,8,0,10377,31,0,628
13,6,7,3,16,344399,14217,61,8147,460
23,6,17,5,10,102099,75354,124,45085,477
38,4,34,1,10,12324,5059,18,5626,447
13,11,2,3,3,48386,15531,11,1044,476
7,5,2,5,13,141609,84984,57,0,449
50,14,36,7,16,237146,206813,289,26022,425
13,2,11,3,16,58629,58628,41,51527,474
12,6,6,1,13,170144,16074,23,2716,517
7,5,2,4,17,60466,38672,11,1345,530
13,5,8,5,13,21976,21976,60,2455,484
14,5,9,2,16,273404,6044,38,4334,575
20,8,12,8,10,327729,44052,33,5864,392
3,1,2,1,6,4810,4810,16,0,587
24,13,11,0,24,213620,0,15,11214,611
17,4,13,3,6,11661,11659,68,9929,443
49,14,35,11,11,438128,102625,114,39242,382
8,3,5,3,8,13970,14101,28,6985,528
29,2,27,2,14,36953,46357,43,36953,624
7,4,3,3,7,213823,13810,97,4976,527
14,6,8,4,14,41942,35697,0,17410,510
14,9,5,11,15,560476,827169,214,22143,471
13,6,7,6,9,109774,104608,151,509,493
19,6,13,1,4,46188,125,10,525,544
314,11,303,3,9,52541,17730,104,1157,466
8,2,6,0,3,3280,0,0,0,621
12,1,11,1,10,7900,7900,0,0,574
9,7,2,0,16,314238,0,2,110,608
44,10,34,5,18,131126,152176,136,4286,516
28,13,15,9,9,106051,37664,324,12096,437
24,6,18,3,14,135037,18601,76,13772,497
9,6,3,4,6,24120,10362,214,4690,506
21,14,7,5,7,443073,16150,0,0,474
15,5,10,5,14,50054,50054,139,27597,442
4,2,2,2,7,35389,29202,31,0,488
29,13,16,0,69,1233445,0,22,612,462
14,7,7,4,7,400143,29233,97,6908,420
16,8,8,0,9,83900,0,3,1232,515
9,5,4,4,22,213101,256604,77,0,532
35,16,19,0,10,4725049,0,14,10689,556
12,8,4,0,12,1030444,0,2,292,667
21,13,8,3,8,93775,1025,113,1023,494
19,15,4,0,69,75031,0,25,1733,673
18,10,8,4,12,165053,21703,85,9436,481
12,10,2,0,9,153194,0,2,0,628
17,6,11,2,15,408259,3724,13,0,586
20,5,15,0,13,495636,0,27,2704,628
33,13,20,6,15,144168,143850,250,14704,423
30,9,21,9,7,36709,40491,346,15903,507
11,3,8,1,9,46221,564,10,3887,633
6,2,4,0,6,13479,0,5,0,604
8,6,2,1,7,155753,15990,11,0,579
29,11,18,8,8,337278,29792,124,8026,438
24,5,19,4,7,12724,5230,64,2204,613
12,10,2,8,6,27156,28891,68,17828,483
21,7,14,4,17,289785,38617,58,705,522
12,6,6,0,8,363650,0,31,0,550
25,5,20,5,11,73018,41232,111,14091,431
30,8,22,5,7,31285,9251,53,5198,432
12,10,2,5,5,82146,23795,38,4006,476
62,15,47,6,8,216907,62519,50,1086,447
14,7,7,6,16,782091,57904,93,2958,464
10,3,7,2,12,18826,18826,50,1965,473
5,1,4,1,7,10818,10818,14,12562,479
43,12,31,0,12,129708,0,98,2222,496
19,11,8,14,10,77694,113641,33,15772,411
17,5,12,3,6,30225,28965,53,2580,483
18,10,8,1,13,1185519,26,40,26,581
15,7,8,6,21,50965,47545,100,34485,484
20,10,10,5,16,59427,8223,144,3739,411
7,3,4,3,8,12436,12436,52,8383,474
7,4,3,3,8,90931,69800,0,0,469
23,5,18,2,17,175822,11682,26,13339,468
19,6,13,11,25,174290,197789,0,0,418
20,3,17,2,8,2985,10033,125,8140,558
35,5,30,1,9,92093,2120,31,5420,528
12,6,6,0,13,15676,0,37,349,602
35,5,30,3,8,106438,98183,57,3173,470
565,2,563,0,5,19503,0,0,3243,692
40,3,37,2,16,37859,37859,0,305,482
8,5,3,6,15,15760,10639,27,20313,409
11,4,7,4,7,121144,121144,95,6588,446
19,5,14,5,12,80489,62509,55,10715,551
4,1,3,1,2,4015,4015,7,4015,530
11,3,8,2,10,23378,19637,135,12858,610
32,14,18,9,13,509818,242083,290,1355,531
8,3,5,1,7,1802,1400,52,2398,528
96,25,71,5,38,506968,19883,75,11025,496
14,8,6,4,14,1774718,634075,107,223439,475
29,8,21,0,16,1592893,0,0,0,673
8,5,3,4,13,36675,33124,49,7752,459
4,2,2,0,11,83995,0,0,0,655
30,14,16,0,12,174378,0,0,207,616
13,11,2,9,10,683192,193851,176,7014,441
7,5,2,2,13,310470,19589,11,0,512
8,1,7,0,12,25861,0,16,1108,620
13,2,11,0,9,18000,0,15,3082,532
5,3,2,3,9,116844,1266,37,500,476
18,12,6,6,8,174215,56174,106,18400,407
7,5,2,0,9,369493,0,0,0,693
4,1,3,0,17,0,0,0,0,805
2,0,2,1,7,6614,6614,2,121,495
16,9,7,0,15,17871,0,4,1240,613
12,6,6,3,4,177280,11352,33,384890,472
15,8,7,0,16,233540,0,4,0,612
31,15,16,19,16,532037,684588,296,92730,420
18,2,16,2,15,19253,19253,53,5966,586
5,2,3,1,8,3706,9367,0,0,647
13,8,5,5,7,15325,11705,51,4348,478
14,5,9,4,4,22712,23273,20,12220,389
6,4,2,4,6,978053,117970,0,0,440
29,8,21,0,9,466213,0,54,1022,627
34,22,12,13,19,311995,71622,237,14030,433
23,12,11,9,11,880566,331237,157,227048,417
35,7,28,7,9,48641,42129,123,13079,493
9,6,3,3,6,363911,56728,2,5734,456
22,9,13,0,16,254117,0,46,77891,397
7,5,2,0,19,113697,0,8,0,659
28,8,20,3,13,451701,3510,51,1888,529
41,7,34,0,26,147610,0,23,1325,619
17,10,7,2,18,69516,23060,42,0,515
3,1,2,0,14,10599,0,0,0,658
10,5,5,0,69,54720,0,0,102,670
60,17,43,17,13,155523,146836,490,24459,413
13,7,6,6,8,81981,85935,76,66813,440
13,8,5,3,8,300848,107047,12,0,463
6,3,3,2,10,230831,18938,27,18158,465
6,3,3,2,14,32505,32505,31,17281,446
10,3,7,3,13,78240,212401,45,0,498
23,4,19,7,7,37995,50809,113,6775,440
22,15,7,7,18,480853,105603,125,27755,481
7,1,6,0,6,0,0,0,0,631
27,6,21,4,14,17145,25767,70,1269,469
28,6,22,2,13,120,52,35,1250,513
22,10,12,0,10,173142,0,13,0,581
17,9,8,6,10,115723,52506,49,21462,462
19,8,11,8,7,35121,17067,205,2588,462
17,11,6,4,9,298324,12331,17,10339,423
32,8,24,0,15,320682,0,11,214,603
5,2,3,1,8,1007,4031,19,0,616
9,7,2,6,14,86634,72982,25,5040,498
21,6,15,2,21,197107,71963,68,59053,536
10,2,8,2,7,45568,19840,27,1425,520
36,18,18,1,9,155500,19773,121,3319,500
11,6,5,1,9,43624,248,0,0,581
18,5,13,3,7,83733,2775,147,1791,474
20,4,16,2,27,446058,11845,15,6595,492
8,3,5,3,4,4916,4916,211,3587,476
6,3,3,2,6,9166,6366,89,7659,542
9,7,2,1,8,15849,3048,1,3048,563
6,1,5,3,8,96346,133671,51,0,649
33,14,19,3,13,651067,4663,67,31720,439
32,12,20,0,21,43789,0,20,0,588
6,4,2,5,14,239884,156849,117,100697,452
12,5,7,1,8,23324,1134,44,2461,574
10,5,5,0,7,21474,0,21,0,564
26,10,16,0,17,1257767,0,0,0,662
38,11,27,3,13,90554,2196,41,2735,469
13,10,3,9,25,658761,151614,226,6167,457
14,12,2,5,3,424012,13071,22,2987,480
16,10,6,6,16,1181391,42792,37,2188,474
26,4,22,0,14,108511,0,31,1390,629
18,12,6,1,16,48846,3465,51,3465,520
9,4,5,3,13,130987,9122,55,4279,474
11,6,5,5,17,246046,221985,23,18566,612
15,8,7,4,15,405495,24542,113,12089,453
4,2,2,1,11,11167,11167,25,2922,480
23,14,9,1,11,817493,890,0,0,414
11,9,2,4,10,157107,17426,14,3540,466
8,2,6,0,17,22895,0,3,777,679
11,9,2,0,13,650804,0,0,0,627
7,5,2,1,10,1477369,9170,24,9170,612
9,7,2,6,6,30018,22550,63,1264,452
56,5,51,0,6,26720,0,19,420,550
17,9,8,0,27,201154,0,1,6,691
11,8,3,5,6,404096,14832,93,7020,490
16,4,12,0,6,218032,0,0,0,606
6,1,5,2,9,0,8368,0,0,468
8,5,3,0,3,8930,0,27,261,630
8,3,5,1,33,2543,1420,33,1420,596
9,5,4,6,15,28849,47646,110,4949,596
9,6,3,4,15,25019,12352,33,82276,527
8,5,3,0,8,55901,0,0,0,622
49,8,41,6,13,72305,60061,172,14574,490
44,7,37,5,11,14494,11110,157,5836,475
28,10,18,0,8,492827,0,0,0,672
49,24,25,21,10,480105,168884,334,47001,407
34,7,27,5,13,407131,108447,137,71614,444
11,8,3,0,5,144965,0,4,0,573
42,3,39,1,22,317468,241517,12,3100,508
38,12,26,6,7,94100,6541,72,53944,520
18,6,12,5,9,90298,91080,80,15134,466
25,9,16,2,19,225366,12865,54,3588,492
17,7,10,6,7,43859,43021,103,13805,496
2,0,2,0,6,0,0,0,0,674
13,7,6,0,8,239936,0,0,0,573
7,3,4,1,15,240893,46001,4,46001,520
9,6,3,3,12,41853,24898,50,3465,481
15,6,9,0,7,79537,0,5,0,600
5,3,2,1,7,214714,6360,16,1935,602
8,6,2,2,13,310056,34833,0,0,458
18,13,5,6,10,83532,19333,49,4414,481
4,1,3,0,6,4365,0,1,1095,704
5,3,2,2,9,31215,31215,132,10568,506
21,10,11,1,13,133960,24583,14,1796,593
19,7,12,6,11,424569,86411,267,14380,455
11,7,4,3,7,240021,2082,98,932,428
7,5,2,0,13,430063,0,1,0,715
4,2,2,1,19,23708,16251,19,16251,631
11,9,2,1,11,410352,131,10,1958,568
24,11,13,11,12,998589,743295,228,0,447
10,6,4,3,17,8593,7174,76,6216,428
4,2,2,0,4,49782,0,0,0,639
10,6,4,2,11,369252,2003,0,0,469
9,5,4,4,12,39499,14042,40,6324,447
12,3,9,3,10,53996,5825,16,549,482
11,7,4,5,12,10451,10451,74,4007,504
26,5,21,1,9,371402,7836,84,43748,640
23,5,18,3,7,9256,22145,58,1029,595
19,6,13,6,7,19454,19454,137,8300,417
29,13,16,7,15,392020,92035,43,0,516
18,8,10,7,14,40566,58583,55,23454,450
21,10,11,0,10,411327,0,4,0,675
50,21,29,3,10,32397,7343,54,3846,426
10,3,7,1,20,194330,5642,12,0,607
11,5,6,2,6,534206,3896,196,5189,452
4,2,2,2,23,591965,8568,40,978,548
12,6,6,5,9,484526,376762,6,3097,474
3,0,3,0,5,0,0,0,0,613
21,16,5,1,12,209670,256,3,3472,532
7,5,2,5,10,48637,41604,191,7044,479
8,6,2,5,5,30164,5459,132,3470,485
10,2,8,3,15,11291,9938,26,7500,480
12,7,5,0,16,88972,0,3,0,494
10,5,5,4,16,340130,7884,46,1312,465
3,1,2,1,9,20826,20826,10,20826,589
20,4,16,1,14,15019,3955,28,9160,466
21,10,11,0,16,823799,0,26,0,596
9,6,3,5,8,18279,13056,61,4704,508
6,4,2,0,3,186895,0,0,0,664
11,6,5,7,22,73096,66514,125,6125,463
23,6,17,0,14,169614,0,39,9706,487
9,4,5,3,69,79229,36754,52,289,516
3,1,2,0,7,0,0,9,0,721
8,6,2,6,8,542370,864288,65,268658,508
30,12,18,6,9,84031,28016,113,9163,426
4,2,2,3,9,18990,30154,0,0,564
11,8,3,1,15,40938,536,11,642,494
18,9,9,0,12,352884,0,0,99,645
14,5,9,2,8,137693,1848,5,436,559
29,4,25,5,14,43976,53795,14,15259,450
5,3,2,1,7,35883,5358,9,0,650
15,4,11,3,8,4014,4014,269,20522,481
5,3,2,0,3,12824,0,29,651,634
132,3,129,0,11,12421,0,23,1053,497
31,12,19,3,12,71228,49226,94,915,444
6,3,3,1,3,15794,1970,86,483,498
14,6,8,0,11,395896,0,1,0,600
16,8,8,0,10,83570,0,0,572,578
3,1,2,2,14,41909,48723,26,6814,496
12,5,7,6,25,1132298,154677,76,0,441
8,5,3,3,5,89198,9580,6,0,492
9,6,3,5,11,669941,666719,114,0,439
13,4,9,4,11,18908,18908,54,7422,476
5,2,3,3,9,7271,11973,68,4516,488
12,10,2,4,39,572440,256824,93,216748,491
7,3,4,0,22,226451,0,3,0,639
21,7,14,0,3,50816,0,2,6508,437
10,6,4,2,4,20416,7590,25,3691,454
20,8,12,6,16,205495,71241,16,13936,576
6,3,3,3,9,434493,40282,64,23485,578
7,5,2,2,15,479191,11598,26,0,473
7,4,3,1,14,12000,10137,51,21536,586
15,10,5,0,6,289321,0,15,0,625
3,1,2,0,3,5069,0,0,0,631
17,10,7,0,10,10011614,0,10,0,575
22,9,13,0,4,140759,0,1,0,495
10,8,2,5,9,226305,25084,31,503,477
14,8,6,6,7,22453,20462,86,3029,477
10,7,3,1,9,999158,3785,47,0,491
20,9,11,6,9,41313,33279,269,10443,505
18,10,8,6,10,387750,40960,90,13673,451
12,8,4,6,4,86212,49895,66,0,450
11,5,6,0,4,58286,0,0,0,647
25,5,20,1,11,191788,296,10,5747,578
19,8,11,9,8,89823,97314,139,33135,440
25,16,9,15,18,119339,127570,267,11935,444
13,6,7,1,12,314422,6061,2,0,613
20,12,8,3,9,218276,118753,46,509,439
19,12,7,13,12,443024,97059,217,33991,441
22,4,18,4,10,46951,46951,45,24581,522
30,11,19,7,7,106707,27355,162,13947,425
15,8,7,4,16,973714,128331,70,2651,457
15,3,12,1,14,18160,11363,37,4656,559
16,2,14,2,11,140541,114479,29,0,622
29,12,17,7,17,139061,39463,206,9660,414
14,8,6,8,8,72287,57026,117,18189,446
37,6,31,2,10,145116,9459,53,8270,496
11,7,4,2,11,122991,14709,26,9081,528
4,1,3,0,16,0,0,24,0,662
14,8,6,6,21,84077,73549,146,49163,414
6,4,2,1,4,40020,298,30,828,511
26,7,19,0,7,564936,0,2,0,595
6,1,5,2,10,0,3942,25,0,648
22,12,10,3,12,289365,508,7,240,518
19,9,10,9,9,54901,42379,200,9504,454
16,8,8,3,11,86725,8694,28,2728,506
39,7,32,3,10,50996,13003,78,9353,513
10,2,8,0,18,149212,0,9,251,738
12,9,3,0,5,528257,0,25,17903,594
6,2,4,1,8,2980,2079,2,2079,619
11,3,8,2,11,82105,22593,43,21274,444
9,7,2,5,5,65819,5087,24,2544,415
32,12,20,3,17,587961,31259,55,10793,474
7,4,3,1,10,65225,17249,96,17249,449
14,9,5,7,17,213032,163239,166,50331,468
25,5,20,1,14,231686,747,40,747,574
64,7,57,6,15,128800,106398,136,53868,471
14,5,9,3,12,162477,9418,21,0,594
26,8,18,14,11,422323,135418,0,0,445
4,2,2,2,3,2839,2839,48,7214,523
5,2,3,3,5,35898,157228,8,34332,476
5,2,3,3,6,9053,4322,22,2319,458
26,15,11,1,14,966007,6591,26,339,470
9,7,2,4,8,45632,23447,68,8369,443
5,2,3,2,7,35557,35094,49,26942,472
12,7,5,0,8,39542,0,6,726,579
9,3,6,0,12,14419,0,0,28586,660
6,4,2,3,8,190380,189139,71,2607,471
23,7,16,0,16,112330,0,63,1682,668
14,11,3,7,12,490871,67501,52,0,447
33,7,26,2,26,908713,1928,25,1444,444
17,5,12,4,12,37350,17849,30,11104,503
2,0,2,0,2,0,0,0,0,629
16,7,9,5,8,48801,89075,153,29098,575
17,9,8,5,14,49138,5150,204,2672,469
14,5,9,3,16,13161,10629,45,5497,468
18,2,16,2,10,13621,13621,61,8221,438
11,6,5,3,12,234873,75082,38,0,506
6,3,3,2,9,9182,6775,18,3306,549
112,10,102,4,11,127420,78541,137,33114,390
8,6,2,3,3,38479,7877,23,5179,416
70,9,61,0,14,1063131,0,25,5910,443
185,1,184,1,15,7807,2920,4,3222,531
11,3,8,3,11,75114,40011,55,0,548
19,7,12,4,6,11108,1076,45,431,528
8,5,3,0,17,115,0,1,0,657
10,3,7,5,10,35014,35014,124,26118,458
7,3,4,3,7,83991,11005,51,8077,551
28,5,23,2,9,109276,290,52,3889,581
138,5,133,2,12,14493,14493,27,1595,500
15,1,14,0,17,0,0,0,5349,746
11,7,4,4,23,608430,534849,23,6408,446
18,13,5,13,7,250481,114190,82,234100,432
71,18,53,10,13,337698,48232,181,11574,410
53,16,37,7,15,582812,447951,95,220,495
22,12,10,9,9,960148,214423,156,4803,456
17,3,14,1,8,27284,14019,36,14020,620
31,4,27,4,10,215521,167050,94,2937,517
4,0,4,1,7,0,9272,20,0,523
24,7,17,5,19,186516,126524,101,782,492
24,8,16,0,8,489205,0,3,2905,586
6,3,3,0,13,26139,0,0,0,558
11,6,5,4,5,55832,41889,58,1634,488
9,3,6,0,8,27541,0,0,0,690
6,3,3,4,11,19211,22518,0,0,454
24,10,14,4,4,71648,41694,20,126,464
49,10,39,3,15,132333,15856,37,8500,474
22,8,14,7,29,125277,89724,59,76027,475
9,5,4,1,9,116253,570,8,0,596
24,11,13,0,14,94800,0,15,0,640
6,2,4,2,8,709,709,26,512,532
13,5,8,1,22,71306,9890,80,21924,503
19,8,11,5,15,46388,28234,236,15928,446
4,2,2,2,4,10606,24328,45,0,693
20,9,11,9,8,55124,62862,63,7671,410
5,3,2,0,8,10930,0,0,0,621
13,6,7,3,13,467710,140963,0,0,580
9,7,2,1,9,27282,3720,21,3720,568
18,7,11,5,13,41032,41031,313,23388,427
29,9,20,2,16,346310,21215,34,9727,520
7,4,3,4,9,41865,41865,147,25566,466
9,5,4,1,18,41416,2038,33,2443,427
29,12,17,0,15,789140,0,0,0,617
16,12,4,8,25,601343,473778,234,102845,436
31,11,20,2,13,68414,42546,20,24036,657
7,2,5,2,7,12107,2736,19,2224,597
14,6,8,1,8,149519,9001,26,0,524
21,12,9,4,10,323487,27301,60,6076,520
6,1,5,2,12,172966,172966,3,1912,495
11,8,3,4,22,789921,19415,40,9055,505
259,10,249,4,4,96802,53867,94,53451,438
5,3,2,3,6,44615,3757,12,558,569
5,2,3,2,6,41160,41160,17,0,448
3,1,2,1,5,1281,1034,27,1034,433
6,2,4,2,8,1385,1385,24,1181,456
6,1,5,0,14,0,0,4,9539,562
14,5,9,0,14,48456,0,11,2184,667
10,5,5,5,11,394578,35082,108,1720,432
18,8,10,5,9,124505,64973,144,2377,439
37,6,31,5,10,41636,41576,83,24409,493
9,5,4,4,13,85946,28821,8,5995,383
16,5,11,0,9,367535,0,0,0,681
6,3,3,2,6,18287,28840,15,0,580
27,3,24,1,19,15309,5689,98,1931,578
9,5,4,1,13,67604,45996,66,37700,499
11,5,6,0,9,82401,0,3,0,681
23,5,18,2,10,436550,12216,7,11820,462
12,2,10,0,20,508953,0,0,1772,651
8,3,5,3,11,26099,26099,162,15180,516
11,6,5,6,5,61042,60886,177,11014,436
45,12,33,5,10,52222,21836,34,10847,402
7,2,5,0,8,7987,0,0,0,686
12,3,9,2,15,414625,42311,36,33024,453
5,2,3,0,7,19404,0,0,0,626
19,8,11,2,15,24861,29555,53,25958,534
21,8,13,0,13,502911,0,19,8541,509
12,9,3,0,12,43869,0,87,15035,458
23,9,14,2,17,322017,4511,47,3937,428
18,3,15,2,10,35150,24606,65,22914,529
5,3,2,4,5,6298,7946,86,4607,440
4,2,2,1,9,20060,20060,0,0,537
15,9,6,2,7,68805,17169,38,6789,500
8,4,4,5,20,529532,810429,127,0,463
17,8,9,6,7,140668,45801,20,923,466
14,8,6,3,27,33421,28982,80,26535,422
30,7,23,7,15,57894,44472,299,8340,543
6,3,3,3,7,133384,135144,64,0,454
38,9,29,4,8,590434,18420,66,3602,412
18,14,4,2,23,1812722,6376,7,0,571
7,3,4,2,14,26977,5288,16,4980,419
4,0,4,1,13,0,11296,11,0,558
12,5,7,0,12,18564,0,2,527,630
31,13,18,6,13,94528,9719,53,865,515
4,1,3,1,11,701,701,3,701,639
8,3,5,1,11,632,632,26,0,603
11,6,5,5,16,556936,12208,14,5052,463
29,9,20,5,9,51966,16986,122,6607,435
68,5,63,5,7,134938,42989,128,11482,517
56,11,45,4,13,356987,59621,88,42637,456
28,18,10,9,19,357775,111716,44,8737,553
2,0,2,0,10,0,0,0,16320,539
8,2,6,1,2,364660,26406,7,3009,458
5,2,3,4,6,27577,40054,59,24371,452
12,5,7,4,7,54221,25283,43,10734,383
21,5,16,6,18,21332,13070,54,4311,442
17,9,8,1,14,97105,510,2,2330,517
14,9,5,0,11,602961,0,0,0,637
18,3,15,3,10,10381,10381,28,8124,501
18,7,11,3,14,486968,43719,30,34632,554
3,1,2,0,12,0,0,20,25917,583
9,2,7,1,6,3147,3147,27,661,513
3,1,2,2,5,6274,6274,0,0,546
22,12,10,0,48,408289,0,27,0,574
13,5,8,3,16,395316,9284,53,7820,556
36,8,28,5,12,932419,24205,117,11589,433
10,4,6,6,9,25833,43888,39,8636,547
13,7,6,0,8,62431,0,16,1323,500
26,19,7,12,19,262304,240258,194,12600,507
227,11,216,7,15,103027,92816,247,38031,446
4,1,3,0,7,49638,0,19,0,644
17,13,4,13,14,53030,58083,165,1651,503
28,12,16,5,13,176855,15135,29,9402,474
16,9,7,11,10,280878,306486,226,90398,449
14,4,10,1,8,113301,417,35,545,539
21,5,16,0,16,126850,0,1,1657,648
7,4,3,2,11,90545,90175,64,81233,478
12,9,3,7,7,376299,12403,62,6201,439
15,4,11,0,10,143109,0,3,0,639
5,2,3,3,18,73069,71494,57,24349,460
11,5,6,1,8,52322,1462,9,1462,510
10,5,5,2,12,438985,25701,51,2528,540
48,11,37,1,16,106463,1900,27,3636,484
5,3,2,2,5,3635,5928,17,0,489
4,0,4,0,7,0,0,0,0,662
7,5,2,0,5,148038,0,3,5412,608
22,18,4,0,20,302899,0,6,950,589
12,6,6,2,15,47969,68052,46,1884,447
38,10,28,3,13,282825,93578,165,3456,480
20,5,15,3,7,41004,5091,54,1782,478
20,9,11,1,12,2065089,8979,66,2077,534
15,9,6,0,4,84146,0,0,0,593
4,2,2,1,5,79220,6334,8,0,476
8,2,6,5,8,84344,89936,56,18672,616
22,12,10,2,8,96230,13901,12,10087,421
12,9,3,0,14,363631,0,24,0,683
20,5,15,2,10,340348,8642,203,16022,454
18,6,12,6,17,33787,24615,141,9430,562
19,5,14,1,18,26258,1447,17,1447,430
15,4,11,1,15,844207,113421,0,0,532
37,8,29,4,8,112273,24966,47,13186,420
42,8,34,6,11,32652,17220,243,10620,446
25,5,20,1,13,451106,643,1,208,663
14,4,10,3,15,5060,5060,141,16258,544
17,8,9,0,9,391739,0,17,0,609
21,10,11,3,12,272561,134664,58,5119,470
12,10,2,0,13,392066,0,0,0,705
19,12,7,1,12,1094051,6182,1,300,435
6,4,2,4,6,593404,30409,60,0,500
19,7,12,3,10,115078,23637,36,8639,503
8,4,4,0,4,36310,0,130,4536,534
2,0,2,0,11,0,0,0,378,601
21,7,14,3,19,13015,12329,36,8401,549
26,8,18,4,11,47685,15185,47,12920,476
12,7,5,2,9,1143890,157757,74,157389,529
13,9,4,11,6,798687,941856,124,274178,384
12,8,4,1,20,706809,1697,16,1086,501
14,7,7,2,6,222555,3108,9,3063,454
17,12,5,8,4,271903,55179,63,33799,458
23,21,2,16,15,1456048,147517,218,19206,396
4,2,2,0,1,2200,0,0,0,623
16,12,4,3,16,241571,4248,0,0,555
17,6,11,0,7,369908,0,1,0,696
9,3,6,2,6,107376,107376,18,45907,505
9,3,6,3,31,18141,14768,88,7840,477
19,10,9,2,13,270049,903,17,2491,475
7,4,3,2,10,11790,8746,53,19678,552
21,12,9,8,8,448666,17962,72,5275,467
11,5,6,0,8,86402,0,8,0,601
28,6,22,4,9,27579,12429,42,3210,459
41,7,34,0,8,218477,0,32,198,632
27,11,16,9,14,48841,48192,100,14004,429
18,7,11,4,10,258449,69818,87,48735,504
20,3,17,2,2,11413,8526,19,8361,450
9,5,4,1,12,185784,170005,18,170005,515
25,6,19,1,12,96089,428,68,4225,532
8,4,4,3,17,16915,16915,43,37001,498
38,8,30,2,17,89594,1805,180,51988,529
28,13,15,0,17,244143,0,0,0,564
9,4,5,1,14,159079,15326,25,0,571
6,3,3,3,8,39701,2243,12,1081,482
18,7,11,0,15,16143,0,14,1152,497
15,11,4,10,15,604251,227751,275,169975,447
17,9,8,5,8,44200,20118,132,7416,527
17,12,5,10,9,652799,221602,83,112175,438
9,7,2,1,4,94376,275,8,0,575
3,1,2,0,9,388726,0,1,1857,703
34,9,25,3,14,567935,36193,14,17844,433
13,6,7,3,16,634142,35992,25,29216,574
26,13,13,3,17,425796,7926,47,1200,507
28,12,16,1,21,625838,2086,7,0,631
16,1,15,0,15,111891,0,3,111891,703
10,4,6,0,4,106493,0,0,0,647
20,6,14,6,11,13924,3918,211,11540,449
6,2,4,3,9,162608,145527,68,18125,589
12,4,8,1,10,54816,4512,22,4512,684
4,2,2,0,5,0,0,10,1477,595
18,9,9,1,11,905378,289,23,4180,508
6,4,2,3,6,6550,6550,61,3106,438
18,6,12,0,13,309271,0,11,4164,598
12,1,11,0,7,8880,0,84,525,624
9,5,4,2,10,187718,5044,21,5335,469
43,26,17,13,14,1124470,254453,154,154336,353
6,4,2,3,1,20505,1399,24,1146,536
5,0,5,0,6,0,0,11,2612,594
11,5,6,0,8,28473,0,29,0,630
59,19,40,2,7,193636,10063,74,5474,524
4,2,2,1,9,311773,21540,13,21540,527
29,21,8,12,11,545405,131879,144,55331,429
23,5,18,1,13,6359,2859,16,4716,549
29,16,13,10,22,2241007,798768,0,2165,453
18,6,12,3,9,13345,4436,210,2250,486
10,2,8,2,8,6818,6454,12,0,517
12,3,9,4,10,8127,12935,18,3625,501
11,4,7,3,9,4266,11560,93,2349,508
8,6,2,0,7,365812,0,6,0,589
17,7,10,1,8,255026,410,5,0,673
14,7,7,4,8,107759,12022,51,3055,407
4,1,3,1,12,1463,1463,0,0,536
9,3,6,1,6,2233,589,5,839,543
3,1,2,3,3,13062,29719,16,19901,598
12,4,8,2,13,7222,10366,41,9788,592
4,2,2,0,12,32056,0,0,0,653
5,2,3,2,9,3922,11200,35,0,527
16,4,12,1,14,21472,1878,22,1340,539
4,2,2,1,7,7534,4606,6,4606,522
17,8,9,1,21,57380,5381,93,1770,471
17,15,2,11,12,418572,37199,70,10801,426
54,14,40,11,7,163439,74925,36,37869,410
60,8,52,5,26,88904,85287,136,13410,464
7,4,3,4,11,8399,6410,41,1287,464
21,7,14,6,12,90915,114147,143,3460,502
5,2,3,3,5,34028,34996,0,0,466
9,4,5,4,16,483284,19545,21,9900,567
9,5,4,6,10,330758,43859,66,431,466
10,5,5,1,9,32298,2332,12,6789,498
32,7,25,0,14,171185,0,15,2021,540
64,5,59,5,7,54838,81450,24,4611,485
13,3,10,5,12,42264,127932,104,16231,459
20,7,13,8,8,68690,72615,130,22527,425
8,3,5,4,13,195975,35055,35,8264,566
31,4,27,4,10,22668,19059,94,8172,430
10,7,3,2,5,82918,737,9,0,580
4,1,3,0,4,4177,0,31,964,612
25,5,20,4,7,92557,28291,26,4007,439
20,7,13,2,18,83512,32265,131,31689,477
15,10,5,4,7,224388,5200,20,2004,492
18,5,13,2,7,139369,3659,6,2888,613
34,13,21,5,18,543391,35206,78,15258,437
23,12,11,12,19,339342,138143,151,38689,448
6,3,3,3,9,98598,91049,59,0,497
14,3,11,0,11,1567973,0,0,0,670
49,6,43,5,10,163955,27759,38,12376,452
48,7,41,4,18,309908,53264,249,4413,510
27,8,19,1,19,237383,15862,22,15862,622
99,4,95,1,8,29597,1127,12,407,591
9,5,4,2,6,152352,86586,57,1618,460
26,9,17,0,12,102206,0,232,1156,600
5,3,2,1,69,4134,4134,24,886,595
11,7,4,8,8,89875,94152,136,0,439
8,3,5,0,4,316690,0,0,0,562
20,16,4,12,22,73281,51659,160,6993,416
17,10,7,3,15,369638,52071,14,49899,436
47,8,39,5,9,167721,16566,59,1146,440
19,4,15,2,13,530663,18536,27,11500,482
4,2,2,3,8,12331,7554,6,1045,477
9,7,2,0,14,1294490,0,0,0,666
16,10,6,12,9,123089,127862,371,35726,429
21,16,5,14,14,114179,129263,193,35845,421
18,2,16,3,16,449077,116560,53,2777,515
17,7,10,5,11,188790,25527,50,4610,433
15,2,13,3,11,62393,48309,39,19091,605
10,5,5,3,7,68750,10213,46,5995,460
25,9,16,4,12,170672,5876,44,2400,427
11,5,6,2,13,171577,10590,29,0,555
9,5,4,1,16,36174,1640,17,8259,513
44,3,41,1,8,14540,6157,59,6157,641
27,2,25,2,21,6484,6484,23,2919,465
10,4,6,2,11,15510,8520,12,5119,458
17,13,4,7,6,415285,103573,164,632,437
10,7,3,3,10,239566,56664,44,19237,513
13,9,4,4,17,21077,16702,112,7785,391
9,6,3,5,8,394249,34947,37,4422,451
37,6,31,3,9,19238,9811,122,7286,451
4,1,3,3,7,1509,13722,42,0,569
10,3,7,3,7,40439,54743,47,23329,423
13,6,7,1,11,276531,16853,56,6830,585
13,5,8,3,5,39535,9297,1,2003,491
12,7,5,5,11,43077,13769,86,8225,435
28,10,18,5,12,16018,6509,100,15699,597
22,15,7,0,11,362232,0,4,0,647
10,8,2,0,12,2863877,0,2,0,638
16,8,8,0,16,457936,0,15,330,677
6,1,5,1,7,15662,15662,26,15662,574
14,7,7,7,27,56797,55015,90,13259,485
14,6,8,0,18,348710,0,8,0,693
16,10,6,3,4,184432,7396,19,3150,452
13,11,2,4,15,523755,15994,25,0,497
28,11,17,0,17,36525,0,6,287,690
10,7,3,0,4,152145,0,15,995,443
43,5,38,5,9,74100,82578,85,35839,462
5,2,3,0,20,14808,0,0,0,701
19,9,10,1,19,908639,2902,12,0,539
11,9,2,0,14,1519831,0,12,0,538
16,6,10,1,12,13713,4127,58,5860,640
7,3,4,3,8,27402,27402,0,0,482
15,6,9,1,9,25386,4430,33,4430,574
25,3,22,1,13,9659,1483,19,1483,478
34,7,27,1,8,209693,519,38,519,672
42,2,40,0,6,7539,0,0,0,600
4,1,3,0,14,2406,0,6,2980,564
27,8,19,1,4,192693,490,9,4323,483
10,7,3,6,10,43627,46495,0,0,451
12,1,11,3,17,627424,101000,19,84723,421
43,9,34,2,14,369629,8717,72,3907,469
12,1,11,0,8,1693,0,22,2633,668
16,12,4,1,16,703681,229,18,229,573
7,4,3,4,5,233353,167259,72,3919,483
5,1,4,0,5,2574,0,1,2615,652
12,4,8,0,9,382027,0,0,0,643
12,3,9,2,15,827794,16969,32,16452,552
8,2,6,1,9,9946,697,0,166,470
16,14,2,11,8,32622,42272,92,16382,575
13,8,5,4,21,271674,178188,58,57394,550
12,9,3,4,17,122015,14678,26,6157,492
51,5,46,0,13,168860,0,88,237,632
25,4,21,1,10,14746,4873,23,4873,677
6,2,4,2,11,230,179076,23,56,497
8,5,3,4,9,17482,29424,67,1860,463
4,2,2,2,6,5909,2146,0,0,483
12,5,7,4,18,356266,281665,86,73921,401
96,12,84,9,11,173068,62228,426,19058,573
7,4,3,2,13,614892,2776,0,0,479
10,2,8,0,3,3781,0,0,0,649
11,1,10,1,13,2624,2624,34,3124,536
10,4,6,1,14,275442,2359,96,3395,453
14,9,5,7,14,100858,50223,115,2898,458
18,3,15,3,8,383540,30832,53,12392,451
5,3,2,2,9,28699,2871,9,2286,557
21,7,14,2,25,865690,26779,87,0,477
10,2,8,0,46,13325,0,0,7,699
16,7,9,7,12,26863,53269,100,5217,502
17,7,10,4,13,291472,6693,18,2438,470
10,5,5,4,10,257382,348581,11,182327,490
41,12,29,5,12,95289,16571,4,4333,475
13,5,8,3,8,31058,8018,112,5126,512
4,2,2,1,3,66421,15390,10,0,546
14,2,12,2,19,26975,30112,1,3137,682
25,4,21,0,8,25836,0,5,2292,652
16,8,8,7,9,17437,16381,137,3528,446
24,12,12,7,17,323594,157606,109,5654,450
14,7,7,3,18,98073,26714,56,0,463
12,5,7,4,11,88005,30431,82,10000,551
7,2,5,1,8,56382,1664,15,1664,632
4,2,2,1,6,12056,12056,25,0,634
21,6,15,3,9,249596,6497,20,4906,450
8,5,3,1,4,46650,158,8,0,439
17,7,10,1,15,590981,211,1,0,672
11,6,5,3,6,463019,10320,45,533,462
4,2,2,1,4,605,605,17,1099,584
9,5,4,3,16,557389,103836,40,101689,459
7,3,4,4,14,236563,236563,78,51540,477
10,5,5,3,9,153952,6163,42,0,477
7,3,4,5,12,78607,130992,90,35443,510
25,23,2,1,8,1776246,8956,4,8956,410
16,11,5,2,6,326202,25255,83,1725,438
8,2,6,1,15,2200,19143,0,0,637
24,12,12,4,8,102342,27908,87,12126,507
22,9,13,7,12,179706,168902,111,110582,439
15,5,10,2,7,32297,1336,12,889,438
15,6,9,0,10,1576,0,2,589,653
16,5,11,1,14,122648,1422,29,6232,591
41,2,39,0,3,6103,0,4,7975,507
9,2,7,1,9,8343,2038,33,732,444
4,2,2,3,7,44285,52024,47,32931,538
8,4,4,3,8,16012,579,18,388,561
10,6,4,2,6,257962,22352,62,5885,466
6,2,4,2,14,23269,23269,35,19738,596
16,5,11,10,9,144601,212327,453,92307,483
59,9,50,1,18,255154,5277,22,190,481
18,11,7,0,9,9990,0,15,5318,491
9,3,6,1,15,11533,7961,57,3373,502
51,10,41,9,16,62372,69045,264,18423,418
32,10,22,9,10,103072,66088,145,17594,419
8,5,3,5,15,75980,67154,95,1818,504
11,6,5,3,17,896911,351626,14,0,523
14,8,6,3,10,364345,17559,22,6828,391
18,6,12,9,9,106150,113752,0,0,492
37,3,34,1,9,6882,6882,81,6882,645
11,6,5,6,14,317795,108054,120,43977,455
44,17,27,0,22,202772,0,60,633,463
43,5,38,3,15,11544,14053,48,4790,482
33,8,25,7,10,25483,22926,392,11764,449
23,12,11,1,13,278324,626,18,736,507
9,6,3,3,13,56979,35082,50,22992,458
19,11,8,8,4,83243,26999,29,5663,418
11,7,4,0,2,57957,0,4,312,593
17,4,13,0,11,6522,0,36,84566,568
14,6,8,3,15,59152,85101,64,945,500
7,5,2,0,7,569239,0,18,0,658
8,4,4,0,9,2427,0,0,0,634
21,6,15,0,19,2748643,0,1,0,637
19,10,9,10,5,48189,47436,204,3174,482
6,3,3,0,3,322457,0,2,0,562
13,9,4,9,7,1804131,634441,186,107395,503
15,10,5,0,9,531018,0,0,0,675
55,15,40,2,14,143899,1901,257,1816,481
17,7,10,4,6,291248,23762,50,0,494
7,3,4,3,2,21599,11676,9,4971,419
5,2,3,3,8,35570,41796,0,0,500
25,19,6,0,27,930956,0,30,828,514
16,6,10,7,11,24506,36662,114,1587,480
26,20,6,10,14,357259,22875,244,5290,481
21,14,7,8,7,70908,28674,151,3595,439
74,39,35,2,17,938976,43333,52,37980,501
52,12,40,3,10,746550,86170,52,7407,453
40,9,31,7,13,55695,106108,77,40678,459
8,5,3,3,10,10699,10699,61,0,545
11,3,8,9,10,82292,172243,0,0,494
23,8,15,2,14,528848,12976,56,5499,552
11,2,9,3,7,31857,41929,1,5549,522
12,7,5,0,11,82048,0,12,5780,480
2,0,2,1,4,0,5184,10,0,610
6,3,3,3,5,42397,37452,47,0,494
35,17,18,13,13,636436,77114,72,26267,443
14,5,9,3,17,247070,15344,137,14098,486
6,2,4,1,11,14452,17439,16,0,631
24,8,16,3,11,14862,12893,85,2550,484
24,10,14,4,13,78868,29581,141,16829,446
8,4,4,3,9,548171,146713,58,128973,475
7,1,6,1,6,0,6479,19,0,615
14,3,11,4,9,183084,213917,42,9138,523
15,10,5,8,8,312837,53556,180,8636,466
21,9,12,8,9,67382,73181,88,21832,391
9,4,5,0,10,0,0,67,3624,618
26,7,19,2,20,738374,410893,65,42668,434
11,8,3,4,12,342274,28520,55,3641,501
68,8,60,3,14,62617,5800,59,21178,486
17,6,11,6,13,376142,506778,135,264594,463
27,12,15,0,13,327032,0,8,380,537
25,8,17,7,12,149755,41159,50,0,463
22,13,9,14,19,575428,1035093,187,337314,397
5,2,3,2,10,14340,239,22,447,583
20,8,12,8,9,423549,29997,110,12506,466
28,11,17,10,8,115185,116663,356,52015,539
19,9,10,5,14,1203382,39634,76,5233,431
19,7,12,0,15,448133,0,36,1249,603
9,5,4,0,13,47337,0,22,2836,618
5,1,4,1,7,1447,1447,24,4587,616
27,8,19,1,18,74214,582,0,0,573
10,2,8,4,7,9840,15024,56,6276,453
3,1,2,0,19,0,0,0,944,713
16,7,9,5,14,92298,104825,63,23703,504
12,9,3,0,21,959615,0,0,0,687
78,12,66,7,14,292398,18069,177,8036,497
20,8,12,0,11,123792,0,12,303,562
30,16,14,15,4,124043,58480,408,7012,449
18,9,9,5,26,44576,8978,46,1666,480
25,9,16,2,12,39543,13655,40,10449,381
7,4,3,3,6,1879,19102,34,2080,522
44,4,40,4,10,9680,9680,218,5229,507
38,11,27,6,13,67242,32108,25,11533,443
20,14,6,0,27,1994945,0,1,0,634
18,5,13,3,8,38299,19635,369,4424,477
16,13,3,5,7,360513,11229,165,35025,350
7,2,5,3,12,0,60854,31,4668,522
7,3,4,2,7,15930,9919,49,7775,559
25,20,5,1,23,308679,390,10,5781,687
19,4,15,4,15,11386,15185,73,2199,460
24,10,14,11,17,207764,214043,328,14031,431
22,7,15,0,21,184091,0,0,0,700
25,13,12,0,18,461435,0,0,14327,604
15,6,9,5,13,245522,20293,37,11796,457
16,10,6,9,11,210772,33410,28,3428,449
5,3,2,3,7,247567,461181,39,247567,482
28,14,14,7,21,597552,79438,287,25627,453
4,2,2,0,3,3540,0,0,0,625
59,18,41,5,16,97314,12626,50,10338,500
43,15,28,11,14,253818,88174,162,20029,444
18,10,8,8,6,144426,135238,137,27478,444
11,5,6,3,8,8046,8046,125,14104,521
36,14,22,7,9,260102,44139,414,19738,433
5,3,2,1,13,11721,1047,21,6097,617
22,10,12,4,16,45051,599,26,2381,571
20,4,16,4,14,62594,32625,54,6310,459
13,2,11,0,7,4241,0,0,0,602
8,2,6,2,8,64224,64224,47,32112,464
41,9,32,1,15,836822,9072,25,17370,453
13,5,8,5,9,73851,73851,112,42790,493
17,7,10,6,20,356820,30474,55,10662,488
11,0,11,1,13,8301,8301,4,11258,615
17,3,14,2,11,49227,54925,1,1697,491
34,6,28,4,16,69581,1153,62,1808,515
25,13,12,5,17,295995,48459,73,10822,496
61,14,47,5,15,386302,19493,193,6572,429
11,7,4,6,14,237441,16468,80,7283,446
37,20,17,16,24,943150,409422,320,28200,362
14,8,6,5,16,69936,69742,112,27128,450
16,4,12,4,21,113604,63710,131,3155,450
12,5,7,2,13,368025,188355,38,0,466
10,5,5,0,5,90549,0,20,0,663
14,9,5,0,7,65813,0,15,0,511
10,2,8,0,10,59295,0,13,0,562
6,1,5,0,6,8751,0,0,0,614
29,18,11,8,4,451781,13584,73,5521,488
6,3,3,4,12,21960,27393,69,5860,513
34,7,27,12,11,94112,139592,642,41928,417
6,4,2,2,13,10012,9946,50,0,506
2,0,2,0,11,0,0,0,628,668
7,5,2,1,7,350160,5466,1,578,546
12,5,7,2,8,65731,57563,0,0,498
5,0,5,1,12,0,12678,30,0,598
8,4,4,3,14,22929,18604,18,15068,474
20,6,14,3,13,44819,38425,46,21673,397
23,3,20,0,3,151707,0,8,0,570
63,6,57,2,6,74235,1371,0,0,539
2,0,2,1,7,19689,19689,1,0,648
5,3,2,1,4,341533,27581,26,5259,552
12,4,8,2,12,17245,4778,13,1822,486
32,10,22,6,11,64356,33594,36,11057,450
19,6,13,8,20,679028,588201,173,2595,503
13,10,3,3,9,35123,10219,62,5479,396
32,7,25,2,10,36461,13746,213,10990,472
18,11,7,9,11,60386,51382,134,18600,422
45,17,28,12,24,106264,35893,156,6015,431
3,0,3,0,4,0,0,0,0,606
14,5,9,2,21,350518,1359,22,41666,460
7,5,2,1,18,130820,6264,33,8278,629
17,12,5,0,7,84705,0,0,0,601
34,16,18,0,14,898579,0,5,1,714
9,5,4,3,69,136757,104502,41,910,459
23,9,14,10,11,769672,314680,178,90518,530
18,8,10,0,10,195516,0,9,2647,586
3,1,2,0,11,0,0,1,0,577
13,7,6,5,10,73265,6971,7,2851,508
29,15,14,13,23,214011,252795,425,96126,413
11,4,7,2,11,37064,8207,9,0,584
23,5,18,4,12,45580,33329,56,13332,557
36,10,26,7,15,687521,286213,175,0,447
29,6,23,2,11,348796,1470,83,1389,584
15,4,11,1,18,17463,3588,30,24395,536
45,18,27,1,7,546344,6000,20,366,463
35,12,23,2,10,1428460,95830,33,0,524
6,4,2,3,7,28170,17541,62,5281,493
6,2,4,0,11,250101,0,6,5568,643
16,6,10,2,16,457805,10147,17,8175,553
6,2,4,3,7,23733,29143,66,15561,478
11,5,6,5,8,38283,34400,105,2550,530
10,4,6,3,6,442751,26796,20,11450,422
8,4,4,1,6,6986,535,109,1496,450
5,1,4,0,11,609039,0,24,0,645
13,9,4,2,17,1091922,424397,70,1919,463
12,8,4,2,20,619756,2887,7,0,530
11,4,7,7,4,20423,26202,71,0,522
9,7,2,4,9,518999,91150,53,1353,469
34,7,27,1,20,40982,716,2,716,633
9,6,3,0,10,515262,0,0,840,644
32,14,18,3,8,74360,7158,169,2883,451
43,6,37,0,16,32646,0,0,5713,647
21,6,15,2,12,203845,8175,15,7847,507
41,18,23,0,18,1287484,0,2,1356,612
11,4,7,0,11,1980,0,59,1010,470
30,9,21,3,17,560896,112688,54,9430,529
9,6,3,1,10,38840,714,1,2351,530
12,8,4,7,15,157534,151508,68,13419,440
24,8,16,1,17,152849,2872,137,7308,476
11,6,5,6,15,12754,16414,124,7157,502
39,12,27,3,10,817810,42969,34,17874,481
19,9,10,0,12,37976,0,7,6684,570
25,15,10,12,8,113972,98463,205,44440,439
9,5,4,2,16,163896,154902,34,78548,544
17,10,7,6,11,452058,158692,58,2,456
19,9,10,7,7,146368,123025,284,1531,442
18,7,11,6,14,85683,73739,261,49045,517
17,4,13,1,16,219918,7382,0,549,586
8,6,2,0,7,527467,0,1,710,656
9,3,6,5,7,7412,14275,66,751,588
9,5,4,2,10,61185,50742,6,33198,662
6,3,3,2,6,30825,10527,31,1568,509
14,11,3,0,8,250921,0,3,0,542
14,5,9,6,13,96270,34843,82,6491,478
16,6,10,10,11,158802,200181,153,27416,474
29,15,14,2,69,325551,28370,25,1367,503
8,2,6,4,13,557779,389737,69,0,491
18,6,12,5,8,14400,14400,296,9475,487
4,2,2,4,10,12399,47272,61,8183,542
27,16,11,0,18,1247880,0,25,0,563
13,3,10,0,12,186288,0,28,0,460
6,3,3,1,13,347939,1775,25,3853,538
4,2,2,0,7,19314,0,0,0,639
13,7,6,1,9,195810,2348,28,0,537
18,4,14,0,19,90393,0,13,13548,689
25,11,14,7,6,91593,48016,126,13578,376
12,5,7,1,13,19945,2455,3,4571,501
11,7,4,8,9,22096,26081,128,6181,420
34,25,9,10,13,4173686,85525,100,3720,522
5,3,2,1,4,181254,10430,4,10430,609
18,8,10,6,9,398478,70157,68,10791,414
59,9,50,6,9,158446,45441,459,10524,462
8,2,6,0,3,369,0,1,3159,621
9,6,3,6,17,458274,162669,88,121353,460
4,2,2,2,3,1200,1200,18,1195,472
20,7,13,2,10,393893,8976,10,8567,551
38,5,33,0,9,48367,0,44,5690,637
18,4,14,0,12,45945,0,10,785,635
5,1,4,2,8,54074,42076,0,0,603
10,8,2,0,6,75062,0,0,169,627
15,9,6,1,8,41470,248,45,3775,470
27,18,9,12,7,556233,127603,249,52355,426
10,4,6,2,6,32212,206,106,2883,501
34,7,27,2,12,35935,29055,72,19055,602
11,9,2,7,10,120909,61824,21,5357,468
24,3,21,2,11,8340,15886,0,0,630
28,9,19,4,15,105106,10165,81,4762,486
24,11,13,5,10,300980,30302,239,14931,402
18,2,16,0,9,34277,0,0,0,680
3,1,2,0,17,0,0,1,1427,630
24,5,19,1,11,271191,8443,175,8443,503
10,3,7,1,4,35649,3050,1,1647,622
12,5,7,1,18,13090,3618,8,3618,614
16,10,6,7,6,45270,34067,54,6066,412
17,14,3,6,6,263210,63469,33,22502,450
9,4,5,4,7,604312,27908,10,4177,474
22,16,6,0,10,260431,0,6,246,599
30,5,25,5,10,14337,14337,471,8090,485
10,5,5,3,2,37603,481,89,857,567
42,10,32,6,21,223287,80918,446,16236,555
25,7,18,7,8,21671,21671,431,11813,484
12,9,3,6,15,583364,37014,110,22385,422
22,6,16,3,12,91116,52627,44,6411,504
14,6,8,1,7,26647,520,232,335,548
19,8,11,0,13,164397,0,9,1325,628
21,12,9,14,13,408487,516174,267,0,494
11,7,4,6,10,22858,21118,187,7867,488
214,6,208,5,10,18999,12506,152,936,493
11,3,8,7,9,26459,46806,0,0,531
12,6,6,0,16,145446,0,1,0,623
15,7,8,4,7,27846,32524,37,11772,458
9,6,3,4,10,366153,11340,74,3003,475
5,0,5,0,8,0,0,0,737,660
10,8,2,7,8,142174,117496,156,0,499
9,6,3,3,13,740321,10761,24,3610,435
16,3,13,1,5,126779,102000,9,102000,635
32,11,21,0,19,513866,0,9,0,626
20,7,13,3,8,49992,8035,125,7740,463
11,5,6,0,7,294188,0,6,0,512
15,4,11,3,9,8861,8861,39,4969,493
13,4,9,3,18,70929,31491,216,22529,514
13,3,10,2,15,10430,6048,121,5954,577
4,2,2,2,8,10399,16835,8,10399,512
5,3,2,2,5,10994,13027,13,10377,462
15,6,9,2,30,416452,17459,30,1916,476
17,2,15,0,10,0,0,0,718,648
5,3,2,1,27,48912,484,5,0,499
7,4,3,6,5,174227,134043,80,17989,468
12,9,3,7,7,54876,54536,210,15135,393
9,4,5,3,19,3285,3285,74,1363,491
7,4,3,2,9,71891,10619,42,9504,550
26,4,22,3,16,22563,6751,354,11405,503
13,6,7,5,9,23878,23212,333,17408,507
6,2,4,1,6,7465,2690,57,9760,503
14,6,8,2,12,205508,21873,43,14450,438
16,8,8,6,12,245454,146113,0,0,447
2,0,2,1,5,51423,51423,12,0,648
12,8,4,1,12,2276893,7057,29,0,603
2,0,2,0,9,0,0,8,28495,610
13,5,8,4,10,55861,11803,24,477,442
31,4,27,1,10,85464,55844,25,4280,545
18,7,11,2,16,186346,17990,51,1193,470
9,2,7,1,15,878512,43100,41,7190,513
8,5,3,4,8,639655,11398,61,2819,474
6,3,3,1,18,36215,36215,11,1971,564
14,8,6,3,9,388164,14137,124,3246,451
18,5,13,5,13,50316,34613,107,0,499
50,6,44,8,17,46460,71828,179,34402,459
12,4,8,3,12,43675,23054,17,13340,485
12,10,2,4,14,678189,54673,101,19021,576
9,6,3,0,10,252148,0,1,1252,445
5,3,2,1,6,7219,2009,18,0,634
3,1,2,0,9,0,0,18,607,648
13,1,12,2,7,11009,31947,88,5774,641
11,8,3,1,6,235601,5399,41,5472,459
8,2,6,3,9,17121,20336,42,0,626
16,9,7,5,7,548509,46580,87,409,493
10,7,3,5,9,319981,254089,137,22578,451
55,11,44,1,11,301543,46964,133,10222,480
14,9,5,6,10,34878,29577,245,9052,506
76,16,60,6,15,224070,6894,137,7990,460
11,5,6,2,15,77206,9920,82,8694,485
10,8,2,5,12,400235,39761,137,16688,455
14,2,12,2,8,10070,8046,57,0,525
12,4,8,3,11,22853,21853,260,14444,511
2,0,2,1,6,34193,24420,18,0,597
25,4,21,4,13,32196,32196,124,11413,472
6,2,4,3,6,20730,20730,55,15015,572
9,3,6,4,14,338333,380693,67,309293,551
8,3,5,2,4,4014,3712,51,3960,478
6,3,3,0,11,16668,0,4,13655,672
8,1,7,0,8,6152,0,0,0,629
18,8,10,8,7,329056,413455,67,155142,460
10,8,2,2,6,486003,48294,15,0,503
14,10,4,8,14,411239,160489,148,15917,456
9,4,5,3,9,62758,62042,169,4123,530
20,7,13,5,14,47680,47680,105,24490,527
22,12,10,2,3,363640,4976,12,1007,470
15,9,6,9,6,44185,42877,480,15744,404
24,13,11,9,15,40591,22726,129,3741,397
5,3,2,5,6,21120,22949,55,8906,492
5,3,2,2,9,7474,7474,45,0,522
7,5,2,0,5,42736,0,10,0,442
13,4,9,5,8,400413,41051,84,2906,459
11,5,6,6,11,675225,233574,105,95248,507
9,4,5,0,12,140767,0,9,0,544
47,5,42,1,18,577851,6124,42,16348,395
37,14,23,1,19,213048,30061,31,6357,470
7,1,6,1,8,21330,21330,25,21330,511
9,4,5,2,17,678505,90879,73,3328,505
11,5,6,6,10,27362,46780,3,13427,443
8,4,4,2,9,30404,27760,119,12877,509
4,2,2,1,24,1784,1784,6,11514,455
13,6,7,4,12,231593,153796,76,50,556
7,1,6,2,12,4591,12331,16,4591,524
15,2,13,1,8,4160,4160,15,1870,459
29,7,22,7,13,301086,58134,0,0,487
10,6,4,1,21,409014,5492,4,11594,488
4,2,2,2,14,221217,223342,57,0,490
22,12,10,10,19,69879,35390,166,12041,461
15,8,7,0,20,220829,0,0,0,512
8,6,2,7,6,23880,33107,100,9227,471
11,3,8,2,8,189085,54676,28,0,527
7,5,2,6,8,39968,39968,418,9796,510
21,12,9,12,13,1022487,516243,0,0,498
15,9,6,11,7,53421,66910,427,18159,425
11,4,7,1,10,37683,3970,27,3970,632
12,6,6,0,6,36100,0,17,387,537
16,5,11,4,18,37234,37234,54,8885,516
15,9,6,5,12,102011,74198,70,3397,485
32,4,28,1,6,294638,1320,10,1320,630
22,5,17,3,15,18640,18310,60,14207,430
20,13,7,4,15,590231,12377,9,0,533
6,4,2,3,17,381470,16506,35,996,573
23,7,16,1,4,65238,4,116,2916,488
30,21,9,0,9,3041155,0,3,6531,563
11,6,5,1,7,290540,102,39,412,543
3,1,2,0,4,0,0,0,0,588
11,9,2,0,9,91285,0,0,14872,598
15,5,10,0,13,18576,0,0,0,612
9,5,4,4,4,70741,70741,89,785,518
7,3,4,2,8,9467,8777,30,7735,608
30,8,22,8,6,47259,33213,52,8559,443
10,8,2,8,11,26900,26900,549,10282,418
20,2,18,2,10,9660,9660,59,8007,546
31,4,27,4,7,5337,5135,158,14260,455
9,6,3,4,9,11055,8259,117,4456,514
8,6,2,2,12,106198,28862,35,19770,609
8,3,5,4,9,21007,43900,62,5090,455
8,1,7,1,7,0,8126,25,2100,551
5,3,2,1,9,6168,511,33,511,545
7,5,2,3,4,35425,5823,18,1414,478
26,9,17,9,12,707877,132225,169,83811,489
6,4,2,4,13,72879,75563,57,0,429
11,3,8,0,10,394996,0,20,186,497
14,5,9,3,13,28016,20734,68,32576,626
2,0,2,1,7,26037,26037,19,0,605
19,6,13,3,11,46147,35431,55,3259,482
5,3,2,0,9,670,0,10,2660,540
15,7,8,1,16,11197,10516,77,3152,503
7,2,5,2,15,7488,1926,7,1377,429
30,17,13,0,30,2044152,0,0,0,622
14,12,2,3,12,261351,247,28,417,580
25,11,14,10,5,50165,61371,151,18859,459
7,4,3,0,7,52153,0,0,0,513
19,4,15,3,19,55241,55515,87,5102,528
24,9,15,0,7,119775,0,14,1700,555
17,5,12,3,7,43457,13838,30,3969,556
30,9,21,4,13,399221,18589,178,19777,452
9,5,4,0,14,9400,0,27,1636,415
7,3,4,3,13,12621,12621,41,3325,424
23,16,7,0,13,385028,0,23,7266,532
16,9,7,1,12,459384,2878,23,859,571
38,23,15,21,16,1697303,1692723,186,199084,411
14,8,6,1,13,457592,349,24,5354,474
7,2,5,1,3,25090,3315,60,3315,493
38,4,34,2,19,5435,5435,66,2461,471
6,3,3,3,7,23819,33754,0,0,513
25,7,18,4,14,4461081,1212085,65,0,553
25,5,20,2,11,629165,21048,24,7639,520
20,11,9,12,10,88036,145556,0,0,464
24,3,21,7,19,97191,283981,162,63128,554
4,1,3,1,11,0,4578,1,1252,644
27,8,19,3,8,37614,3100,36,1678,394
30,7,23,5,26,29945,16990,59,11182,421
95,13,82,5,14,185105,144374,53,24393,517
15,1,14,0,16,0,0,0,11467,644
25,4,21,5,9,61878,61878,47,49619,455
19,4,15,1,10,27338,347,23,4761,579
7,4,3,6,5,28870,20109,0,0,440
17,8,9,4,14,101347,8862,104,4105,504
10,4,6,0,2,28626,0,24,244,611
41,10,31,7,9,120844,70671,242,39000,427
22,6,16,0,7,20054,0,0,0,674
28,13,15,0,22,615472,0,52,5679,581
4,1,3,1,6,0,20307,36,0,664
18,9,9,7,11,53146,44144,107,21124,429
6,3,3,0,11,688931,0,0,0,699
6,3,3,2,7,367354,33498,58,11045,494
10,4,6,4,19,29075,20097,31,18654,438
16,8,8,5,15,767926,273579,54,48681,495
19,10,9,0,7,74863,0,12,0,669
4,2,2,2,4,20960,20960,0,0,478
17,8,9,2,10,11073,3089,14,2412,485
61,2,59,4,14,5465,18253,23,5447,504
16,12,4,3,12,293964,5781,61,783,460
16,12,4,5,4,29340,2104,30,1352,438
25,7,18,2,14,34116,1104,54,3125,467
36,5,31,4,14,165917,165917,47,144085,500
10,8,2,0,69,14588,0,20,1232,567
13,3,10,4,11,29064,40994,23,11577,510
20,8,12,0,8,139512,0,1,1170,632
12,3,9,0,12,54969,0,19,0,647
18,13,5,0,12,24235,0,10,2160,539
29,18,11,17,17,738719,314506,275,49981,383
53,10,43,3,21,379412,126973,26,28069,480
22,2,20,4,28,29662,46118,0,0,482
12,3,9,3,21,230,53150,78,0,697
13,2,11,2,13,15022,15022,21,13597,474
12,3,9,3,8,16644,12000,195,1030,517
9,6,3,4,17,317973,23011,98,4923,485
10,5,5,5,8,422021,421318,53,118174,490
22,3,19,1,8,40594,16374,0,0,525
7,4,3,0,10,241156,0,0,0,678
5,3,2,3,7,66270,56865,111,2307,522
12,4,8,4,12,251146,69686,51,28356,498
10,2,8,0,9,26888,0,18,0,528
6,4,2,3,14,57856,45993,54,25874,557
5,2,3,3,5,23739,34902,25,11163,472
29,6,23,4,18,60805,23478,18,19289,466
12,10,2,0,10,264671,0,3,512,672
15,7,8,14,4,121484,332558,133,61321,429
29,18,11,14,16,449751,362373,172,121790,425
36,15,21,0,21,749125,0,24,297,644
4,2,2,0,15,0,0,0,5064,716
9,5,4,4,11,42385,23405,188,6082,505
56,18,38,1,12,53638,449,14,8568,530
21,13,8,8,16,790104,141510,137,99619,469
14,11,3,1,12,608650,7053,20,0,448
6,3,3,1,6,38317,1032,16,1032,555
12,9,3,1,7,6065,201,1,598,659
7,4,3,3,9,43349,3347,46,596,515
19,5,14,6,13,224753,233201,87,85009,443
11,6,5,9,16,69572,68758,168,11710,441
12,7,5,7,15,439576,397926,45,190326,426
28,13,15,5,14,348775,36848,69,26337,446
26,12,14,1,16,270720,46,9,0,672
24,10,14,2,11,100273,4558,20,861,520
29,5,24,1,11,49275,3569,16,3955,540
6,3,3,3,20,58875,45987,53,43884,537
9,4,5,2,9,18989,6692,46,22902,555
6,2,4,1,11,20446,20446,24,20446,491
11,4,7,2,11,25296,9056,39,5985,479
39,7,32,7,17,24056,21543,70,15534,412
18,7,11,3,10,81609,32760,116,450,515
10,3,7,2,18,6009,11009,48,13961,400
25,12,13,12,8,427997,252764,257,66672,382
13,7,6,7,14,98436,94275,139,13343,528
21,9,12,1,18,49591,2355,2,7699,468
17,2,15,1,9,534,534,48,611,603
9,4,5,3,12,69285,26146,60,11421,609
14,4,10,1,7,47295,3226,60,3226,609
11,6,5,0,7,225444,0,0,0,553
35,12,23,1,8,218294,83,62,3686,494
17,10,7,7,15,92845,80880,68,13111,418
21,6,15,1,12,94343,1010,28,3333,575
7,0,7,1,7,0,2331,1,17259,515
3,0,3,0,7,0,0,2,0,613
13,10,3,5,9,32833,12827,102,2559,456
15,5,10,4,6,101374,33381,233,16330,512
14,9,5,1,14,230331,1194,7,1194,596
9,5,4,4,7,47514,79675,35,38835,530
17,5,12,1,13,202732,30822,11,0,684
14,4,10,2,18,40306,6827,60,5818,489
14,8,6,3,10,35475,15275,27,7059,466
10,3,7,1,19,389694,11663,24,11663,577
120,6,114,0,11,109286,0,26,3331,507
35,19,16,1,21,1648671,1364,9,0,492
7,4,3,2,10,33719,33719,0,0,667
6,3,3,2,14,158449,31314,34,22946,513
21,8,13,7,8,32257,28934,115,7610,438
7,4,3,0,5,104837,0,0,0,631
6,2,4,3,14,3101,5829,76,2728,553
10,5,5,3,14,13544,10614,12,8372,490
10,8,2,1,9,169277,8536,16,0,480
7,4,3,4,8,28635,28635,76,7296,537
17,7,10,3,12,12876,21744,55,1777,467
7,5,2,6,18,15905,18900,77,7468,495
17,11,6,1,16,668387,1,2,1,514
9,6,3,1,7,52099,2933,11,0,470
41,10,31,6,14,556489,39324,317,17699,469
22,13,9,5,2,214964,7096,81,1673,491
30,14,16,18,22,996076,993962,300,196569,479
12,8,4,1,25,295005,520,24,0,552
7,5,2,3,9,79709,72516,59,0,451
15,9,6,3,6,46981,32741,25,3531,491
6,4,2,1,6,13930,50,20,2542,527
8,1,7,0,11,10012,0,3,1411,654
7,5,2,0,6,24146,0,0,0,709
19,10,9,0,28,1114129,0,1,0,612
63,3,60,5,10,758987,308702,45,4075,519
19,7,12,6,8,69414,51805,63,18381,462
39,19,20,6,15,461535,31645,300,9340,386
15,12,3,12,6,69075,62876,136,16238,404
9,6,3,2,14,64663,27153,37,0,495
12,2,10,0,9,20440,0,11,5887,434
5,3,2,2,9,8439,8439,24,5619,537
48,11,37,11,15,77667,76647,369,25370,398
51,13,38,9,13,132847,73052,244,19085,417
12,6,6,2,18,46574,1098,17,6468,486
20,7,13,12,7,457242,185641,0,0,440
4,2,2,1,14,68638,59538,25,0,654
57,9,48,4,21,892405,443387,128,0,497
9,2,7,3,16,34450,43319,10,18022,476
11,8,3,1,8,217891,12560,22,1326,470
14,8,6,8,11,397319,57683,7,241,497
15,7,8,4,18,27138,23530,61,4979,446
13,3,10,2,18,16353,16353,8,13769,628
11,2,9,0,11,10235,0,0,0,611
13,8,5,0,15,1613479,0,14,0,677
24,12,12,0,9,369485,0,6,0,535
105,4,101,3,18,36295,40455,80,30600,547
35,12,23,0,11,88106,0,1,259,645
56,2,54,1,5,2244,2097,5,2097,380
27,7,20,6,18,46073,44090,67,2615,450
15,4,11,1,9,562851,6836,43,6836,625
9,5,4,0,14,1758,0,4,0,756
9,4,5,4,6,23996,23996,41,6757,594
23,3,20,2,9,15484,15484,248,14694,542
11,4,7,2,14,879241,518404,50,29675,531
24,8,16,1,13,633181,1826,49,1826,532
10,3,7,5,17,41588,40805,39,12978,468
19,10,9,0,11,1940045,0,16,12488,491
6,1,5,1,18,29656,29656,0,304,569
15,6,9,5,5,18773,9580,61,0,546
10,6,4,3,3,40853,36124,72,2892,409
20,12,8,3,6,324132,3572,52,1667,495
9,3,6,3,12,39918,33915,55,15295,504
5,3,2,4,6,185747,103904,68,0,552
7,4,3,5,9,191301,45548,21,4980,442
5,2,3,2,7,361264,34262,30,0,579
16,11,5,2,9,51044,11131,1,2422,467
9,5,4,1,23,66620,11065,31,11065,535
24,14,10,5,23,896172,42423,0,0,520
10,7,3,6,25,52807,53884,106,8533,511
10,6,4,6,5,400079,579238,135,0,451
39,3,36,0,19,242332,0,27,8895,436
8,4,4,1,7,167522,1225,30,540,510
7,2,5,2,14,18642,12338,12,1655,548
33,11,22,1,13,76500,24026,36,0,603
12,2,10,3,17,54139,60822,103,590,613
8,5,3,2,5,40847,878,2,662,399
5,3,2,3,14,17187,16060,46,3589,528
10,1,9,5,9,12373,40198,0,0,488
26,13,13,9,20,678423,47246,12,11991,453
12,9,3,8,5,19088,19088,116,6720,425
15,6,9,0,8,226284,0,1,0,599
8,4,4,3,12,84812,80233,57,48913,526
40,8,32,9,6,49028,44084,113,32349,475
43,8,35,3,10,95718,13919,66,2253,511
18,12,6,7,7,290216,31196,96,21218,464
26,7,19,7,11,61841,56826,58,6822,436
11,6,5,4,8,243650,24973,41,10664,434
7,3,4,3,7,5278,7651,49,4733,506
33,13,20,3,15,195181,45179,100,16377,429
19,11,8,5,20,420941,34221,93,2728,464
6,1,5,0,7,0,0,0,0,726
15,6,9,4,9,191084,98633,54,3585,520
17,8,9,8,5,38508,20341,44,6656,474
8,1,7,1,11,2887,2887,21,0,512
27,8,19,8,18,58188,87496,82,25675,506
12,2,10,1,8,3446,1770,33,0,568
10,3,7,3,7,1446,3305,27,0,524
5,3,2,1,10,48889,6893,0,0,629
47,11,36,5,9,135969,28359,166,1369,433
9,7,2,1,11,35193,10305,18,10305,675
24,6,18,4,6,39810,26109,116,8102,449
47,9,38,6,12,308971,37763,16,3558,451
18,0,18,0,10,0,0,3,592,654
12,10,2,8,13,209137,173501,113,35461,430
14,9,5,1,18,116136,10200,13,10200,613
17,13,4,1,14,134477,185,21,0,470
17,13,4,6,8,375757,7225,91,4378,458
17,15,2,8,16,616740,36937,9,600,475
54,21,33,15,7,444350,117304,222,20531,437
14,6,8,0,17,8657,0,22,797,535
7,4,3,2,13,15513,1690,45,0,481
10,4,6,3,9,25731,7542,32,4507,439
31,8,23,3,14,488563,65591,60,27092,487
24,4,20,0,11,753969,0,3,1333,700
63,22,41,12,16,476794,159251,422,8009,432
32,5,27,3,10,59464,31154,123,32500,531
21,10,11,1,12,146247,8024,29,0,480
36,11,25,8,13,232691,91148,282,56951,432
16,11,5,2,9,199472,148000,35,149,561
14,9,5,7,9,8833,15666,103,2813,429
6,4,2,5,10,433277,476717,46,178604,479
14,6,8,5,20,242937,280096,101,0,498
63,16,47,11,14,1094567,1024498,284,53678,418
20,2,18,1,14,1673,1673,20,1673,503
9,7,2,6,20,235704,234504,113,109790,435
17,12,5,8,12,349178,58133,109,14860,440
10,3,7,2,11,23526,23526,91,30718,456
24,2,22,1,18,26703,11076,27,1590,564
8,5,3,0,4,19546,0,22,5220,558
18,8,10,0,21,60635,0,0,0,720
13,6,7,4,9,31801,7946,24,5265,382
36,5,31,2,18,263765,73399,187,0,535
5,3,2,3,11,25900,25900,86,24559,460
22,5,17,1,8,37629,648,26,2932,514
9,5,4,2,10,253614,7396,53,6178,487
37,15,22,19,25,1111844,783443,44,11746,475
9,6,3,6,8,41207,26032,83,9884,466
15,8,7,0,6,34613,0,21,1623,526
9,3,6,3,14,4498,115489,15,4498,540
8,5,3,5,8,23592,23592,125,12744,441
19,9,10,0,16,50786,0,9,232,644
18,5,13,0,15,708326,0,5,0,616
32,7,25,4,28,57932,55767,355,32658,496
11,9,2,2,3,51584,10478,9,38,535
77,13,64,13,12,225289,155351,135,2694112,482
36,11,25,8,18,545899,20162,137,5480,503
15,9,6,0,13,1028769,0,6,0,520
15,11,4,4,12,71632,34878,63,5130,457
4,1,3,2,4,8895,8895,12,6200,518
16,10,6,3,12,310133,9598,36,4513,361
13,7,6,6,25,377740,10108,39,5333,480
31,5,26,2,69,7034,2127,50,3813,491
77,7,70,0,19,245849,0,17,830,595
8,4,4,3,15,35535,35535,49,16627,598
9,4,5,0,12,22512,0,0,0,630
6,4,2,0,5,18468,0,6,198,641
13,6,7,0,13,2121,0,1,70,643
6,4,2,3,3,28958,11728,22,942,487
15,12,3,1,11,1477447,2480,25,5514,501
6,3,3,2,13,54664,65598,49,6779,548
5,3,2,4,19,23589,23589,26,10900,445
8,4,4,4,5,17537,18698,67,11390,603
40,6,34,3,11,99443,11743,56,4885,578
16,5,11,4,8,83927,33624,90,3404,474
10,5,5,3,9,314012,39005,51,350,501
11,5,6,1,6,27397,255,15,0,469
36,5,31,4,10,61458,41612,165,19371,393
22,14,8,1,12,212481,6621,3,6621,566
35,9,26,6,20,205913,101481,99,44139,477
19,3,16,2,8,12490,246,314,2625,471
9,4,5,2,14,34864,11229,92,6150,415
11,6,5,0,7,56640,0,6,270,641
30,8,22,7,17,47653,46482,260,14870,398
8,5,3,5,6,307621,32885,77,4506,448
10,3,7,4,8,64074,60821,0,0,510
22,14,8,7,11,543626,184033,122,6835,377
14,4,10,5,14,27364,27364,111,7681,626
9,4,5,4,15,21280,10810,20,5913,431
9,4,5,3,8,38756,24955,13,21694,425
32,10,22,6,19,192879,49784,99,22540,485
4,1,3,2,5,4659,13928,0,0,477
6,4,2,4,7,172557,264215,75,93264,444
9,6,3,0,4,36797,0,0,0,509
11,2,9,1,2,14204,1913,1,3445,516
14,9,5,7,15,394481,77243,4,1028,444
27,5,22,2,8,20685,11857,119,9700,551
7,5,2,4,2,23908,2329,49,1927,446
17,5,12,3,13,15138,11085,64,8400,502
5,2,3,2,8,7137,7426,0,0,526
8,4,4,1,8,36725,860,33,0,479
3,1,2,2,6,58113,99622,31,58113,526
7,4,3,3,8,24856,28978,6,13848,462
125,9,116,5,14,57252,43803,416,16166,455
10,8,2,0,6,71155,0,3,1320,515
23,11,12,0,8,1240526,0,30,959,445
22,2,20,2,16,23260,23260,61,5777,592
23,9,14,6,12,20540,25258,64,2115,474
130,11,119,10,17,580013,113001,62,48257,421
7,4,3,0,6,39342,0,47,0,642
38,15,23,15,15,248049,249936,186,15505,423
22,9,13,9,12,96808,48410,88,12371,441
23,10,13,8,12,628487,81932,279,21647,451
29,11,18,2,16,312523,10468,43,19800,417
16,4,12,2,15,100324,52259,69,3959,467
20,5,15,5,41,65904,56973,25,30858,449
9,5,4,5,8,18131,23335,101,6829,447
27,6,21,1,14,28810,25782,4,25782,520
18,8,10,0,15,1139534,0,3,0,665
9,6,3,1,6,112571,1671,18,0,485
87,13,74,7,18,863658,155174,253,41048,470
25,7,18,4,8,13856,5757,56,3519,543
9,2,7,2,15,9039,7566,38,5051,526
13,7,6,3,12,456238,183259,48,11381,485
10,3,7,1,6,2286,557,23,557,534
10,5,5,5,12,110535,47784,0,0,488
19,7,12,6,10,328172,45205,71,14375,421
11,6,5,3,15,103337,76378,54,52183,600
16,6,10,4,12,78957,42259,78,9100,424
27,6,21,3,17,105030,63317,62,54803,495
4,2,2,0,2,10107,0,0,0,686
27,8,19,8,13,394691,101485,57,31634,414
47,9,38,9,12,94548,54800,370,30156,455
5,3,2,1,9,17836,10108,6,480,525
4,1,3,1,7,3600,11907,28,0,544
84,14,70,5,22,314098,113890,331,61473,481
5,3,2,3,11,12162,24591,74,12162,466
12,5,7,4,14,29934,11703,12,5323,450
16,7,9,1,15,783677,1500,29,1760,460
4,2,2,1,7,17667,5620,4,781,470
11,4,7,3,13,62370,8961,57,3292,503
15,9,6,0,9,168945,0,3,0,682
9,6,3,5,12,6547,6547,33,3443,434
52,5,47,2,12,25509,13846,130,10378,550
9,1,8,3,9,1,14378,0,0,644
25,6,19,1,15,46639,666,3,3780,488
15,6,9,2,13,121750,722,19,2753,578
22,3,19,3,14,57821,13391,110,8270,486
21,16,5,9,12,746193,218501,58,6598,445
15,7,8,2,9,47168,15102,0,0,520
14,5,9,3,5,52225,31031,11,28628,436
18,2,16,0,10,235571,0,15,0,601
12,4,8,5,16,32961,52053,55,17160,530
8,5,3,2,11,96384,4056,12,0,535
9,4,5,5,9,117593,151801,73,16151,418
20,8,12,8,8,172585,102547,291,83236,477
21,9,12,0,13,262908,0,17,0,644
10,2,8,0,6,2812,0,21,4877,639
5,2,3,2,9,26610,26610,29,485,455
9,3,6,0,9,131661,0,3,0,582
14,7,7,0,6,135967,0,2,0,599
10,4,6,4,9,35714,35714,67,17600,446
16,6,10,6,8,380722,17684,75,2800,448
4,2,2,0,6,57029,0,5,0,618
4,2,2,3,7,34906,42488,0,0,470
36,8,28,5,9,114871,76966,107,9130,571
10,8,2,2,16,270568,16426,37,14376,506
9,6,3,5,15,97387,115061,113,50538,584
11,9,2,2,2,406328,268,17,1523,550
26,15,11,5,12,78232,12011,321,16823,469
8,5,3,3,10,32471,32471,84,5975,455
13,8,5,0,8,167335,0,1,0,655
14,6,8,3,10,303351,11425,48,3970,513
71,12,59,5,15,90264,10919,87,8571,428
22,9,13,6,6,316295,220237,83,532,498
10,4,6,1,4,269574,547,17,1132,504
9,3,6,2,8,5148,5148,32,6530,481
17,8,9,4,7,220260,77002,49,3711,521
13,4,9,0,8,9879,0,12,1167,655
76,10,66,11,8,111096,105108,32,4393,437
27,17,10,2,22,1560080,117417,47,156714,615
6,2,4,1,18,465192,121671,0,669,640
6,4,2,5,6,14089,18540,67,6520,514
16,12,4,0,11,380080,0,19,3466,612
15,11,4,0,12,573647,0,4,0,585
7,4,3,4,8,519834,61672,52,51912,495
26,9,17,3,21,103540,7994,46,2250,525
34,7,27,4,12,26685,9474,94,4394,438
10,8,2,0,5,190718,0,19,2490,565
7,4,3,3,8,6413,10177,47,0,524
31,11,20,0,11,232205,0,9,0,596
21,7,14,10,8,71831,112628,223,21898,438
22,10,12,2,13,754813,5558,16,3313,600
8,6,2,0,2,281804,0,4,0,501
25,4,21,3,14,68145,25282,56,29618,515
40,7,33,3,20,24587,3442,37,3290,571
8,1,7,0,4,31508,0,0,0,567
7,4,3,0,10,36136,0,0,0,680
11,9,2,9,5,29150,44319,116,7000,419
52,9,43,6,14,60539,22377,367,6140,466
15,8,7,1,14,78013,30694,33,6959,492
3,1,2,1,8,7211,7211,56,7211,474
5,2,3,0,6,34737,0,8,3211,608
10,5,5,1,7,26951,101,11,9728,466
19,10,9,3,15,195151,12307,11,1,476
15,9,6,8,11,68366,89565,4,9117,454
8,1,7,2,7,15876,15876,34,766,574
8,5,3,1,21,34158,5094,12,0,539
19,8,11,1,11,247527,247,32,397,517
8,4,4,2,6,319666,23881,18,768,468
18,8,10,0,15,36173,0,0,0,638
42,13,29,12,21,380821,378028,492,27945,460
25,6,19,6,6,26404,26404,131,10452,610
8,5,3,6,7,81279,158484,0,0,578
10,6,4,5,13,115250,100971,84,24705,484
21,10,11,2,11,511110,3016,8,2567,462
8,6,2,4,16,44763,43717,73,22595,549
15,4,11,4,14,155383,12668,72,3830,521
45,0,45,0,2,0,0,0,0,653
18,5,13,4,7,31540,50474,152,8052,414
7,2,5,4,11,5465,13253,48,5035,645
5,2,3,0,4,48712,0,3,972,541
20,11,9,1,11,245846,1014,4,1126,407
74,9,65,2,7,55642,2546,52,5157,585
13,4,9,4,13,68935,32095,97,40445,489
25,17,8,0,24,4375955,0,0,0,610
20,8,12,0,13,306324,0,9,0,668
17,2,15,3,10,21906,30695,56,19336,445
19,7,12,3,10,177740,786,108,734,555
29,11,18,6,14,743721,51354,151,14240,481
15,7,8,5,10,101567,18375,114,9834,512
8,2,6,1,13,249628,4242,1,4242,510
13,2,11,2,9,7051,9925,39,0,491
46,6,40,3,11,73085,12083,44,7587,468
18,11,7,1,17,5683,23219,31,672,624
18,4,14,0,9,207613,0,2,926,537
6,4,2,2,12,43684,19815,51,0,474
33,8,25,5,12,62861,26208,233,14544,422
5,3,2,1,11,34282,8458,13,8458,595
5,3,2,1,15,414327,10324,24,10324,649
10,2,8,2,14,23603,52573,0,0,623
8,6,2,1,2,114865,1004,4,0,537
45,14,31,10,7,207563,98519,219,16454,429
42,16,26,7,15,260099,28638,91,9791,449
28,11,17,0,17,654336,0,31,898,545
33,7,26,3,9,37502,37423,241,1711,451
8,2,6,2,7,30114,9412,8,1413,452
29,5,24,6,19,480240,92910,101,35899,498
10,5,5,4,10,23068,17855,88,7677,452
8,5,3,6,6,82902,83749,109,23680,498
27,19,8,19,10,91371,83847,391,14657,399
18,6,12,6,13,25655,21117,80,5561,448
14,6,8,3,8,254871,16637,55,4706,474
20,8,12,0,16,745696,0,5,0,529
23,8,15,0,5,10973,0,12,2774,661
47,18,29,1,11,377630,446,43,1681,500
29,7,22,0,14,286238,0,26,4128,547
8,3,5,0,15,32797,0,8,260,687
17,5,12,5,7,68350,45279,9,2938,486
10,6,4,0,6,48120,0,19,1083,500
21,11,10,0,7,828140,0,10,2993,470
9,7,2,2,4,341437,23008,122,22276,452
26,13,13,10,14,149493,136031,417,59748,410
46,6,40,0,14,41765,0,9,3919,672
4,1,3,0,12,0,0,0,0,740
7,5,2,4,16,151170,151170,65,1874,428
9,5,4,0,17,37152,0,0,4643,604
18,7,11,3,15,21145,10318,109,5858,598
8,3,5,1,6,34807,17544,21,317,539
28,12,16,10,15,369955,393487,51,12445,476
15,5,10,2,18,228611,59438,67,0,511
22,12,10,10,6,274975,43334,315,8999,416
6,3,3,3,7,25072,25072,293,22603,490
27,4,23,1,10,5750,3263,43,4870,528
9,2,7,2,8,174350,13155,30,0,595
6,3,3,3,10,21716,21716,10,11380,458
18,3,15,0,9,9224,0,15,277,698
7,3,4,1,7,6218,4859,7,4859,596
15,7,8,9,12,67009,64769,101,22680,468
19,3,16,4,12,25829,51061,77,25232,559
4,2,2,1,5,12380,1302,3,0,464
8,5,3,0,7,6328,0,4,0,642
29,14,15,10,9,387893,261556,234,180791,489
5,1,4,0,12,0,0,0,3130,684
5,2,3,0,7,374897,0,1,8473,670
64,17,47,14,21,160412,133498,70,60329,394
8,6,2,4,7,23348,23254,23,2488,469
16,8,8,3,13,176926,72620,48,40323,466
16,5,11,3,9,30047,3984,21,2235,487
38,8,30,8,11,77032,77032,148,56603,446
10,5,5,2,9,219692,5458,15,14580,470
14,9,5,9,12,291824,291824,123,10604,430
9,3,6,2,8,37999,37999,30,22150,475
5,3,2,0,14,7954,0,8,1964,590
11,1,10,0,5,9637,0,8,2206,636
15,7,8,11,10,88574,133718,241,7700,438
40,13,27,6,26,259523,137491,152,5063,454
32,11,21,9,18,564314,110768,47,71940,391
20,8,12,14,9,809341,1124514,270,382255,418
4,0,4,0,7,0,0,3,0,595
10,4,6,2,14,476317,3720,25,1770,462
18,15,3,10,19,582459,183513,46,30590,450
21,11,10,4,7,392797,101529,266,37116,442
11,4,7,2,19,13042,13042,38,8235,425
11,4,7,3,9,9912,4387,54,1085,414
9,5,4,1,12,197131,35018,0,0,535
20,4,16,1,14,194897,12939,70,12939,653
14,12,2,1,5,470432,5037,5,0,528
16,4,12,2,10,353690,20710,0,0,488
11,7,4,2,17,760023,10848,11,3601,501
13,5,8,5,8,86108,54851,87,16715,470
17,3,14,3,13,21689,21689,197,25912,521
7,2,5,1,6,35775,22950,26,22950,518
7,2,5,3,8,248634,14620,0,0,507
19,6,13,3,7,69340,22644,38,10318,482
7,3,4,0,6,22578,0,6,1260,627
11,5,6,5,1,31983,18052,20,9948,452
11,6,5,4,6,348487,31192,76,12146,450
72,13,59,0,10,197482,0,68,9031,632
3,1,2,1,7,4197,1411,30,0,529
14,8,6,0,7,70650,0,14,0,537
14,4,10,1,16,144069,14271,26,14900,529
14,7,7,7,15,41136,55624,67,20224,472
21,6,15,0,7,54957,0,11,826,553
27,14,13,9,8,186901,61793,84,26572,441
10,5,5,6,8,79208,80072,85,21768,491
8,5,3,0,4,445566,0,0,0,632
26,11,15,0,9,389625,0,39,7617,535
11,6,5,1,4,74687,750,9,0,520
19,9,10,4,21,407926,196009,82,40184,473
13,5,8,4,14,6589,6589,0,2005,487
5,1,4,3,6,26322,35099,9,10713,499
49,8,41,0,23,340338,0,1,440,609
17,7,10,0,4,34309,0,5,285,513
9,6,3,0,5,242407,0,8,0,616
23,2,21,0,9,3575,0,226,14248,650
17,5,12,4,7,49227,38179,54,4882,416
21,3,18,4,14,18271,18271,89,4044,559
25,10,15,3,15,194403,8240,110,7752,394
51,4,47,2,12,23009,13846,130,10378,555
7,2,5,0,7,12349,0,44,635,576
10,5,5,2,5,44001,21376,44,0,520
17,8,9,0,12,120187,0,10,0,647
7,4,3,0,17,315405,0,8,0,550
8,5,3,6,5,236292,54105,34,0,437
21,6,15,1,9,197942,7023,17,3028,488
8,6,2,6,8,58013,58013,72,5746,418
43,8,35,5,18,91041,73925,91,64835,463
26,8,18,8,15,863573,317817,178,94642,426
4,0,4,1,6,1232,1232,4,1232,631
12,5,7,2,12,2296,14325,0,0,524
25,4,21,1,13,32775,14810,11,14810,543
31,11,20,6,4,92501,52587,81,16433,429
31,2,29,2,11,19643,13380,41,11610,421
17,7,10,7,4,242756,63895,0,0,449
11,8,3,7,12,145928,97096,115,30296,427
30,9,21,1,14,499627,1100,86,1975,489
8,4,4,1,13,1192399,123614,54,1169,469
26,7,19,4,18,941491,14562,64,4210,523
5,3,2,0,4,226756,0,2,0,603
34,10,24,13,16,117617,120020,95,24929,437
12,3,9,1,5,28976,2795,19,8701,608
18,8,10,6,8,30405,25309,73,2617,480
8,2,6,2,12,39412,11926,28,5242,618
17,11,6,9,8,34568,22592,132,6065,418
53,12,41,3,8,110853,13520,25,6096,421
12,5,7,0,10,6434,0,4,3708,568
18,4,14,5,18,518069,1226796,107,1182,550
29,10,19,7,13,1091473,164326,102,2314,447
7,3,4,0,9,2610,0,0,0,639
47,4,43,0,11,29945,0,3,848,585
16,1,15,2,10,36311,36311,26,2200,476
5,3,2,2,6,23091,21076,35,0,617
36,18,18,3,7,78073,223,7,716,577
8,5,3,5,7,32109,34509,24,7107,509
24,11,13,5,25,278390,307918,27,0,577
23,14,9,2,15,1149584,54782,9,54477,548
12,7,5,3,11,596719,7271,48,0,488
6,4,2,3,9,45406,34247,61,1150,533
3,1,2,1,12,4562,4562,23,4562,655
24,7,17,0,11,272520,0,6,1449,640
9,3,6,2,8,21149,16367,62,0,510
18,5,13,3,15,94219,50639,40,6588,520
28,9,19,4,8,86439,26909,6,6175,510
39,25,14,0,29,903809,0,3,270,564
39,15,24,0,17,823172,0,4,739,592
8,3,5,0,21,155637,0,0,0,689
11,8,3,4,8,311669,8611,14,1763,471
14,8,6,7,69,727833,46574,95,15495,480
23,5,18,3,18,143661,55490,40,37166,615
19,11,8,1,13,516614,70,34,10903,562
16,11,5,1,13,1301407,461,3,461,541
29,8,21,3,14,146075,26922,51,6137,491
5,2,3,2,12,1819,1819,6,2254,484
7,2,5,2,11,4166,4166,25,3202,612
12,8,4,7,9,310535,310036,0,0,550
27,4,23,7,26,56734,41475,89,5008,469
562,15,547,0,7,195610,0,0,0,652
13,7,6,0,19,83575,0,2,17764,610
10,4,6,1,15,422229,88664,4,176,680
20,8,12,1,10,101971,7297,37,3058,460
6,3,3,0,3,20950,0,78,702,512
21,1,20,3,9,6605,6308,56,3618,582
14,6,8,0,8,113300,0,39,541,556
8,5,3,1,6,23001,628,2,628,473
13,5,8,2,8,40661,32491,10,3940,509
5,2,3,2,11,10046,10046,3,1222,477
5,2,3,2,7,74630,69380,53,0,512
3,1,2,1,12,2078,2078,8,0,479
18,8,10,5,16,94314,123167,123,16081,465
18,9,9,2,16,527164,614,133,3450,589
17,7,10,8,16,564539,175911,148,95770,456
19,7,12,6,17,318637,27268,413,8196,518
5,1,4,0,10,0,0,2,4323,597
20,10,10,4,69,303178,9698,16,6681,466
34,12,22,3,9,60251,4794,75,2210,496
9,5,4,0,13,599788,0,6,13075,596
20,8,12,5,18,329363,38094,54,1053,498
29,8,21,3,12,15840,35435,56,20339,469
56,12,44,6,13,161760,43121,72,19611,491
10,6,4,3,8,96783,23402,51,15494,418
9,4,5,3,8,23650,21279,49,0,512
37,16,21,4,12,598832,83423,234,52659,536
28,8,20,2,11,664802,12114,2,5809,462
20,6,14,4,12,37120,161813,99,2000,606
7,5,2,3,18,27748,25086,69,0,474
84,5,79,3,16,341867,471,77,2147,529
31,4,27,2,9,28959,20305,0,0,454
19,7,12,7,18,569715,920132,163,301486,574
39,11,28,2,13,79673,16930,102,12487,449
14,9,5,3,7,36652,15767,285,13866,494
17,3,14,4,16,52940,41097,64,5289,499
23,8,15,3,9,447928,913,74,965,491
8,3,5,3,16,534975,49568,68,29178,613
23,12,11,7,18,45719,17994,53,4703,493
10,4,6,1,16,12549,8199,9,8199,560
7,5,2,4,7,12617,12617,230,5306,525
48,7,41,2,17,354393,133379,33,1321,545
15,5,10,1,12,274093,535,7,0,555
30,11,19,0,15,307480,0,70,4231,456
9,1,8,0,4,713,0,15,0,639
29,10,19,1,16,452745,2867,10,0,609
26,18,8,18,6,1278478,1511456,43,319912,408
34,13,21,8,11,773162,64970,80,14011,361
11,3,8,2,8,2937,2937,15,1567,504
6,3,3,0,12,2864,0,3,0,552
5,3,2,2,6,14922,3896,13,0,473
14,3,11,2,14,14172,14172,35,10349,578
6,3,3,2,15,240801,23101,17,2788,528
20,6,14,5,13,60914,55889,35,32765,443
15,10,5,10,15,1293329,405244,119,54052,421
28,9,19,1,16,286750,360,0,1630,619
9,3,6,3,12,45126,45456,64,21721,515
23,5,18,3,21,24176,22006,66,10493,511
13,8,5,2,8,361228,131757,20,10409,447
9,7,2,1,6,537013,273,1,273,577
7,5,2,1,13,21319,1487,5,0,473
6,4,2,2,14,11871,11871,0,0,537
26,6,20,5,16,74334,40165,108,3795,446
30,8,22,1,5,90531,414,33,1507,500
18,11,7,3,19,133246,25765,63,2450,497
7,3,4,2,5,63159,359,169,1052,464
19,14,5,0,15,349442,0,0,0,642
29,13,16,8,9,145947,91971,128,11992,451
14,10,4,4,11,340549,8988,23,1439,473
9,7,2,3,5,230958,13052,0,0,448
8,1,7,1,16,0,12336,13,12336,604
30,10,20,4,4,48863,12538,12,5958,429
12,7,5,2,7,30749,1301,6,922,518
11,6,5,6,6,22256,30217,38,9978,446
19,13,6,15,19,99985,117900,44,10179,426
39,18,21,8,14,385455,51334,368,11837,378
12,4,8,3,8,79237,52833,60,1292,518
27,9,18,5,7,156047,72042,86,15765,439
73,9,64,6,9,27370,2271,28,3683,477
32,7,25,1,69,286417,16076,12,16076,592
22,4,18,6,8,28677,18568,90,9084,481
18,4,14,2,13,25632,24392,46,13630,461
37,10,27,8,7,331575,229410,200,74934,384
18,6,12,4,12,15980,15463,30,10477,484
6,1,5,0,3,2153,0,6,0,569
24,8,16,6,8,420698,144521,80,9042,388
9,6,3,2,21,71301,21156,53,0,528
18,15,3,15,7,122841,111259,64,19206,468
5,2,3,0,15,594,0,0,1837,626
10,6,4,6,6,407342,32868,108,5498,327
5,2,3,3,8,31423,47586,0,0,475
9,4,5,3,15,288456,128747,7,23190,474
18,5,13,2,11,62660,8312,36,8699,474
13,4,9,3,19,18278,30664,65,4927,503
14,9,5,10,12,288479,84714,138,5059,498
16,6,10,3,7,186260,21086,7,4082,462
54,10,44,8,10,45091,38744,200,8849,453
6,0,6,0,8,0,0,0,933,673
54,17,37,12,12,588829,438904,303,157481,445
10,6,4,1,8,107089,4980,4,4980,464
10,7,3,4,4,93540,11180,15,349,464
6,3,3,3,5,16049,9967,52,3936,480
52,9,43,8,8,87096,41945,161,17536,423
23,5,18,5,16,33825,26216,27,11634,435
12,5,7,6,15,237630,55532,15,9643,485
7,2,5,3,6,1921,32641,0,0,471
11,3,8,1,16,795336,4300,59,0,621
7,3,4,3,15,10922,7402,63,995,436
27,14,13,1,14,1629992,254,12,0,603
8,5,3,3,19,129719,53870,43,0,525
11,0,11,0,8,0,0,4,278,594
3,0,3,2,3,0,16443,17,12901,605
13,8,5,7,7,103809,123835,132,6808,383
10,6,4,3,11,111277,44760,65,1347,492
33,12,21,17,7,563344,700352,153,87989,417
11,5,6,3,8,54798,26865,240,22557,536
20,5,15,1,8,23993,3224,30,3224,586
20,14,6,4,12,1019985,14848,14,17073,404
15,4,11,0,13,51208,0,0,0,630
32,10,22,6,16,482053,83842,86,23638,411
15,3,12,3,9,285107,12344,120,2876,481
11,8,3,2,4,24968,1932,7,1644,535
56,12,44,0,13,305276,0,145,18308,461
11,8,3,1,11,98175,7413,12,6421,568
11,4,7,4,19,35650,33779,33,13298,461
21,11,10,0,12,301232,0,54,366,615
7,3,4,6,12,15680,71485,56,9079,478
13,3,10,1,9,14382,3263,35,5831,474
33,9,24,0,13,973988,0,9,0,675
14,10,4,11,5,533829,274117,175,91138,443
17,7,10,7,8,45559,37458,94,10350,398
21,8,13,7,5,35316,35316,337,10292,378
10,6,4,3,13,322918,13523,51,5371,481
5,3,2,3,7,19119,29686,139,8612,529
13,6,7,3,7,44138,46266,68,2601,477
9,5,4,0,8,529885,0,0,0,411
3,1,2,1,6,8830,8830,4,582,534
14,12,2,11,6,28118,32630,62,3174,463
11,4,7,2,16,36023,24106,45,0,523
15,5,10,1,11,60560,35433,0,0,558
10,3,7,3,11,6345,6344,6,2765,531
8,3,5,3,13,260129,260129,59,244359,621
10,3,7,2,10,27645,16847,8,14845,507
22,2,20,0,14,2219,0,1,4321,601
16,8,8,8,16,739708,246303,76,20021,418
15,8,7,0,8,1216673,0,2,0,574
11,4,7,3,9,57111,38860,12,2873,492
9,5,4,3,9,25765,25669,132,11046,530
22,6,16,1,8,48487,8716,36,8716,503
23,7,16,5,13,30558,18713,154,7686,524
22,9,13,4,13,89057,7286,115,5978,408
13,3,10,1,7,117713,5667,0,0,575
19,8,11,8,10,90140,39523,94,11521,438
33,12,21,7,14,88642,24445,255,7494,458
5,3,2,3,13,391639,76335,48,59577,488
10,4,6,4,11,19653,32365,110,16291,518
13,8,5,6,14,693389,81303,118,13419,434
6,2,4,1,12,3587,3587,25,0,558
8,6,2,3,11,102439,14309,5,11454,597
11,3,8,0,8,9229,0,0,0,522
21,15,6,1,69,586082,37821,24,234,497
20,12,8,7,9,428766,5389,29,1465,469
9,7,2,4,14,46822,32666,83,9122,520
25,6,19,5,13,102441,75035,151,19796,474
12,4,8,7,15,94534,106872,74,0,490
10,5,5,0,21,31712,0,24,0,561
6,4,2,1,7,58151,291,1,0,651
82,14,68,4,18,114190,28736,37,9887,453
4,1,3,0,6,8746,0,3,1045,533
64,17,47,12,14,223297,115595,426,59317,417
4,2,2,3,7,27857,40049,60,1680,517
37,13,24,8,19,267066,53455,119,14738,476
5,2,3,1,4,18753,18258,12,18258,507
5,0,5,1,4,8989,8989,6,8989,555
8,5,3,3,7,19800,17653,61,14819,462
3,1,2,1,7,5746,5021,9,0,568
117,6,111,1,22,249392,4562,1,0,571
25,13,12,0,19,2349064,0,1,0,639
15,3,12,2,14,2849,548,0,0,536
59,8,51,5,15,26678,6221,165,3446,463
10,4,6,1,9,26059,3564,61,3450,462
5,2,3,1,4,5424,4301,11,1786,583
7,2,5,0,8,0,0,7,1753,713
4,2,2,0,14,9363,0,0,16,600
29,8,21,2,9,419394,4485,86,5045,508
19,5,14,1,10,43518,11826,22,11826,532
23,9,14,4,8,16598,29963,33,25128,439
11,3,8,0,19,677656,0,0,1762,635
21,12,9,2,12,695194,6230,50,16625,397
9,5,4,4,14,79736,7263,30,2791,460
41,13,28,11,9,385898,164937,251,25809,475
53,17,36,0,12,1045242,0,25,777,469
8,5,3,5,7,16221,23760,76,11795,414
13,10,3,10,7,74787,79648,126,32146,466
15,3,12,2,7,124040,112424,150,762,608
9,4,5,4,9,486667,31157,56,10823,429
22,8,14,2,20,126788,89169,22,27149,603
8,5,3,4,9,95302,80430,0,0,439
17,6,11,6,13,225258,225258,95,231949,474
16,4,12,3,5,26295,16000,177,9517,471
19,6,13,1,13,235842,6416,5,6416,528
19,8,11,0,15,130423,0,2,0,708
6,4,2,1,2,36153,1838,6,1838,462
21,5,16,2,12,19687,8416,12,6431,496
17,3,14,0,11,196,0,36,3439,505
7,4,3,1,14,605956,10032,13,10032,544
15,7,8,3,14,78022,7510,7,836,546
10,3,7,1,16,52934,11596,0,686,542
11,6,5,0,8,160079,0,0,0,666
17,9,8,4,13,376310,45208,126,25822,523
15,12,3,10,19,198445,160425,215,28728,426
27,4,23,3,18,22309,9134,62,10863,496
12,6,6,6,7,33289,39897,348,17633,435
28,5,23,2,13,12309,2060,42,0,545
13,6,7,1,6,33649,1164,0,0,491
8,6,2,0,5,60457,0,18,0,560
7,4,3,1,17,35847,2120,0,0,521
6,2,4,2,4,7275,7275,50,4725,567
11,7,4,8,7,399464,99400,99,18012,403
24,9,15,1,6,38842,3212,11,0,467
6,3,3,0,26,284226,0,0,0,519
6,4,2,1,9,35022,64,1,64,611
10,4,6,2,17,7157,6157,43,4961,655
9,5,4,0,6,18981,0,7,1076,660
42,24,18,11,24,529180,385132,33,18485,513
6,3,3,4,8,90896,116554,226,67499,497
11,7,4,5,5,16048,1456,124,750,548
15,10,5,12,8,148779,136581,0,0,548
12,3,9,1,6,27600,9079,10,9079,464
7,2,5,3,6,1803,4056,33,0,506
10,5,5,0,9,376055,0,28,0,450
18,13,5,12,10,455018,284351,164,4458,420
9,3,6,2,4,8549,1574,20,1033,551
23,4,19,6,13,39090,45214,81,9984,431
10,2,8,2,9,28919,8747,0,3072,511
52,25,27,8,14,629908,26673,31,9217,513
23,8,15,0,19,704614,0,16,13698,489
26,7,19,4,13,54847,30328,94,6774,528
45,9,36,1,7,219562,6675,0,0,622
26,8,18,2,15,164467,6732,62,0,543
36,9,27,8,8,43084,43040,380,15048,477
17,11,6,8,8,116277,94277,166,45324,470
10,8,2,6,10,20719,18931,43,4851,533
97,10,87,1,16,316894,111476,101,111476,455
21,11,10,0,19,416860,0,9,34778,660
12,5,7,0,5,303508,0,0,0,580
19,9,10,5,11,28796,24924,219,7232,449
10,4,6,1,11,670,38162,26,0,651
19,4,15,6,8,523599,169089,96,11900,456
9,7,2,0,4,142157,0,0,0,652
14,4,10,4,8,27980,17630,65,10820,431
111,5,106,2,10,91811,38424,127,4497,458
11,6,5,1,6,31294,958,17,958,482
3,1,2,1,3,21241,9020,13,1587,455
13,10,3,9,12,114512,117336,207,49371,434
5,2,3,2,16,44040,44040,29,26254,607
21,13,8,0,12,1356189,0,1,0,566
10,4,6,1,16,518738,18378,22,320,659
13,4,9,1,23,95552,47767,16,0,656
11,3,8,6,12,38978,44973,135,9985,496
12,5,7,2,11,105594,63998,0,0,547
15,9,6,4,13,239111,17084,74,6198,413
44,18,26,13,6,214366,92302,281,10145,416
5,3,2,1,7,3755,3755,12,3755,670
8,4,4,4,7,34723,19480,81,3251,438
10,7,3,2,14,146651,6476,5,0,640
17,4,13,6,14,127089,273391,110,7156,502
34,8,26,1,9,325815,425,40,10465,505
9,4,5,0,12,246411,0,1,1562,543
62,14,48,4,17,247426,23751,94,7457,479
29,12,17,2,18,100722,3283,49,10781,471
9,4,5,6,10,349498,484560,137,220861,481
25,6,19,2,8,38066,5195,77,3565,504
9,5,4,0,3,92620,0,16,301,470
16,5,11,4,6,137016,18854,83,61602,422
13,5,8,5,8,26248,21507,84,3621,494
35,1,34,1,12,11001,11001,22,11001,673
14,5,9,0,6,166955,0,0,0,578
24,6,18,5,8,16278,19676,116,6633,439
15,9,6,2,9,64579,7401,0,0,578
28,11,17,12,7,144574,156730,124,51332,451
57,10,47,2,15,69498,11092,130,9870,524
33,26,7,15,11,405355,105092,250,3241,486
29,5,24,1,8,300208,1250,18,5490,536
8,1,7,3,10,133740,133740,99,0,491
9,6,3,4,7,21773,28980,164,12764,526
19,13,6,3,19,5539074,335073,49,820,520
7,3,4,3,6,51571,51571,58,11578,427
18,4,14,3,11,8176,4841,293,3673,506
87,11,76,6,11,209527,30566,45,15549,408
21,6,15,2,16,235668,33023,35,30373,503
7,4,3,4,10,25894,25894,26,13775,433
7,4,3,2,18,15458,14485,115,12000,430
13,7,6,0,7,246070,0,20,450,648
3,1,2,1,11,2211,2211,18,2211,498
6,3,3,3,9,3749,10132,54,2065,622
8,3,5,5,4,16399,16399,50,0,453
4,1,3,1,7,6146,6146,25,0,525
12,4,8,4,7,131052,131052,90,9144,470
15,8,7,5,7,377476,16675,94,4520,394
13,9,4,5,17,243436,29649,169,5169,519
4,2,2,1,5,33788,7259,8,7259,541
8,4,4,1,9,58079,789,0,0,491
43,22,21,0,13,2691261,0,24,780,613
7,4,3,2,13,67302,42703,26,30869,481
18,6,12,4,13,45046,58190,55,24233,493
3,1,2,1,6,11388,11388,26,0,533
14,9,5,10,8,65796,59158,167,19804,450
14,6,8,0,12,22060,0,3,0,683
17,5,12,1,15,29915,940,27,7009,528
9,2,7,3,7,28916,23739,65,11437,641
23,7,16,0,7,1717080,0,2,499,639
4,2,2,2,9,26654,5903,51,0,443
23,6,17,0,16,1242904,0,43,3704,546
12,4,8,2,8,17727,17727,32,16173,557
6,1,5,3,8,1135,17740,283,16275,490
6,2,4,1,12,31858,4647,10,4647,668
12,3,9,2,10,101948,4223,29,270,578
7,5,2,2,8,405974,21461,24,18130,624
20,8,12,0,12,317956,0,8,44,644
76,13,63,6,8,54157,24314,115,16504,468
30,9,21,7,10,39940,24718,318,18084,515
16,10,6,2,11,89220,7063,23,0,545
7,2,5,3,7,14705,8423,51,7492,574
27,11,16,4,16,170745,20239,45,11191,424
14,7,7,3,13,83053,1394,1,196,531
26,2,24,0,7,6136,0,16,8469,649
10,4,6,4,13,96400,96400,83,60971,466
13,4,9,0,7,30478,0,72,366,654
11,8,3,1,9,244998,1350,8,0,560
13,8,5,0,11,681942,0,4,3835,625
17,7,10,9,17,560978,78595,1,21610,469
34,10,24,0,18,417638,0,31,2432,587
22,6,16,5,8,81838,76441,296,19124,491
3,1,2,1,9,753,9311,8,0,623
10,6,4,3,9,27900,16877,60,12917,469
9,5,4,0,7,21046,0,0,1,608
8,6,2,0,11,103392,0,2,0,677
41,24,17,0,10,1326559,0,20,0,551
15,8,7,0,8,496705,0,7,0,624
3,0,3,0,5,0,0,18,4343,479
18,6,12,3,11,49435,10360,65,2289,468
6,4,2,0,9,93272,0,0,0,546
9,4,5,2,8,12298,2440,26,3656,527
12,4,8,0,10,104451,0,0,2904,584
8,3,5,2,12,1058007,596169,49,119823,444
25,12,13,9,9,275682,191238,149,5095,460
3,1,2,2,4,481,46238,28,0,549
33,5,28,10,12,1378636,2863719,119,671184,368
9,2,7,1,14,34431,1442,10,3916,468
11,5,6,4,14,13651,12582,70,18996,433
12,10,2,10,5,48742,45643,180,3531,384
5,1,4,0,11,50020,0,19,18354,615
9,7,2,1,5,45632,660,3,660,603
19,11,8,0,12,1050223,0,0,0,565
26,2,24,1,9,7030,1844,29,299,534
11,9,2,2,8,43982,33138,56,0,520
9,6,3,2,8,96153,72918,22,0,604
8,4,4,2,14,32342,3968,21,32807,532
10,6,4,5,8,571229,571229,105,152923,469
21,11,10,5,13,48956,13158,26,5501,490
18,10,8,7,6,203229,29867,49,2221,418
8,6,2,4,5,336649,9384,61,0,453
20,9,11,9,13,184241,94091,275,15597,438
14,11,3,1,12,259065,1182,25,0,552
10,4,6,2,11,172554,122381,66,44741,517
8,6,2,1,13,124114,129,30,20027,556
12,10,2,3,9,6341,5148,49,1778,508
20,7,13,5,12,83320,30441,35,11985,489
42,8,34,6,13,32998,56778,181,10140,391
43,7,36,1,30,92928,976,242,7283,551
20,7,13,0,9,141604,0,0,0,591
8,3,5,2,3,6964,4803,9,3493,511
17,5,12,3,11,93896,110581,61,48711,597
58,19,39,1,21,587812,523,124,19320,571
10,6,4,1,3,114646,1496,17,1496,486
12,6,6,4,12,66615,18269,48,5244,457
11,5,6,1,9,226545,582,19,3592,659
10,4,6,2,7,23143,15635,30,12885,462
4,2,2,2,12,903261,88775,62,0,469
31,7,24,1,13,235713,4100,3,0,683
18,11,7,7,9,223766,54182,62,12680,410
25,7,18,2,8,52275,5854,43,0,501
10,6,4,6,10,75289,75289,225,8061,473
9,4,5,1,5,487,487,0,0,510
52,6,46,6,16,35489,33900,223,12482,433
11,8,3,9,16,46393,40802,32,10221,378
29,1,28,1,6,1628,1628,18,1628,550
37,19,18,21,13,2635870,3016608,256,496416,414
26,16,10,6,7,954982,380046,106,6627,442
13,1,12,2,7,19852,13872,39,0,515
44,17,27,9,8,505058,95737,118,16389,383
7,3,4,2,8,255177,9337,0,0,520
27,12,15,2,13,226461,8276,48,5516,442
49,10,39,5,10,28078,13327,95,8888,562
19,8,11,0,4,638013,0,2,0,631
21,5,16,4,12,88328,77740,87,9629,522
44,19,25,7,23,1564343,39658,186,66975,421
47,9,38,6,16,479079,234744,37,4987,421
9,2,7,1,5,478978,5293,65,979,565
26,15,11,0,28,1149010,0,20,0,688
39,16,23,0,10,1120215,0,8,616,614
11,6,5,2,9,318422,9620,4,0,504
33,9,24,0,17,853446,0,2,0,592
3,1,2,0,9,0,0,0,1238,644
28,11,17,0,8,505910,0,26,0,548
28,13,15,10,11,120107,69427,126,14755,443
16,5,11,2,8,132878,1052,290,6138,570
33,7,26,1,15,11774,2284,189,2794,423
7,2,5,2,12,49074,18169,8,0,438
7,5,2,1,4,3319,2841,22,348,527
26,3,23,5,11,11123,24597,301,9910,575
53,7,46,3,16,15060,14464,111,7842,500
6,4,2,4,18,28995,38846,61,0,539
37,15,22,9,15,427812,85754,159,19997,446
8,5,3,2,11,32421,32421,49,0,435
8,5,3,6,13,535724,22157,100,2209,546
24,14,10,1,30,892199,3130,27,0,475
32,6,26,3,21,169169,188930,0,0,595
12,7,5,5,8,337569,11258,0,0,451
13,4,9,4,9,14261,12055,50,5140,547
10,4,6,5,8,37525,33972,88,9161,455
11,5,6,0,4,36987,0,0,0,630
29,10,19,0,9,221451,0,2,0,703
14,6,8,4,12,80744,56776,33,453,443
33,9,24,0,13,973988,0,9,0,675
39,4,35,0,5,43449,0,0,0,651
50,21,29,2,12,360294,8357,13,7923,461
21,9,12,10,16,136536,142924,50,61460,459
32,19,13,0,10,318305,0,0,0,695
9,5,4,3,6,13177,6335,31,1513,496
17,6,11,6,15,12826,15632,80,4043,443
5,3,2,2,11,9852,9852,46,5128,507
5,1,4,1,7,26731,26731,25,26803,556
7,4,3,0,19,158374,0,1,0,557
11,6,5,0,11,483424,0,0,0,718
5,3,2,2,10,2966,1965,43,1163,557
21,10,11,7,35,407260,263959,147,2768,434
13,6,7,2,16,419139,8348,21,1895,494
28,10,18,0,22,898639,0,45,2200,606
12,2,10,0,4,2700,0,10,1403,542
5,2,3,1,21,1674,1674,0,0,616
3,1,2,0,7,1169,0,7,10710,548
5,2,3,1,17,11144,7163,7,7163,553
16,9,7,2,6,71712,804,18,1400,490
21,5,16,0,16,155457,0,135,1950,517
14,9,5,6,19,22386,30255,77,15237,386
7,2,5,1,9,0,42536,65,0,581
4,2,2,3,8,54386,97899,8,54386,536
19,7,12,2,32,520327,167808,78,155342,483
11,8,3,9,7,27548,30821,395,11858,462
6,4,2,1,13,10794,9667,18,32256,549
18,9,9,4,10,105113,10201,15,2172,504
25,9,16,3,14,335418,32362,0,0,519
15,9,6,7,15,50601,50600,88,8716,443
7,3,4,3,8,12476,12476,38,7236,543
18,5,13,4,5,63394,26374,123,10972,458
13,3,10,2,9,5998,16409,24,5998,501
23,9,14,0,14,801334,0,0,0,616
29,16,13,0,30,1333195,0,6,520,678
12,4,8,5,15,357536,20233,74,2475,492
10,6,4,7,10,37255,37255,141,7218,459
15,3,12,1,6,438,136566,66,3336,608
13,5,8,4,8,115285,80637,26,5912,364
11,2,9,0,7,568,0,0,0,610
14,5,9,4,14,17684,10193,40,4804,472
13,4,9,4,11,7501,7501,67,42943,467
16,8,8,10,10,1119227,913542,147,295232,423
83,34,49,23,25,1140448,346911,190,215052,507
18,7,11,4,10,22543,13770,104,4139,548
12,7,5,5,13,638993,73919,60,21429,447
17,8,9,5,14,724901,164830,101,7194,549
16,9,7,2,23,202996,73411,0,0,501
11,6,5,4,11,55006,40196,66,17592,433
7,4,3,3,14,61154,32464,0,12527,504
9,6,3,5,8,450545,18764,46,8080,396
8,5,3,2,15,78942,20356,9,13344,539
7,5,2,4,12,523346,27785,97,0,534
21,4,17,3,9,14136,14136,69,4271,515
47,18,29,11,10,531857,48586,54,11064,410
14,8,6,0,17,203320,0,6,1508,517
6,3,3,2,10,9585,30942,42,0,592
17,6,11,0,11,335358,0,4,1442,599
24,8,16,0,8,245548,0,12,0,592
14,4,10,2,11,55832,4654,25,4453,618
8,2,6,0,23,891,0,21,389298,580
37,12,25,10,69,173326,42257,397,11008,430
19,10,9,0,8,285902,0,0,0,676
43,13,30,11,7,124780,69758,196,14055,514
3,1,2,1,10,5130,5130,4,5130,673
8,6,2,7,9,23937,30181,338,11704,485
23,4,19,6,12,156326,131794,95,7998,538
12,8,4,2,10,81340,4187,19,3141,547
23,8,15,9,18,66982,51461,241,22100,425
13,10,3,2,5,147640,4045,11,0,463
13,7,6,11,6,356401,526035,233,0,479
6,0,6,2,8,0,7864,26,0,649
11,4,7,3,15,14123,33123,189,14123,425
6,2,4,1,7,7730,7730,0,0,584
22,7,15,7,11,379150,47265,263,5607,420
16,8,8,3,8,31308,12940,113,0,453
26,10,16,5,7,99952,19053,87,8956,495
2,0,2,1,6,5397,5397,16,0,564
23,16,7,1,20,1252749,2480,17,2480,472
10,7,3,0,5,75137,0,0,0,671
15,1,14,2,8,23426,27955,28,0,578
21,8,13,5,7,134588,10189,182,4636,434
28,4,24,4,9,42430,66159,99,5266,453
23,5,18,2,18,1043768,64857,32,64800,428
14,9,5,7,7,50118,42608,343,6330,413
36,4,32,6,18,42039,52372,80,8983,457
33,6,27,1,11,139915,13035,3,13750,626
8,2,6,2,8,13271,4991,32,24961,648
7,5,2,4,14,282168,33563,73,8675,467
53,17,36,8,15,357228,27141,62,5938,469
7,3,4,1,10,12745,396,15,0,508
7,4,3,0,7,22755,0,20,0,662
6,4,2,1,1,130973,9105,6,9105,489
12,2,10,2,5,7685,11640,18,0,494
16,11,5,9,16,487191,127688,136,64812,418
9,4,5,3,16,23629,31631,39,8639,621
21,4,17,0,8,569483,0,0,0,587
24,10,14,7,8,52123,40788,172,11818,456
13,7,6,6,8,37298,29035,153,6468,612
6,4,2,4,15,427161,57368,0,0,478
24,12,12,2,25,619757,546403,41,1598,549
5,3,2,1,3,12456,5479,19,5479,459
10,7,3,5,9,331279,14463,76,5712,460
12,4,8,3,26,12266,5600,405,4575,496
13,7,6,0,10,36304,0,12,343,559
3,1,2,1,2,2797,2797,20,0,530
5,3,2,2,5,38059,38059,0,0,460
11,8,3,3,11,92840,21630,16,19889,474
33,11,22,1,12,152424,10477,31,10477,551
15,5,10,3,14,67980,64380,46,26510,449
18,7,11,3,13,60846,45862,37,26293,558
6,3,3,0,16,7310,0,37,0,496
11,6,5,3,11,90602,13476,16,0,490
18,9,9,5,7,65674,1420,48,646,569
10,5,5,1,8,1095286,4475,0,232,552
18,6,12,2,15,28835,12857,41,39755,502
13,8,5,7,7,303597,37509,25,17826,453
10,3,7,3,9,9693,20076,56,2503,488
17,8,9,5,8,32504,22103,135,12726,427
7,1,6,1,6,0,90642,44,818,564
30,10,20,9,11,230376,45153,485,8603,414
15,3,12,1,11,3882,3824,0,1201,460
50,17,33,1,15,388781,26,48,601,569
2,0,2,1,5,0,9037,24,0,618
13,6,7,2,8,319071,70832,41,0,497
9,4,5,1,13,24999,4181,16,4181,629
34,8,26,4,10,261205,3351,359,1440,482
10,6,4,0,9,36017,0,3,2240,551
6,3,3,3,5,82125,82125,67,25371,476
34,11,23,2,4,325442,12434,33,12185,440
9,2,7,4,10,82449,75764,0,0,632
17,7,10,8,17,181739,216926,118,110668,468
13,9,4,4,7,88860,74549,88,1722,394
13,2,11,0,14,21171,0,0,3457,671
34,4,30,2,13,48094,19918,162,19678,536
13,7,6,0,13,100062,0,24,0,541
34,12,22,3,27,134248,98389,58,50943,538
135,28,107,11,14,6160919,131973,382,52785,426
15,12,3,12,6,50579,58165,181,12906,420
12,1,11,1,8,13184,13184,13,497,639
22,9,13,6,17,119247,30144,100,1653,488
18,5,13,3,9,44765,22197,215,5278,392
8,2,6,1,9,167659,11205,37,2499,614
7,5,2,5,9,29460,33144,96,0,478
10,7,3,0,8,139433,0,14,0,547
23,7,16,5,13,23444,33197,74,15572,579
15,12,3,11,15,321919,155816,111,6803,427
39,10,29,8,11,327797,32647,61,3837,352
7,2,5,2,3,28317,1570,18,13136,539
18,13,5,7,15,734839,322704,168,5508,495
41,17,24,14,32,403271,332385,331,140905,477
71,7,64,3,12,311823,63596,81,439,480
19,2,17,0,16,0,0,1,15007,674
29,20,9,5,7,1668772,21018,63,4513,505
84,23,61,1,16,1236318,2910,39,1380,553
15,8,7,1,16,980502,8461,31,0,448
3,1,2,1,13,5363,5363,17,5363,575
6,4,2,0,8,184093,0,0,0,666
10,7,3,0,5,94911,0,0,0,482
9,6,3,1,17,579003,6332,0,22835,503
5,1,4,1,16,594,594,23,1385,536
19,6,13,5,11,345646,64919,101,22808,464
6,3,3,1,14,5607,3990,26,3990,575
29,11,18,9,19,1778841,351993,14,13918,426
23,4,19,3,19,9078,20684,49,8865,549
9,7,2,4,13,206595,19125,49,9934,458
23,7,16,4,7,157921,26022,79,8533,467
5,3,2,1,16,287563,250451,44,16597,597
15,7,8,4,9,436018,15318,76,11594,411
12,2,10,2,9,14207,39268,50,0,529
26,13,13,2,22,388272,511946,8,1538,529
24,4,20,8,13,655382,75226,0,0,473
25,5,20,4,9,20054,15210,34,12828,443
4,2,2,1,7,980,980,7,2663,587
22,8,14,3,12,266247,244633,51,167497,450
26,14,12,0,11,1235418,0,3,0,645
13,4,9,0,2,112676,0,1,5259,577
13,8,5,10,8,159725,159725,119,34601,556
9,6,3,1,6,298310,10648,17,34,459
14,8,6,0,6,103144,0,3,186,570
33,12,21,5,8,45213,23786,235,3348,487
11,2,9,0,12,63058,0,3,0,641
45,6,39,3,13,194532,31956,0,0,460
59,7,52,5,13,72762,72455,0,0,449
9,4,5,2,18,439021,27790,51,344,465
12,1,11,2,11,121790,121790,50,3654,496
20,6,14,1,11,32468,14167,29,14167,471
26,11,15,0,9,284102,0,135,4880,589
34,8,26,9,9,335052,69828,317,31553,471
3,1,2,0,8,14847,0,0,3342,668
21,11,10,4,8,77825,835,72,593,567
80,6,74,6,13,517137,31267,113,4010,460
6,2,4,1,14,5583,390,0,0,542
29,9,20,10,14,361583,118709,219,24149,419
11,3,8,4,12,354641,80288,80,64293,489
6,3,3,2,15,597097,125099,0,0,523
13,9,4,7,4,306555,34539,63,12096,384
13,3,10,4,15,122700,135512,69,68199,436
15,10,5,0,15,485709,0,32,13353,504
18,3,15,3,9,14253,14253,146,8192,571
9,3,6,1,18,15203,2197,25,564,551
22,14,8,0,39,2773376,0,1,0,585
41,8,33,0,15,161116,0,8,1954,529
20,5,15,4,14,30832,22649,63,9596,531
28,5,23,2,9,31162,728,337,1582,490
22,7,15,1,15,84523,335243,28,4451,592
13,7,6,1,9,96581,6000,59,9500,477
7,3,4,0,22,69885,0,24,0,633
17,13,4,1,25,394002,3720,3,4882,613
19,9,10,2,14,1751519,14137,9,626,411
9,4,5,2,16,164280,55396,0,0,691
4,2,2,1,8,516279,273,17,1510,450
25,9,16,3,9,590314,24001,75,18677,522
7,3,4,0,2,34196,0,1,144,572
56,12,44,7,13,98895,30974,104,9520,486
21,4,17,3,10,41536,36251,171,22490,518
16,4,12,1,8,366205,7674,49,0,463
7,2,5,3,7,17159,24052,53,0,459
31,20,11,16,17,171972,74439,86,10882,383
10,6,4,4,8,95325,54475,55,32576,508
10,6,4,5,8,107284,85199,0,0,506
9,6,3,4,6,35773,32946,197,11245,464
7,4,3,2,8,259327,9484,43,9000,485
11,7,4,6,7,19612,33005,0,0,452
21,9,12,6,14,158022,35197,90,19220,486
19,6,13,2,6,52891,14383,35,10335,477
48,3,45,2,8,2479,2071,48,7713,509
30,10,20,6,17,165743,51544,30,24821,419
4,2,2,1,2,16985,1307,8,899,529
9,2,7,4,5,26600,27605,53,8756,456
21,6,15,3,11,26441,8490,52,27489,520
10,6,4,6,15,406351,82256,83,0,498
5,2,3,1,5,20004,1271,10,0,479
10,7,3,6,13,29538,29538,36,10731,417
10,6,4,0,4,38705,0,0,0,667
5,2,3,0,7,123792,0,0,0,618
21,8,13,5,18,960872,136924,358,93494,423
23,8,15,0,12,3400490,0,1,0,619
9,3,6,1,6,28954,5985,12,5985,498
11,4,7,9,14,207650,566231,185,172438,458
8,5,3,3,20,37868,36129,26,11997,530
5,3,2,2,4,20681,1708,0,0,492
27,3,24,1,15,16511,5000,72,16887,567
20,18,2,3,11,442549,6164,9,2947,468
22,5,17,9,10,24327,98443,157,7464,594
12,4,8,1,14,14064,2534,23,2371,408
24,19,5,9,11,523267,46083,148,15260,468
21,11,10,1,10,252666,423,41,1218,557
32,17,15,13,11,520070,76182,165,13714,426
6,3,3,0,3,10468,0,1,2674,588
21,8,13,8,14,110905,108113,87,46986,397
19,16,3,9,9,242989,47420,80,13932,434
7,5,2,4,13,1677616,828528,60,354209,455
6,3,3,4,14,27211,35868,24,12253,401
22,8,14,1,13,352623,15881,17,0,459
17,12,5,8,16,555579,51282,92,6915,390
55,17,38,9,7,208491,74155,135,19624,408
20,7,13,0,8,234295,0,3,502,631
36,6,30,2,10,641495,13234,18,9230,511
9,4,5,0,15,31624,0,3,1132,613
8,4,4,3,7,21112,21112,109,14222,527
44,18,26,1,20,371268,215,22,118,555
2,0,2,1,14,1435,1435,1,1435,563
21,6,15,5,20,725091,101531,0,0,465
77,12,65,1,21,460362,1750,98,3806,453
20,12,8,6,5,109681,37773,43,675,488
11,6,5,4,18,342204,91805,60,726,443
10,1,9,0,15,0,0,4,0,655
5,1,4,1,9,1133,1133,9,1133,605
26,13,13,7,13,409946,131759,175,1975,482
34,11,23,2,19,164833,10440,54,5617,465
8,6,2,3,11,151355,15292,21,3958,427
8,5,3,4,23,21223,24694,77,8478,438
13,8,5,7,6,24491,15470,115,4984,444
43,21,22,14,12,426923,61728,271,24038,350
48,10,38,4,13,634410,36999,44,7824,473
10,4,6,3,4,12478,12478,0,0,453
6,2,4,0,11,17334,0,4,5025,582
6,3,3,4,9,9652,12318,49,7065,525
45,4,41,0,21,65755,0,17,5293,597
20,10,10,2,7,231793,3500,37,8619,527
30,3,27,3,9,10259,3882,16,3381,474
39,9,30,4,18,139696,87191,246,10302,458
10,5,5,3,13,38097,29925,154,12641,505
9,5,4,4,10,18784,18784,237,9011,477
6,3,3,5,6,38271,36146,67,4836,519
3,1,2,0,3,1500,0,6,0,601
20,2,18,0,5,17015,0,0,0,612
5,3,2,1,2,9046,2832,12,2832,413
49,25,24,21,16,744560,406575,155,105915,429
62,18,44,17,15,1232449,1031112,288,460365,522
5,3,2,0,4,1711,0,0,0,703
20,2,18,2,11,15146,15146,62,9581,456
14,9,5,1,15,48280,549,5,0,660
3,1,2,0,8,0,0,4,0,706
12,7,5,5,8,43895,24008,82,17078,440
6,2,4,3,5,48099,82462,85,38695,553
25,15,10,4,15,153417,14398,172,6970,470
14,6,8,7,12,81861,123386,27,35460,423
8,3,5,1,5,2972,1796,6,2101,589
34,21,13,0,14,923456,0,9,255,661
12,9,3,5,18,181928,149674,53,124277,456
8,3,5,4,12,18762,18762,50,13600,505
8,5,3,3,12,35247,4830,28,3200,440
13,1,12,3,11,46896,31389,45,0,506
15,9,6,9,14,294910,66883,122,13654,435
19,8,11,2,17,1190449,21732,35,7112,526
23,15,8,6,12,1971720,73071,29,9128,405
7,3,4,4,12,78609,37667,55,18233,439
19,12,7,15,16,58052,89424,156,12126,428
8,3,5,5,8,223412,32626,107,6694,425
15,6,9,2,13,21884,9833,66,0,519
4,1,3,0,5,17572,0,8,101,653
6,3,3,0,8,23560,0,36,5798,532
27,10,17,7,8,98253,7209,407,2422,427
56,8,48,4,18,75737,9866,58,33185,489
12,9,3,1,7,68297,402,21,275,539
14,8,6,0,11,72263,0,0,260,636
11,7,4,4,13,85647,165529,64,1873,541
2,0,2,0,1,0,0,8,429,559
10,6,4,2,7,57976,36324,47,0,471
10,8,2,10,17,40673,40053,87,7966,481
9,5,4,3,4,31111,16602,39,1360,452
18,6,12,4,4,112030,15869,63,9289,443
7,4,3,6,6,572366,50361,82,7298,431
33,7,26,6,11,365420,70640,113,5573,453
33,2,31,1,11,46624,8726,0,0,548
80,3,77,3,8,8351,8351,41,5336,556
16,4,12,2,11,16193,14076,12,7785,472
36,5,31,4,19,18983,16249,146,17028,480
17,6,11,6,8,84954,26952,169,7649,451
31,8,23,7,12,152080,108130,122,22324,397
68,5,63,4,14,50198,8085,89,4668,416
3,1,2,0,9,0,0,0,0,711
9,3,6,1,9,18732,18237,98,18237,605
15,6,9,6,19,224564,98042,7,33022,457
11,7,4,2,8,37301,37301,11,5425,491
23,12,11,5,7,54611,4132,20,2564,508
11,2,9,0,7,3193,0,0,0,651
29,13,16,0,14,826513,0,0,0,533
29,13,16,1,8,389993,3146,23,3146,567
24,10,14,6,8,198796,32417,78,11400,480
19,8,11,9,17,1446680,1444504,182,267183,466
32,10,22,6,28,272284,198480,54,17254,489
11,2,9,4,17,62560,62560,47,10139,473
14,4,10,1,11,241908,20248,62,2353,480
12,2,10,0,2,19931,0,4,2046,598
13,8,5,2,17,86148,102090,21,0,517
18,6,12,3,19,368463,5409,39,3241,448
9,5,4,3,13,217065,31668,42,13516,549
46,11,35,3,11,84591,8000,65,2898,481
13,5,8,3,8,70187,26140,201,40394,570
11,5,6,5,7,75464,31981,341,15381,507
8,6,2,2,17,360888,10549,23,2895,411
23,9,14,1,9,106506,17401,15,227,598
5,3,2,2,10,29149,6009,49,747,520
8,2,6,1,25,4039,2327,57,3675,486
19,15,4,12,9,125849,97512,113,18274,404
23,8,15,0,12,340211,0,9,20973,565
4,2,2,2,6,10467,5552,14,4962,603
29,11,18,5,20,451003,18197,36,2253,461
14,3,11,2,16,35764,31268,32,26816,463
7,5,2,1,6,22060,8016,10,8016,671
25,10,15,1,27,68292,1658,30,1658,480
19,7,12,5,16,927793,201835,93,6051,408
9,6,3,1,11,13107,563,0,5016,572
31,5,26,5,11,102884,41926,125,12049,502
10,5,5,6,12,102993,85703,303,24281,480
9,5,4,5,7,29526,38519,74,17029,449
6,1,5,0,1,2296,0,1,2666,506
50,14,36,10,15,268566,79394,245,7981,439
8,6,2,1,12,79801,10287,15,0,514
19,4,15,1,9,30442,276,214,2539,512
57,12,45,5,8,279328,27297,185,8235,389
14,8,6,6,15,478730,61352,91,1595900,442
17,8,9,8,6,49278,73827,137,15233,447
31,7,24,1,13,270706,1635,58,1635,503
19,2,17,0,6,10140,0,0,0,644
27,11,16,2,13,38548,1558,33,7373,459
8,2,6,3,9,71361,94981,53,0,587
11,4,7,5,7,46224,75610,42,32542,519
6,3,3,2,6,36351,31272,42,0,493
13,6,7,0,11,505030,0,16,1151,446
38,6,32,0,10,104880,0,56,1251,679
8,4,4,5,10,23478,20679,95,6078,504
47,16,31,2,29,407189,234,85,839108,549
8,5,3,0,7,44847,0,0,0,717
7,3,4,2,8,11178,11178,42,7270,487
4,2,2,1,14,10024,6487,2,6798,531
5,2,3,3,17,2382,7919,55,6840,476
16,10,6,0,17,4372030,0,5,0,683
26,12,14,9,9,636912,319217,101,0,525
8,3,5,0,4,0,0,106,3998,553
17,6,11,8,13,44330,58773,100,22063,451
37,15,22,9,14,454438,126469,136,36926,426
14,11,3,6,11,107648,101837,29,28288,441
6,3,3,3,7,11212,5712,13,2606,451
96,18,78,9,16,1016708,62283,473,39825,460
11,5,6,0,8,301520,0,4,0,631
19,7,12,10,6,133561,122244,66,12440,405
9,3,6,2,12,21927,21927,161,14787,636
4,2,2,1,14,663146,8812,5,8812,508
15,2,13,2,4,6719,6719,0,0,484
9,6,3,4,16,19190,27139,41,13016,426
10,7,3,3,14,538528,25342,41,1021,443
30,9,21,3,9,434784,17144,328,8321,434
28,4,24,2,17,39409,15866,50,8121,510
46,8,38,7,12,52985,40452,139,3637,495
25,13,12,1,10,189964,674,13,335,585
12,6,6,0,16,237049,0,4,0,685
15,6,9,7,8,79678,81295,144,37259,419
14,9,5,2,20,246069,45822,64,655,518
29,8,21,5,9,82001,70374,83,12485,468
7,5,2,4,8,21871,21871,85,1210,466
8,4,4,3,14,107583,41886,37,12000,469
7,3,4,0,9,1223,0,0,0,637
4,1,3,0,5,1641,0,2,304,663
5,1,4,1,3,6954,13371,11,0,564
9,5,4,3,19,43307,17440,72,11401,497
16,7,9,1,13,399483,78853,63,78853,497
5,3,2,0,11,8768,0,0,0,609
4,2,2,1,12,8281,6961,26,0,539
13,5,8,8,13,36804,71358,152,11100,446
14,8,6,1,13,741983,985,0,0,545
23,7,16,6,9,254148,58871,47,22262,454
14,5,9,1,19,311336,99301,47,1479,457
11,5,6,3,8,30772,30553,43,13061,473
43,11,32,8,8,194487,36085,27,2829,392
49,18,31,8,12,295081,27006,84,1886,477
17,10,7,6,15,88039,69017,124,37614,431
10,5,5,5,7,396796,48917,27,0,511
16,5,11,1,19,47218,4644,12,5049,604
6,2,4,1,13,88909,5613,1,5613,688
6,4,2,2,69,23248,5880,50,1410,457
17,5,12,0,14,348012,0,3,0,582
13,11,2,9,6,383508,33084,230,7690,471
11,8,3,6,8,48769,63767,145,26455,578
13,9,4,1,7,283380,4071,64,0,562
6,1,5,0,8,191420,0,69,43412,509
7,5,2,2,13,120490,4890,1,1959,539
17,6,11,1,19,190070,4667,83,0,503
29,10,19,5,20,352214,41642,86,8926,452
17,12,5,12,9,62880,49333,116,18951,418
4,1,3,1,15,49404,49404,24,49404,583
9,5,4,2,9,116450,11851,5,2411,457
7,3,4,3,13,56188,22476,22,0,535
12,4,8,0,8,86599,0,19,0,669
15,9,6,11,17,84026,127699,179,86618,496
19,4,15,3,6,25328,8121,161,2552,505
7,3,4,2,14,27673,27673,121,8841,473
9,6,3,5,7,38187,38187,87,7298,470
6,1,5,2,20,2046,3461,18,2046,647
10,8,2,6,7,467896,99242,72,0,451
7,3,4,1,12,8161,1101,11,1101,614
16,7,9,8,8,64887,84605,133,3827,481
14,11,3,10,7,340749,113145,171,7955,444
30,11,19,7,11,63812,48770,164,36909,433
6,3,3,1,8,167653,7262,6,2903,492
12,10,2,2,17,633263,37243,25,3321,494
19,4,15,4,14,30734,30660,49,16841,490
9,4,5,3,13,64998,63154,75,0,523
19,10,9,3,5,66144,11144,16,9162,513
22,6,16,5,15,23748,23748,104,10992,472
54,10,44,2,17,317258,131593,56,417,498
6,3,3,4,5,71386,68172,135,13800,507
14,4,10,1,8,25728,1966,59,1966,563
28,11,17,6,12,58636,49208,68,19655,382
18,12,6,3,16,155641,37365,2,3450,531
24,13,11,8,8,358783,199408,71,15129,447
33,9,24,5,11,151855,74101,225,45583,489
12,9,3,0,17,240308,0,2,0,639
11,4,7,1,12,107973,1550,10,6749,490
54,4,50,8,7,75532,75532,142,20719,463
11,4,7,5,20,58787,201478,106,16058,532
10,3,7,0,2,95996,0,0,0,622
8,4,4,1,8,12532,12532,11,0,541
8,3,5,0,12,10728,0,0,0,601
8,2,6,1,6,16537,3953,32,3953,511
11,8,3,4,9,52502,14515,21,11297,524
12,9,3,0,5,100520,0,0,0,641
54,13,41,13,12,384563,69394,369,16694,398
12,5,7,3,12,273510,37986,79,0,637
23,15,8,0,9,388577,0,10,65,565
3,0,3,2,7,19586,32529,35,0,588
7,4,3,5,8,7234,7234,50,3714,585
14,9,5,1,6,326772,2989,25,2989,460
17,5,12,4,12,131033,130845,67,0,459
6,3,3,2,8,10175,10206,52,0,525
10,4,6,4,10,39809,32483,38,11802,441
19,8,11,2,11,137800,27000,62,19589,450
11,5,6,4,10,11785,28994,65,1395,462
12,5,7,0,12,69281,0,10,750,629
41,15,26,10,14,333764,85171,70,11995,447
18,7,11,5,7,49898,53744,227,18127,418
3,0,3,0,3,0,0,19,576,651
7,4,3,0,20,300381,0,11,0,659
11,3,8,1,8,33495,11860,19,0,544
11,6,5,7,7,27151,36122,378,11397,466
11,0,11,2,8,31756,10532,0,0,651
9,4,5,3,4,57188,12804,20,3709,464
8,4,4,2,11,483487,11906,13,6227,485
10,4,6,0,16,40534,0,0,1306,606
13,7,6,6,19,31914,44908,120,9425,447
7,3,4,1,24,80342,3407,23,4889,692
12,9,3,0,19,201833,0,23,1316,557
22,5,17,3,12,110455,7539,92,11104,486
13,4,9,0,10,599726,0,5,0,586
10,3,7,2,8,5281,5281,13,574,497
21,13,8,0,5,1667650,0,1,35,593
8,3,5,1,8,27097,12886,39,8285,628
28,8,20,8,8,274701,274701,188,18018,472
40,10,30,10,15,203087,207437,134,14402,434
4,2,2,2,4,4830,4830,27,4203,629
18,14,4,7,22,866933,264419,118,12854,453
5,3,2,2,13,67827,67827,50,92857,533
6,0,6,2,8,0,17733,49,0,561
10,4,6,1,20,25372,5535,24,5535,620
7,4,3,1,11,30947,9929,33,9929,653
6,4,2,3,5,156889,5551,3,0,557
35,12,23,0,16,213129,0,32,1423,459
25,12,13,8,17,96284,31659,86,722,453
11,4,7,4,11,383362,309803,43,0,455
170,29,141,12,10,171980,103174,234,13319,444
26,6,20,8,8,219289,250032,106,0,444
7,3,4,0,8,28982,0,10,611,589
5,1,4,2,7,3496,6881,61,1260,504
46,9,37,2,12,231464,622,98,5417,529
6,3,3,0,13,924939,0,5,3153,604
20,9,11,2,11,306551,847,10,0,506
8,1,7,1,10,7412,7412,23,7412,566
18,7,11,7,13,41877,43689,132,19657,454
14,7,7,0,20,365738,0,28,4499,405
46,17,29,5,5,135118,1871,28,2539,444
23,9,14,5,15,502750,27681,54,0,494
25,13,12,10,9,59217,51617,203,11076,434
3,1,2,1,8,5500,5500,97,5500,622
6,4,2,3,9,9874,9874,47,5924,545
20,4,16,6,12,14973,37828,84,1117,441
5,1,4,2,9,0,64875,10,0,644
20,5,15,1,16,67781,9689,26,892,446
15,4,11,2,7,3011,1642,16,928,569
24,8,16,8,8,29732,28952,159,6876,454
9,5,4,2,8,60699,53555,33,0,673
16,4,12,1,15,28786,28786,64,864,496
35,9,26,1,3,152396,6230,4,1244,441
10,2,8,1,11,5120,3490,22,246,540
11,9,2,4,41,20251,11075,81,5537,497
10,2,8,0,3,5131,0,0,0,617
13,4,9,3,9,474018,55946,24,1639,611
12,3,9,2,15,20414,68082,13,7393,555
9,6,3,5,21,29675,29675,69,8850,507
11,5,6,2,7,67948,40539,40,0,546
4,1,3,1,8,508,508,0,105,473
24,13,11,6,14,1143325,814964,40,0,446
7,4,3,0,7,18211,0,0,0,679
14,1,13,1,7,2610,2610,13,2610,626
16,11,5,1,7,104567,624,2,1234,583
6,3,3,4,11,39760,44240,3,6977,465
25,12,13,1,26,4775375,29116,35,750,482
20,8,12,10,9,177943,175304,311,11637,474
10,6,4,0,16,23664,0,103,2499,572
13,9,4,11,8,110910,128280,214,38085,437
4,1,3,1,9,0,2414,0,0,564
8,5,3,4,18,18017,5259,83,4795,449
20,7,13,2,12,63828,26731,32,4189,516
20,15,5,9,6,108716,51695,170,8312,505
7,4,3,4,5,10217,10217,84,3747,471
13,7,6,2,16,44589,171,2,5576,458
27,7,20,5,8,32084,33246,307,5645,462
24,10,14,1,14,112382,48390,31,48390,519
10,2,8,1,9,30361,2622,13,6491,608
7,3,4,2,12,13074,2519,5,0,562
11,8,3,3,8,516832,55009,43,0,544
10,8,2,6,14,444807,43666,116,35499,468
12,3,9,2,13,315070,12635,54,1176,514
8,6,2,0,9,60695,0,1,2500,539
8,6,2,3,11,289820,5011,19,3716,438
30,7,23,6,9,55843,35531,230,10152,442
2,0,2,2,2,0,15317,15,9228,450
21,11,10,6,13,43928,19683,41,5909,455
9,3,6,0,19,4134,0,0,0,691
26,8,18,5,18,173996,33257,271,9772,453
9,3,6,3,12,41952,41952,19,23716,464
9,6,3,8,7,48967,59221,77,11289,437
6,4,2,4,9,69965,66971,0,0,500
13,7,6,0,7,257280,0,5,0,473
19,7,12,5,34,607069,249737,107,6400,457
11,5,6,0,15,49321,0,3,2033,694
16,1,15,0,13,9351,0,0,0,569
21,5,16,7,8,77492,90786,87,38257,424
8,5,3,1,9,99158,2044,8,2044,519
3,1,2,2,8,218,9462,0,0,488
33,6,27,1,8,47285,14525,90,14525,631
13,5,8,2,12,18880,8027,0,0,501
14,10,4,0,7,451003,0,16,845,527
6,3,3,3,29,8884,8044,16,6310,497
18,9,9,2,28,96021,8477,24,6711,584
12,9,3,1,12,526329,28905,37,0,525
24,5,19,2,14,23150,8310,42,8237,492
28,10,18,8,11,86478,88557,331,33623,425
18,6,12,2,16,105797,21053,27,252,492
18,15,3,2,3,340829,194,12,297,499
15,12,3,12,7,71222,91925,215,26494,440
37,2,35,2,13,9590,2389,24,2109,471
20,7,13,0,13,980562,0,19,6115,658
23,7,16,6,7,55464,54064,84,34601,445
12,5,7,5,15,444944,29346,10,3393,443
4,2,2,1,13,32589,14009,30,58,554
23,9,14,4,16,571711,20038,75,7508,529
6,1,5,1,7,2193,1674,7,1674,534
24,16,8,9,9,1295074,64015,40,7937,464
9,5,4,5,9,39860,24330,77,9245,415
6,1,5,1,4,3923,3922,23,3922,595
7,5,2,2,16,508692,77003,42,0,476
14,9,5,5,15,133813,98527,86,0,482
29,14,15,24,5,1534703,3234455,267,495195,449
16,7,9,1,8,123943,289,31,7510,547
4,2,2,3,8,5275,5275,50,2762,578
5,3,2,3,8,14484,12315,20,9383,486
18,7,11,0,13,40622,0,0,1133,543
11,3,8,3,18,647,7292,64,1751,635
10,5,5,4,24,284472,200265,38,0,612
31,7,24,6,17,207755,67442,43,36111,492
21,9,12,9,12,154639,94388,237,21319,484
29,6,23,7,9,385720,48622,63,1610,420
17,8,9,9,15,20144,39319,107,10799,417
6,3,3,1,5,10744,10744,26,10744,575
13,4,9,4,13,228412,26408,19,2503,490
19,2,17,0,7,17342,0,25,10600,611
13,5,8,1,16,568186,46515,49,6110,585
10,5,5,2,6,267787,10600,26,0,514
12,7,5,8,13,41245,46547,105,12286,478
12,4,8,1,9,211189,3560,20,3560,534
12,10,2,5,10,257204,1672,37,12359,502
19,9,10,3,69,29134,24949,32,2361,577
5,3,2,0,5,92938,0,0,0,499
34,9,25,7,19,709188,35540,371,11616,386
12,9,3,7,13,402168,168939,99,41455,346
17,5,12,0,18,1002796,0,7,0,632
7,4,3,2,14,82780,13584,78,2845,555
8,4,4,1,9,185228,1206,9,1759,469
15,8,7,3,6,188487,22405,40,760,456
9,5,4,3,3,17050,581,61,2231,540
7,3,4,4,9,26972,30466,168,12307,470
15,12,3,6,6,418845,79586,58,1172,551
17,7,10,3,12,483481,21626,110,35793,526
14,8,6,9,14,48142,77811,264,7923,509
15,6,9,0,10,93534,0,11,0,672
14,7,7,4,5,29342,24460,86,5045,452
10,5,5,3,4,25427,23913,14,937,364
28,8,20,10,9,58692,81213,453,15731,425
17,13,4,12,13,515909,254378,40,204643,437
40,16,24,2,11,3461798,236013,35,1514,567
7,3,4,1,24,74683,3359,23,4889,592
8,6,2,0,12,630132,0,7,0,397
27,3,24,3,7,32833,32833,61,23775,500
18,6,12,2,10,83687,14540,18,2503,489
69,6,63,3,14,38465,8152,20,10841,427
14,10,4,4,14,413957,1440,7,499,513
20,18,2,11,11,1143778,130347,108,6970,391
9,3,6,0,7,286239,0,9,0,609
12,4,8,0,13,10953,0,48,0,556
28,13,15,4,20,1813761,535114,104,84539,524
13,6,7,4,16,56467,56467,69,3875,467
21,8,13,5,8,173712,40785,50,5133,446
13,10,3,1,18,612658,1712,9,1757,509
14,6,8,3,8,404467,30585,49,24391,405
7,4,3,4,5,11305,9216,41,2941,381
34,10,24,1,10,323460,255,15,165,560
7,3,4,4,8,52962,72727,8,22775,539
13,11,2,12,8,52920,69514,179,9895,437
9,4,5,0,14,194871,0,5,0,535
3,1,2,1,7,0,4864,49,0,596
24,3,21,2,10,3639,8282,34,5874,634
22,7,15,2,19,568155,17584,64,13243,391
20,6,14,5,15,18972,6960,83,1841,457
71,20,51,10,28,426487,125012,411,24897,430
12,9,3,8,13,341303,129797,85,15531,430
29,8,21,0,16,119061,0,23,631,578
15,8,7,1,12,230336,46273,15,0,560
14,6,8,5,17,544876,488450,128,0,457
11,8,3,8,6,43584,72404,141,9444,494
23,20,3,1,8,3295897,7048,3,0,617
27,15,12,8,25,226489,25462,164,15078,444
22,7,15,4,17,59184,80163,103,15618,438
43,9,34,3,8,88170,17951,66,6077,465
12,5,7,2,9,42051,37776,37,0,518
46,21,25,10,35,656135,637615,48,532483,417
7,5,2,3,13,31916,6795,24,876,552
18,6,12,6,14,185044,117976,111,7040,525
8,2,6,2,13,4574,10049,46,5221,512
16,7,9,3,9,120951,83564,48,1294,488
5,3,2,1,7,8363,3846,19,3846,618
8,5,3,3,6,18356,17218,112,7801,477
7,3,4,3,8,23358,10143,134,6952,579
14,3,11,2,9,41974,13080,142,7534,480
9,3,6,3,11,6580,6580,6,3012,460
5,1,4,0,4,5339,0,5,596,642
14,7,7,6,10,25435,15439,66,3489,446
50,11,39,7,19,794188,290579,139,3948,579
39,9,30,4,17,407423,48421,41,37987,465
6,2,4,1,13,325464,4681,0,0,568
14,9,5,7,3,82879,45310,277,28428,433
29,9,20,12,12,155950,207925,241,34881,424
27,9,18,1,9,56543,1407,48,3858,436
8,1,7,1,13,15916,15916,95,15916,694
7,5,2,5,7,263450,257626,6,2184,488
9,5,4,5,2,78828,3323,16,751,568
5,3,2,5,7,23141,40700,98,0,539
11,5,6,4,14,21588,24166,66,6962,451
18,8,10,6,14,299323,10935,106,4449,400
26,3,23,1,11,33636,457,48,2134,583
23,4,19,1,12,36998,9181,34,9181,489
38,6,32,5,11,24214,21676,170,7554,427
11,4,7,5,7,25672,28110,60,10432,493
8,3,5,0,19,0,0,1,66792,662
5,3,2,2,10,2046,2046,18,1501,616
8,3,5,0,13,119727,0,0,0,664
7,3,4,3,8,24133,24133,290,13774,485
9,7,2,2,9,345143,20465,42,1500,493
15,7,8,1,8,299435,3070,21,3070,616
6,1,5,3,9,7747,22783,34,7747,530
6,2,4,1,13,429,291,6,5051,572
47,11,36,9,10,302690,4051,82,1944,540
10,5,5,5,6,42257,39398,96,14558,489
18,3,15,4,17,45486,33838,67,19898,485
11,4,7,6,8,77087,124298,140,39506,486
33,12,21,11,10,498129,176529,0,0,493
24,12,12,6,39,363885,42661,287,13847,437
7,3,4,0,3,15888,0,4,0,595
4,2,2,1,16,348222,7543,0,0,477
7,4,3,1,10,13471,448,0,0,488
21,7,14,1,19,91149,46,13,3500,654
26,9,17,1,19,150487,4950,55,5009,590
17,5,12,0,18,256535,0,42,3584,683
7,1,6,1,6,1643,1320,0,0,513
55,12,43,9,11,73356,60057,295,18001,484
5,3,2,1,6,94990,8476,3,0,468
7,4,3,2,9,4104,1139,142,2835,499
13,6,7,0,8,133506,0,14,0,571
14,5,9,0,20,1622050,0,1,0,679
10,1,9,2,10,58435,58435,19,6420,580
11,7,4,4,13,194986,105887,27,43772,496
43,10,33,3,18,56098,12741,63,18746,428
14,3,11,2,6,31239,10167,52,5955,545
123,4,119,4,13,55439,55439,62,12064,398
21,12,9,2,20,816351,61835,17,45797,463
18,2,16,3,8,21896,25137,35,10769,415
3,1,2,3,2,4892,10471,17,0,561
16,11,5,9,7,29246,22352,88,12230,496
10,5,5,1,17,459255,211,3,3325,443
4,2,2,1,7,12688,6388,56,0,567
23,14,9,0,11,373939,0,5,1200,531
2,0,2,0,5,0,0,0,743,677
13,8,5,7,10,56988,36848,97,17111,519
8,6,2,2,6,70769,10732,0,0,508
7,2,5,2,6,17360,17360,17,16600,592
13,9,4,0,7,180646,0,12,0,600
6,4,2,1,4,319636,4768,16,4768,489
8,6,2,5,9,567668,98639,77,43750,466
3,1,2,2,13,16075,16075,0,0,525
16,8,8,2,14,504905,20823,49,636,472
6,3,3,0,9,8062,0,0,0,677
17,8,9,7,13,1043907,201480,0,0,535
9,4,5,2,14,57592,54528,3,10,490
87,11,76,7,18,423167,20188,120,5302,423
14,9,5,5,13,78964,36000,168,16203,489
21,15,6,3,9,881752,34527,53,16832,427
52,14,38,16,7,498731,632483,209,87704,487
19,8,11,7,13,248248,113405,8,3327,495
7,5,2,4,7,17268,11575,20,6280,509
11,5,6,1,15,32880,1351,5,1351,632
21,5,16,4,13,66109,49778,53,1304,450
15,3,12,2,18,157788,155792,65,154909,491
20,9,11,13,9,236140,305198,478,45147,439
14,8,6,1,10,347437,2999,0,0,559
13,11,2,4,12,226361,17402,51,1010,443
34,10,24,4,9,25556,19393,100,1472,510
26,5,21,1,14,19044,5310,132,3792,471
12,8,4,7,7,34764,32675,347,11754,460
22,7,15,0,19,200668,0,4,4950,575
25,5,20,7,9,195547,260041,105,71016,431
41,14,27,15,11,1801003,879751,0,0,484
11,6,5,4,5,29118,14963,82,10025,440
6,4,2,1,3,79067,844,1,0,675
35,16,19,6,13,570797,49824,59,3788,454
17,9,8,0,16,525150,0,0,0,685
10,7,3,0,9,44170,0,0,0,637
12,1,11,1,12,3527,3527,178,10373,531
19,8,11,10,26,27980,29531,188,9752,460
42,4,38,2,16,17091,7695,108,6562,494
37,13,24,4,9,341995,50844,125,13374,412
32,10,22,6,13,46051,35005,221,13722,455
49,13,36,6,15,611031,65431,246,4676,577
64,4,60,3,10,24927,25310,251,18154,550
13,5,8,5,13,247222,37238,20,15979,397
15,6,9,0,8,95055,0,9,313,691
7,5,2,2,5,19957,4500,21,3554,477
12,3,9,3,11,12743,10540,23,3453,460
16,9,7,4,13,190926,101659,86,24511,464
10,2,8,1,13,12130,3346,4,0,542
14,10,4,0,6,1480471,0,0,0,675
50,6,44,6,8,26682,18702,285,9183,407
36,5,31,4,14,85135,69325,39,1735,475
8,1,7,2,19,1635,15257,36,1635,473
15,6,9,5,13,9297,6702,36,2304,490
17,9,8,1,5,172218,101,12,101,520
11,5,6,2,5,25512,17677,25,13841,427
13,8,5,0,11,0,0,20,10367,646
4,2,2,1,3,10604,40,1,40,502
6,4,2,3,6,13913,12703,36,6195,479
13,5,8,0,7,862308,0,11,5891,537
31,12,19,10,11,55542,33729,357,7580,377
18,4,14,2,15,350120,4234,47,3261,433
13,10,3,1,5,346442,1238,0,0,638
5,3,2,1,8,452686,4883,45,4883,501
8,6,2,4,13,16964,11407,9,3115,443
6,3,3,0,6,17671,0,1,1548,583
18,11,7,10,15,519363,518575,184,269557,450
9,7,2,2,13,206181,23031,46,10792,605
80,7,73,5,9,59507,40990,335,15624,470
11,4,7,3,16,30864,29829,34,6983,428
21,9,12,6,15,93486,31364,89,5851,457
18,4,14,2,12,61496,25791,54,9278,459
38,9,29,7,8,217855,186870,178,76842,452
12,1,11,2,10,97386,31091,83,731,471
12,4,8,0,9,239845,0,26,4000,464
4,2,2,1,12,51725,20680,0,0,543
6,1,5,1,7,6945,6945,17,6945,466
17,11,6,8,13,42370,54813,122,11927,459
8,4,4,2,9,57917,64392,37,0,514
23,4,19,1,13,62817,6974,166,8359,516
80,14,66,9,17,36970,54602,151,10854,448
3,1,2,2,7,6367,9500,0,0,480
15,4,11,3,18,26027,15244,82,7389,543
43,20,23,2,13,562662,7641,64,879,502
58,11,47,7,13,86613,85259,143,22498,523
19,10,9,7,8,50210,25968,52,14826,429
9,2,7,4,5,26293,26089,58,14512,509
3,1,2,0,6,25641,0,2,0,681
14,10,4,0,6,256984,0,0,0,525
18,4,14,0,10,47189,0,19,744,613
17,7,10,0,3,38285,0,2,0,518
22,2,20,1,10,792,605,8,2926,486
10,5,5,1,7,533781,5149,285,11275,624
9,6,3,0,3,101918,0,0,0,617
20,6,14,4,15,513017,101307,103,3710,498
42,20,22,9,15,408418,82961,112,10488,474
9,7,2,0,8,436506,0,14,9335,589
10,3,7,1,3,17172,7187,5,7187,503
6,0,6,0,2,0,0,0,0,590
11,9,2,7,15,162081,59132,124,10043,490
27,10,17,8,19,464452,33258,0,0,493
8,5,3,5,12,102028,114706,97,1000,448
43,10,33,5,9,33033,30929,27,9992,414
3,1,2,0,11,0,0,8,134301,531
6,3,3,2,7,10767,10767,45,7223,564
43,9,34,9,9,72616,70219,340,26203,441
11,7,4,0,8,149948,0,2,120,675
27,7,20,0,13,249900,0,0,0,632
18,5,13,6,13,131963,122131,94,1860,475
53,9,44,2,16,493122,15625,8,15256,503
4,2,2,2,13,15260,15260,11,13869,547
10,8,2,2,9,197644,17515,9,0,475
4,1,3,1,7,0,120781,25,0,503
18,0,18,2,11,0,15927,47,2186,499
8,4,4,0,7,36012,0,27,606,567
6,4,2,0,14,915370,0,0,0,688
7,2,5,4,5,5992,10126,52,2680,509
15,8,7,1,12,215954,72,0,0,605
8,5,3,5,6,5463,5267,83,2570,406
8,3,5,1,11,35629,796,22,169372,476
8,5,3,2,16,231745,19499,33,7959,450
23,10,13,2,12,418445,931,0,0,660
37,14,23,9,13,76208,74515,175,38096,445
6,2,4,2,7,27419,27419,20,26305,494
10,4,6,1,7,21260,9111,26,9111,460
14,11,3,9,5,311372,51932,74,604,450
12,9,3,3,14,239029,35953,85,34480,446
20,12,8,1,10,1394007,11596,2,0,635
11,5,6,6,15,26001,38457,96,8621,423
14,4,10,3,6,20853,15282,37,2485,507
13,6,7,4,17,58341,57671,51,3198,404
37,13,24,0,8,170228,0,53,23,505
9,4,5,3,21,916380,468935,61,1059,621
9,7,2,6,14,24921,29327,38,9950,411
45,1,44,1,14,54644,54644,215,9092,658
7,2,5,1,2,22471,444,7,14649,537
17,13,4,12,13,515909,254378,40,204643,425
7,3,4,3,5,7500,11399,2,1531,451
9,7,2,0,2,77834,0,0,0,641
6,2,4,3,9,8023,9821,59,0,486
19,8,11,0,11,920586,0,38,0,577
22,8,14,8,11,495613,124032,158,9985,500
36,17,19,2,17,292041,43282,0,2016,481
5,3,2,3,6,65547,64948,57,12320,523
6,4,2,2,10,32474,3346,12,0,464
10,4,6,2,19,321952,10764,46,904,535
25,7,18,0,8,406695,0,45,3331,599
10,6,4,5,12,87881,51306,83,30353,488
13,9,4,5,13,12124,14655,122,1545,509
39,10,29,6,14,57029,37169,158,17475,461
6,4,2,4,4,331150,25321,34,12105,464
5,1,4,1,14,444029,33396,8,33396,509
6,4,2,3,4,6545,14768,52,480,580
33,6,27,4,11,184055,70077,39,14578,525
12,5,7,3,13,5067,5067,34,4100,436
12,7,5,3,13,572964,147124,62,26723,478
11,6,5,6,7,50439,37056,85,14764,406
48,6,42,2,32,662059,16231,4,7579,595
15,3,12,4,8,17694,17694,65,6607,433
16,11,5,1,13,339536,5381,0,0,460
10,5,5,2,10,75109,11259,31,792,551
4,1,3,0,7,27809,0,24,1715,571
23,15,8,1,22,895562,6960,32,0,475
14,8,6,2,13,537724,43085,0,0,474
8,6,2,4,10,7745,4518,53,4543,394
20,13,7,0,26,629631,0,4,4,524
12,4,8,3,9,274384,21938,73,5793,494
63,7,56,7,9,17946,17384,85,5194,481
9,4,5,4,7,21972,21972,230,7677,501
10,5,5,0,15,59275,0,30,0,617
28,13,15,0,12,1032089,0,1,3605,538
29,5,24,5,12,179542,100357,86,3758,584
28,3,25,5,5,9907,9907,235,7437,539
13,6,7,7,8,544268,290235,113,7249,475
54,14,40,6,10,552644,65729,114,17068,495
47,5,42,3,16,70857,49058,212,50532,518
60,8,52,3,11,54042,24291,125,4384,497
9,4,5,1,21,229398,6118,0,191,538
24,8,16,0,11,263163,0,25,1110,569
26,9,17,0,8,128947,0,7,1613,572
13,4,9,0,22,383190,0,8,0,604
10,4,6,3,13,85989,85989,62,27548,626
11,7,4,6,9,66802,61120,70,0,534
12,5,7,3,11,67786,37436,58,10912,603
13,4,9,5,8,46131,57679,158,30587,474
4,1,3,1,7,21628,21628,114,21628,619
77,15,62,4,14,226489,6479,98,12651,483
7,0,7,1,8,0,20913,25,87,605
10,3,7,0,6,44855,0,0,0,611
11,5,6,1,13,259022,25109,0,0,434
17,9,8,11,8,74165,104919,325,18369,425
36,11,25,6,8,336693,73333,136,16079,424
18,10,8,3,13,497983,11331,58,6400,479
59,16,43,4,11,207313,795,69,7099,528
15,3,12,2,14,370852,6666,25,5636,472
3,0,3,0,7,0,0,0,0,603
15,3,12,6,20,132807,169550,86,2300,560
10,8,2,1,9,326708,739,51,3680,589
22,9,13,5,16,136795,62405,103,6299,460
15,8,7,7,7,395977,439793,132,139547,411
8,2,6,2,15,245455,7312,27,4116,514
8,4,4,1,4,19401,1705,10,783,476
25,16,9,1,20,3722804,1057,21,1057,529
19,13,6,0,7,1142267,0,0,0,642
18,3,15,0,9,134473,0,49,1366,491
11,9,2,2,9,82641,383,4,353,620
20,4,16,3,9,41457,28780,52,8062,547
22,9,13,6,12,152514,150455,96,19323,455
17,6,11,7,15,10656,13524,78,4736,426
37,18,19,17,19,554783,291305,42,3360,453
11,2,9,1,9,139,139,160,3268,583
6,4,2,0,9,12198,0,0,2988,567
9,2,7,2,8,6926,6926,48,1351,502
16,7,9,4,8,222293,42813,281,11201,524
12,8,4,2,9,227636,6342,42,3237,650
16,11,5,8,10,380374,116368,12,1467,442
19,8,11,1,5,305092,389,8,0,542
18,10,8,7,37,91408,85810,186,53702,450
15,5,10,5,12,21576,38713,93,19672,457
8,2,6,0,14,14881,0,42,787,647
11,6,5,2,10,339000,1577,40,6410,502
12,6,6,3,20,639167,451455,39,4382,437
7,4,3,2,10,102432,102432,34,61678,526
7,5,2,0,21,403899,0,11,0,549
42,4,38,0,11,38387,0,11,1750,664
9,4,5,3,12,22593,22593,0,0,510
10,6,4,5,9,46028,33637,112,18385,435
11,0,11,1,3,0,12007,8,2753,599
4,1,3,0,9,0,0,0,900,632
13,4,9,0,17,44112,0,0,1469,568
11,4,7,2,9,103595,54758,37,0,487
73,7,66,4,8,87885,81885,192,15747,453
20,8,12,8,13,210954,202486,174,26919,440
17,5,12,2,13,45418,9725,37,0,497
8,4,4,2,13,49338,49338,27,24007,492
24,9,15,3,13,768621,30063,5,27136,701
11,5,6,2,12,103246,55662,29,353,556
3,0,3,2,7,0,11540,19,0,537
17,10,7,4,14,828875,246046,68,196137,430
7,5,2,4,9,53045,33204,37,1350,480
46,9,37,3,25,58557,2881,0,0,543
29,15,14,7,18,404759,18516,18,22326,461
16,8,8,5,14,48755,31494,192,11649,402
27,3,24,1,11,308799,4578,0,0,615
31,11,20,0,9,144593,0,0,0,647
4,1,3,0,8,1719,0,6,0,594
23,4,19,2,13,550623,7178,25,1962,687
32,3,29,2,11,98974,44974,17,3042,529
17,11,6,0,9,42285,0,0,0,662
13,7,6,6,13,529610,98944,76,4983,461
19,15,4,3,17,378671,64400,16,0,542
9,7,2,4,8,104384,103956,109,578,434
4,2,2,0,3,27434,0,0,0,639
21,4,17,8,8,299786,341691,153,0,446
8,4,4,3,9,298933,2578,106,1165,453
19,12,7,3,23,1959210,93073,49,2175,476
22,6,16,1,12,739462,3792,5,2097,625
8,4,4,3,9,77836,42121,1,722,451
16,7,9,6,6,66570,48312,394,17743,504
41,15,26,1,12,210327,2880,47,2880,583
11,4,7,3,18,35074,15610,79,333,647
18,8,10,8,7,43081,56920,144,17899,469
18,15,3,15,10,192302,235732,212,104917,397
3,1,2,0,12,0,0,0,0,508
19,12,7,12,9,388206,65886,131,11334,384
16,9,7,3,19,71102,5090,16,572,519
9,3,6,4,12,95639,139892,99,88507,487
12,9,3,5,6,46825,23658,43,1621,466
16,7,9,6,2,37582,9356,57,4860,411
21,7,14,0,15,886035,0,47,12752,581
15,7,8,4,10,48268,37227,89,941,399
12,7,5,3,7,23811,39903,0,0,561
20,7,13,4,36,792027,16713,44,1913,468
5,3,2,1,8,18212,2106,25,0,548
10,4,6,0,7,59912,0,0,0,572
4,0,4,1,8,36879,36879,25,1545,546
11,3,8,2,5,21404,9739,7,398,476
3,1,2,0,4,0,0,4,0,661
15,7,8,6,26,302677,261148,70,2905,526
6,0,6,0,16,0,0,23,88486,515
4,2,2,2,8,25057,25057,3,148,525
20,8,12,3,12,82246,40121,123,36265,481
21,18,3,0,8,1758989,0,18,0,494
55,15,40,10,13,445826,93657,151,11510,423
12,1,11,1,6,19902,19902,24,0,630
13,6,7,1,14,47879,2679,25,35401,648
17,6,11,2,15,657224,158888,22,0,526
29,13,16,0,8,256572,0,5,2006,650
10,8,2,10,4,95575,116925,167,50835,461
20,2,18,0,5,28282,0,1,0,578
30,12,18,11,13,306457,65304,213,12125,416
145,18,127,3,11,166057,105967,53,3004,474
8,5,3,1,18,12450,710,5,496,544
10,5,5,4,11,565818,40834,28,9144,457
26,1,25,0,7,15275,0,6,2107,641
64,14,50,8,8,189323,89542,302,33423,406
38,10,28,4,15,658532,58115,49,45503,589
13,6,7,7,8,169343,146994,91,4713,450
13,6,7,0,19,36586,0,2,0,707
9,6,3,1,12,11317,1100,3,0,649
49,16,33,16,8,107260,85664,366,12391,416
18,11,7,10,7,71584,78373,210,14441,442
11,5,6,7,9,58891,177858,112,13022,526
12,9,3,7,11,25558,25309,102,9990,513
7,3,4,6,6,325005,529390,54,167497,494
51,12,39,0,13,1655189,0,38,3710,654
6,3,3,1,14,338107,1,4,728,537
7,4,3,3,9,12530,12148,0,0,578
8,3,5,4,9,114754,140962,97,79330,482
10,5,5,2,7,163551,23656,9,7163,418
14,5,9,4,9,30614,29048,43,6977,453
31,7,24,7,17,38669,39854,439,9975,452
7,3,4,5,7,378096,45821,67,6055,443
24,5,19,3,16,7149,6144,19,5113,488
10,5,5,0,9,605,0,0,0,711
10,5,5,5,4,20641,7456,28,5057,463
24,5,19,0,13,50468,0,7,1471,538
19,6,13,6,7,19454,19454,117,8300,425
29,7,22,1,8,13557,1047,28,2698,434
13,6,7,6,8,658881,86394,67,11205,452
37,11,26,5,14,78395,56701,284,38836,427
19,8,11,0,21,355112,0,8,946,561
13,7,6,4,9,39669,34496,133,23014,479
7,4,3,1,11,7827,1409,16,3798,637
15,9,6,10,17,196193,31903,161,1468,447
13,5,8,0,4,11292,0,0,1751,554
3,1,2,1,6,1598,1598,18,1598,569
8,6,2,1,12,40443,350,1,4112,628
5,3,2,2,8,7823,1245,62,732,464
35,10,25,6,8,118349,14930,71,815,444
9,5,4,2,38,72912,72508,70,8741,523
20,11,9,0,12,922445,0,22,0,578
7,4,3,3,8,16772,16772,241,13659,476
11,5,6,0,10,54219,0,7,305,603
7,5,2,4,14,58207,50005,35,4308,425
8,5,3,0,8,37210,0,9,5227,457
16,9,7,6,3,42910,13984,9,2662,494
20,13,7,12,10,358102,70271,27,6005,396
9,6,3,4,14,498921,43198,67,14707,450
10,8,2,4,7,90720,51195,56,26582,509
4,1,3,1,12,9355,9355,13,0,489
10,5,5,0,10,838,0,32,1010,515
4,2,2,0,6,19985,0,0,0,465
8,4,4,1,27,185745,5758,11,5758,570
23,12,11,0,13,533404,0,44,1092,470
18,5,13,6,5,17590,17590,139,11193,420
12,7,5,7,5,46780,39483,75,647,437
18,3,15,1,9,8987,17176,31,5874,538
24,9,15,6,10,71914,42766,190,25697,458
47,6,41,2,14,24823,6503,25,6114,486
22,12,10,9,7,102160,81805,87,22017,388
17,9,8,0,12,418268,0,6,6336,523
9,1,8,1,7,2674,2674,24,2674,530
4,2,2,0,8,24952,0,7,1010,543
4,2,2,3,8,520,11875,56,269,572
49,11,38,3,17,24553,34867,78,16621,542
26,2,24,0,21,0,0,317,13862,587
17,11,6,10,15,723119,388918,201,80069,360
26,10,16,6,14,797676,118219,2,34308,420
15,12,3,2,14,293143,16961,14,0,410
10,2,8,1,7,512,512,20,0,556
24,7,17,5,9,482961,32597,61,28526,527
11,2,9,1,9,7520,1183,16,1183,513
11,7,4,5,11,445592,26227,4,562,457
10,3,7,3,9,23084,8320,85,8270,481
8,4,4,3,21,220863,12309,48,9629,521
29,2,27,1,7,51733,4398,0,0,638
30,4,26,3,10,36732,13411,309,11278,481
14,4,10,0,13,199651,0,62,0,552
11,7,4,1,11,45506,23814,33,1986,501
19,10,9,5,6,370966,13390,35,2430,440
25,10,15,3,13,194042,44556,83,23076,546
19,6,13,3,15,64264,43006,74,21617,415
4,1,3,1,9,147,12550,1,149,562
6,3,3,4,5,153869,131316,78,12312,523
44,9,35,7,9,219778,176737,158,30274,382
19,1,18,1,12,26456,26456,2,26456,537
11,8,3,0,9,6096,0,11,1098,400
14,3,11,4,21,1021351,175341,66,7598,460
6,1,5,2,11,207613,41771,0,0,644
31,15,16,0,17,1597639,0,21,39,635
7,3,4,1,10,104828,4585,3,0,598
5,2,3,2,9,4219,4219,20,2588,568
72,11,61,10,10,297369,194829,285,124679,407
40,5,35,0,13,84569,0,3,1966,566
5,3,2,2,9,20041,17521,59,0,550
13,7,6,6,8,36168,24975,65,8128,424
10,7,3,4,14,46288,21930,150,13927,507
33,6,27,2,14,276833,917,110,1963,565
7,3,4,0,12,0,0,0,0,754
9,5,4,4,9,76197,65582,0,0,412
32,17,15,11,19,556378,310523,81,214616,472
6,2,4,1,7,251160,556,22,0,564
16,5,11,4,12,35409,25856,67,7633,485
6,3,3,2,7,10365,17802,50,5835,487
5,1,4,2,13,7559,15117,35,0,605
33,13,20,5,10,360726,95768,204,2289,483
13,8,5,6,10,41314,26475,93,7563,453
18,6,12,1,10,85013,9208,36,0,586
12,7,5,6,10,93617,93564,12,4673,424
8,3,5,0,10,21364,0,9,0,600
3,0,3,0,2,0,0,4,7000,560
7,3,4,2,10,5531,5531,32,6289,448
27,11,16,6,9,167581,114019,173,3161,512
9,3,6,0,10,14390,0,0,1153,579
6,3,3,3,13,15144,27374,63,197,528
24,4,20,1,10,54640,19,40,2222,615
8,3,5,0,14,17090,0,0,27995,688
11,7,4,8,7,47165,47165,126,12674,445
29,10,19,5,9,227528,226401,137,83589,509
3,1,2,0,7,1223,0,0,0,527
7,2,5,3,12,267700,41279,25,5311,623
14,6,8,0,13,26305,0,0,0,502
9,1,8,1,3,5353,5353,16,5353,528
3,1,2,0,5,3533,0,0,0,661
37,10,27,2,16,172193,22638,79,1970,492
25,8,17,6,17,282194,36813,93,14952,518
21,8,13,6,9,174326,166043,131,66271,468
6,2,4,1,11,8198,219,35,2134,520
39,10,29,7,18,378216,66849,399,28246,446
11,2,9,4,16,4708,59705,49,0,536
18,15,3,2,7,263668,319,7,306,559
16,7,9,3,69,1037366,122287,78,77981,469
13,8,5,8,9,166039,158055,68,17062,423
15,8,7,2,11,339077,1143,25,0,446
4,0,4,0,10,0,0,0,0,610
12,5,7,2,8,113495,71869,43,0,465
14,3,11,0,10,55031,0,0,0,642
7,3,4,4,6,17804,20216,82,980,506
37,5,32,2,8,47881,5774,25,3728,526
19,6,13,6,9,70479,31389,54,15920,586
14,9,5,5,15,108860,33294,65,4609,477
11,4,7,3,14,28507,35316,33,5905,432
8,4,4,1,11,72444,60713,24,60713,578
22,10,12,8,17,499035,98692,6,18189,427
16,5,11,3,15,55328,7009,37,4976,490
12,9,3,5,9,30496,23775,109,2702,425
18,10,8,2,20,5883,301,7,1210,651
14,9,5,3,13,354098,2547,22,997,463
13,7,6,0,13,174931,0,5,2935,563
26,19,7,1,16,506109,8224,24,8224,603
12,7,5,0,6,210009,0,1,0,608
12,9,3,0,4,107642,0,7,292,623
64,17,47,4,13,1025375,50583,138,45881,544
38,28,10,3,13,340029,18283,43,14145,582
5,3,2,3,12,42820,29937,136,492,489
8,4,4,3,7,18266,17561,48,2772,441
13,5,8,3,4,29088,1976,37,3092,603
36,18,18,2,13,582426,1584,32,900,552
11,8,3,0,12,55028,0,17,12654,577
12,8,4,0,8,58514,0,0,0,586
41,19,22,9,12,424488,22848,231,7011,349
16,3,13,2,11,644412,12656,86,11519,457
33,21,12,1,10,680860,2772,4,2772,544
14,2,12,0,11,4633,0,8,2461,648
25,16,9,2,11,1172185,1536,17,738,447
19,13,6,6,5,225483,119256,111,38103,516
21,11,10,7,13,253688,88584,283,23541,502
24,5,19,3,15,15932,15932,66,8343,441
17,12,5,9,23,454813,151390,143,3629,447
31,7,24,1,23,302911,38770,25,0,608
13,8,5,0,8,497554,0,0,0,634
5,2,3,1,5,18120,16120,95,16120,639
13,3,10,1,4,29116,26249,92,26249,502
6,3,3,3,12,16341,16341,53,3966,489
12,6,6,4,8,35303,23849,36,69,494
13,10,3,1,8,90894,1668,27,2544,413
8,4,4,3,9,29350,29350,289,21651,532
23,11,12,1,69,454940,1043,48,5387,578
11,4,7,3,12,43506,26298,5,15768,479
5,2,3,2,11,1676,1676,103,889,497
11,7,4,3,6,102458,22509,0,0,416
8,5,3,1,13,52075,3600,20,0,502
12,5,7,7,8,28114,42143,124,7963,435
20,5,15,6,22,18266,34310,108,7202,521
14,4,10,0,10,18706,0,23,0,691
4,1,3,0,13,5619,0,0,0,634
7,3,4,0,11,291085,0,1,12750,644
9,7,2,2,12,93709,6397,20,2170,536
21,14,7,5,4,166733,40663,98,41,460
9,7,2,5,13,181720,138761,15,36040,501
17,11,6,0,9,88930,0,7,0,470
11,5,6,4,20,13660,13660,321,7282,492
9,6,3,6,12,33880,33880,110,0,486
8,3,5,3,11,32255,32255,12,15646,438
16,5,11,2,3,20254,2274,65,1516,493
8,4,4,3,9,209913,24188,0,0,449
43,19,24,14,14,671434,273865,138,111960,450
11,7,4,3,7,42559,31579,48,795,473
6,4,2,0,12,29242,0,2,669,656
21,4,17,2,7,38929,19875,43,11976,508
8,3,5,1,5,12000,342,4,1204,486
12,3,9,3,13,230545,117861,43,52418,428
18,9,9,4,8,136346,1412,20,824,359
43,15,28,14,26,310848,99641,236,22865,422
25,10,15,8,8,73582,81453,470,19532,429
22,4,18,7,13,109392,51222,29,17763,437
31,9,22,5,16,267573,33013,161,19803,492
9,6,3,3,17,114757,83254,51,16636,486
9,3,6,2,10,14772,14772,51,3146,602
21,7,14,4,5,98322,11766,72,2067,503
12,9,3,8,7,359680,269164,176,3084,466
11,7,4,8,8,19993,17150,36,1799,438
30,9,21,9,15,513069,541737,1,5166,447
11,4,7,0,8,281812,0,4,596,598
25,7,18,0,17,585775,0,12,0,673
18,2,16,4,16,287182,263269,31,1441,534
49,6,43,6,13,18054,12877,82,23541,413
13,5,8,3,9,74479,36197,57,1282,499
38,15,23,5,6,242253,119962,48,728,459
59,31,28,6,17,1277143,25120,74,9430,403
7,4,3,3,11,118043,13072,0,0,495
16,7,9,0,7,138031,0,40,1716,573
22,10,12,4,8,116316,19377,76,3246,477
4,2,2,3,7,19905,30879,96,14242,512
33,15,18,0,18,1636841,0,0,0,579
63,13,50,10,14,610406,322781,280,14048,466
10,7,3,2,6,83200,231,2,206,527
39,9,30,9,9,183766,149715,122,111,469
11,2,9,0,4,5217,0,16,2150,649
10,3,7,4,13,519731,16354,26,2700,558
15,10,5,2,38,43851,5461,113,8741,436
7,2,5,1,9,22048,6021,13,0,629
7,5,2,2,17,646122,41778,33,22175,510
7,5,2,0,4,14609,0,4,0,634
3,1,2,1,3,3596,3596,5,3596,501
32,15,17,20,9,655921,359671,298,68506,434
16,6,10,3,8,58550,17568,9,955,634
8,5,3,4,15,244423,143365,66,0,486
14,5,9,2,9,51238,28245,32,3103,493
8,5,3,4,4,63177,62950,162,39410,529
8,2,6,3,5,7943,16719,52,3148,489
19,6,13,3,9,30734,5616,222,2527,443
20,5,15,0,13,275287,0,14,377,562
155,12,143,6,19,468150,61960,47,0,522
8,6,2,5,12,103165,103165,72,2620021,473
26,14,12,9,12,433604,81707,0,0,458
10,6,4,9,7,119466,151549,29,35569,437
25,4,21,2,8,46123,1635,25,3509,466
10,4,6,2,9,118972,31876,25,0,483
9,5,4,3,10,262963,17896,35,724,503
16,9,7,3,10,461607,10510,30,10327,488
47,5,42,5,13,24661,34177,49,12699,502
13,6,7,5,19,461230,52615,91,27186,495
77,8,69,6,9,353291,53686,3,12584,493
26,11,15,0,20,398213,0,4,0,608
87,18,69,2,14,1543857,7497,39,6281,466
6,3,3,1,5,294598,7182,57,1330,487
38,7,31,2,8,22988,10245,78,8897,430
34,12,22,1,13,139837,543,26,543,495
14,4,10,0,12,83565,0,20,3027,544
4,2,2,2,1,5530,5530,4,3805,502
28,8,20,11,14,30866,43257,219,6490,414
10,5,5,4,8,40427,24597,46,10894,478
18,9,9,3,11,323636,68094,62,0,524
12,4,8,2,7,1803,4462,34,923,530
17,8,9,1,8,125999,26218,49,5546,467
6,2,4,2,9,111645,34765,29,1955,511
15,6,9,2,13,180715,21009,62,3796,496
23,7,16,0,14,616225,0,7,0,533
18,6,12,4,8,590167,93702,47,0,453
9,6,3,0,11,393129,0,19,2246,502
5,3,2,0,9,29639,0,0,0,670
16,10,6,6,16,123137,68868,104,922,455
38,9,29,8,69,730205,68727,290,26335,468
34,9,25,6,15,275862,37449,43,13708,388
18,12,6,0,13,601612,0,85,143292,499
92,14,78,3,15,257944,14797,20,7625,544
13,8,5,10,8,184925,172985,36,87021,418
29,5,24,0,5,34166,0,13,2774,600
23,13,10,1,12,35552,5473,18,4182,496
28,11,17,5,23,26475837,7862126,76,0,457
9,6,3,3,8,415014,53668,39,19675,409
76,21,55,10,19,1396815,1340702,272,550883,472
8,4,4,1,7,4150,947,9,947,571
9,6,3,0,8,0,0,4,0,669
24,10,14,7,15,71698,69308,62,26318,456
9,2,7,0,3,6251,0,71,277,614
3,1,2,0,4,6891,0,0,0,667
6,1,5,1,14,86377,86377,22,86377,562
8,5,3,5,8,11528,19882,0,0,522
10,5,5,0,18,136721,0,11,0,636
35,6,29,1,14,40270,9670,179,9670,609
14,8,6,6,9,50741,23240,38,4950,418
31,18,13,1,13,297760,3746,38,0,469
11,4,7,2,16,215649,41246,17,0,503
10,5,5,3,6,35748,3008,55,5625,498
22,4,18,4,15,49604,49604,366,29617,548
15,6,9,5,8,16300,15019,97,31656,430
20,8,12,4,7,102877,47166,113,1800,568
10,4,6,4,8,119240,56317,66,31242,439
10,3,7,1,8,10386,10386,0,0,520
15,2,13,2,8,32486,32486,35,5306,518
5,2,3,1,19,632370,991,6,1089,596
7,3,4,3,4,233895,48265,65,13391,535
7,5,2,1,8,20978,7155,8,0,587
15,11,4,0,19,311173,0,17,0,548
4,2,2,0,10,49978,0,0,0,667
7,3,4,5,13,380777,91239,34,0,507
50,10,40,5,18,327489,161701,117,31380,453
9,7,2,9,7,254880,50902,175,10579,473
6,3,3,2,8,16471,6458,19,6340,497
18,11,7,0,8,271349,0,28,1328,496
4,2,2,0,11,10000,0,0,0,627
15,11,4,0,9,598267,0,15,0,532
15,6,9,4,13,56461,33094,482,19248,486
6,4,2,2,8,21129,15183,14,13593,502
6,4,2,3,1,18232,1342,33,1312,532
9,5,4,0,6,449369,0,0,0,615
10,7,3,7,17,18069,18069,50,4622,465
21,7,14,6,17,21315,12022,39,4678,477
32,18,14,15,13,175548,143368,243,20874,415
11,7,4,7,14,37894,36415,194,14612,525
45,11,34,6,15,302647,90480,277,66144,494
31,14,17,4,13,663230,16479,26,4842,537
11,9,2,1,19,23301,300,69,7160,604
7,5,2,0,5,11273,0,39,0,545
5,2,3,0,13,11947,0,0,1338,644
23,6,17,4,12,54674,54518,304,48884,455
21,14,7,8,17,536290,291114,110,110120,423
8,6,2,5,8,15856,15856,46,7088,509
7,5,2,1,7,4931,378,25,491,548
15,7,8,6,14,367148,63774,98,15235,450
5,3,2,1,5,34365,24423,0,0,472
18,11,7,9,10,219843,226968,32,55904,450
42,15,27,4,10,333524,124890,94,10653,478
30,8,22,11,19,138223,206506,0,0,501
15,6,9,5,4,25025,10940,205,5605,451
8,3,5,0,8,0,0,12,2083,617
10,8,2,3,11,460521,106265,81,21297,390
66,6,60,1,24,514293,16120,45,16120,519
7,3,4,4,15,9694,9694,11,7097,479
26,5,21,5,19,47183,44423,52,5822,431
22,7,15,0,10,33990,0,2,2523,640
18,8,10,6,19,61438,36778,121,19936,430
12,2,10,2,8,34455,30337,54,29697,518
5,1,4,0,10,0,0,21,2546,538
17,7,10,2,7,22111,4013,119,2405,501
12,7,5,1,22,320319,1611,2,1611,561
10,6,4,0,5,210981,0,11,0,620
7,2,5,1,9,88625,11549,8,0,624
21,8,13,1,9,645312,11981,4,0,525
16,5,11,6,12,171251,169829,125,124158,434
15,6,9,3,10,21429,29749,69,10878,494
30,17,13,1,17,1528167,1451,60,15076,539
15,4,11,4,6,129822,64707,47,9589,415
19,4,15,2,14,27903,2107,5,11432,537
16,11,5,1,7,189257,15947,34,18509,424
12,4,8,0,5,22794,0,8,0,508
10,4,6,4,17,465401,36338,136,40291,435
12,7,5,1,12,205255,326,9,0,628
19,4,15,2,16,39948,30169,53,5705,525
2,0,2,0,6,0,0,1,0,633
17,4,13,4,7,13319,11037,265,5640,449
3,1,2,0,4,0,0,8,0,653
28,24,4,20,8,253846,221465,179,47824,491
14,9,5,8,27,72057,72057,57,19417,476
13,4,9,4,8,198672,203996,77,2987,519
38,9,29,9,11,123797,73899,113,53598,477
11,4,7,3,8,53001,14501,137,7581,522
4,1,3,2,8,30245,30245,59,28628,622
9,5,4,2,13,101493,8646,39,0,553
57,7,50,6,11,77460,34824,110,11203,450
50,22,28,0,15,8976622,0,201,79614,569
7,0,7,3,9,0,52323,68,0,530
19,7,12,3,26,189487,4893,111,4819,487
7,2,5,1,7,1907,1907,18,0,506
14,3,11,3,9,363211,31217,0,0,471
26,11,15,6,18,256325,184425,112,4201,452
16,7,9,5,9,166204,106710,0,0,486
12,3,9,0,9,29470,0,0,191,599
13,3,10,3,9,37579,32222,71,17482,614
10,3,7,0,9,990,0,5,0,473
11,8,3,0,9,35173,0,0,0,602
29,11,18,0,2,79798,0,6,3447,547
20,8,12,6,15,684926,100105,139,18676,435
21,6,15,1,13,302370,1483,9,1880,517
7,4,3,3,9,141471,124946,65,0,522
12,2,10,2,12,7488,7488,31,6806,572
23,9,14,5,14,32899,13652,26,4319,586
22,5,17,2,18,477482,10822,161,5411,533
19,7,12,4,11,37535,10285,233,4631,525
33,19,14,8,18,330997,15134,0,0,494
120,6,114,2,6,31461,1768,11,1694,526
17,7,10,8,13,405899,29295,77,8175,496
18,3,15,1,10,36619,2459,52,2459,632
10,6,4,0,6,104879,0,17,997,623
18,6,12,6,16,64697,46025,11,2755,523
6,3,3,2,10,4719,2977,42,2559,550
22,12,10,1,14,505016,10994,25,10994,648
7,5,2,0,7,8797,0,0,753,702
16,8,8,3,11,212468,24170,55,19317,607
25,9,16,0,10,439391,0,0,0,632
24,5,19,9,13,43901,46463,109,27739,447
28,17,11,0,13,1310255,0,9,0,501
13,5,8,2,7,71107,6056,111,3974,638
16,8,8,5,9,362904,29493,314,11859,437
3,1,2,1,6,9102,9102,95,9102,615
20,11,9,4,8,800315,35690,53,0,444
11,7,4,5,11,293520,153554,28,0,548
4,0,4,1,6,0,11289,10,0,534
10,7,3,7,7,32903,32902,136,2806,447
15,0,15,0,8,0,0,1,2910,646
9,6,3,1,17,11783,7832,30,7832,601
8,6,2,0,6,27057,0,1,1342,591
20,9,11,0,6,142815,0,7,1481,589
4,0,4,0,13,0,0,0,0,615
25,9,16,6,7,57005,37815,334,18279,442
22,8,14,5,10,19742,17037,66,13535,443
11,0,11,6,18,0,87655,113,877,537
34,8,26,6,13,54990,26205,218,11877,550
8,4,4,3,14,895869,32638,57,8479,431
5,3,2,3,8,25819,4255,5,4020,552
13,9,4,8,12,149962,147610,185,22119,420
20,9,11,6,13,586143,96190,113,17222,415
6,2,4,2,7,40720,26835,0,0,543
14,4,10,1,9,257415,557,0,0,549
36,13,23,7,11,887408,81126,179,50207,425
6,3,3,0,2,41794,0,2,28101,594
12,8,4,1,4,89229,938,2,0,541
10,8,2,0,2,25738,0,24,1026,557
7,2,5,2,3,909,909,6,571,374
5,0,5,0,7,0,0,2,880,555
16,10,6,0,21,616977,0,8,0,690
22,4,18,0,14,108777,0,80,3300,628
13,4,9,0,3,12258,0,1,490,605
13,3,10,0,9,96174,0,1,255,698
11,7,4,1,9,151082,477,0,0,598
24,10,14,2,13,172638,3296,70,380,528
7,3,4,1,13,243950,11743,0,0,614
10,8,2,2,4,90805,6705,34,0,485
14,4,10,1,11,37569,9767,15,3213,589
10,4,6,5,16,95480,208228,105,2171,455
23,10,13,10,12,84348,78265,264,14526,456
37,17,20,2,11,919600,5335,47,5183,482
27,14,13,6,18,426471,75834,123,30943,429
19,4,15,3,11,21120,21120,203,31886,467
16,8,8,4,13,30699,23269,145,16433,427
6,4,2,4,7,14472,7143,71,2631,413
39,12,27,2,14,402068,13087,38,9259,452
22,5,17,2,14,233445,159839,0,0,478
13,3,10,2,6,36042,15230,23,10194,570
4,2,2,1,9,6500,6500,95,13000,663
8,6,2,3,16,367190,30642,46,4922,468
22,16,6,6,19,423624,42410,66,2884,463
31,10,21,5,8,172932,9774,35,2608,406
26,12,14,12,12,583504,141866,279,76711,391
12,5,7,1,10,14590,592,14,874,506
9,3,6,3,9,23719,26841,0,0,469
34,8,26,5,19,246532,48288,109,4348,446
18,12,6,1,8,348552,406,15,0,511
17,10,7,2,7,23534,2099,25,2107,527
20,10,10,6,15,53334,52609,222,11536,447
9,6,3,7,5,26034,42304,73,21229,498
11,6,5,0,16,41054,0,0,5576,571
8,6,2,5,15,309730,22810,70,8262,521
19,2,17,2,12,31208,31208,194,29653,565
26,10,16,10,10,152442,158289,230,72969,412
7,5,2,1,8,23717,16912,15,1061,600
7,2,5,1,11,256812,2263,0,0,683
8,4,4,6,18,84294,119210,110,32833,585
6,4,2,4,8,19443,19443,47,8755,521
11,3,8,2,5,35850,6732,6,1904,489
28,11,17,5,18,441660,52145,64,21458,438
23,5,18,3,8,33759,14354,27,12223,474
37,3,34,0,15,401,0,73,5655,626
38,3,35,1,7,356671,5502,12,0,543
20,8,12,3,17,281870,28284,24,7108,424
10,4,6,4,10,85332,35206,51,14656,480
12,8,4,4,17,106927,42844,108,8035,454
7,4,3,0,5,513384,0,4,1759,621
6,4,2,3,10,57705,57705,72,0,522
19,4,15,6,8,183205,39813,64,8991,451
4,2,2,0,2,1100,0,0,0,609
60,17,43,9,17,156689,123732,141,5520,475
23,8,15,7,7,59288,58217,35,3628,416
4,1,3,1,8,0,7895,0,0,615
22,7,15,2,12,296670,5679,21,0,469
4,1,3,2,5,1505,3782,40,2568,534
21,5,16,6,19,229793,40590,364,23584,488
11,9,2,6,14,423153,302136,97,159242,495
3,1,2,1,8,1638,1638,0,0,645
19,13,6,1,16,125905,812,24,3284,580
23,8,15,6,11,414868,32660,156,13552,450
17,11,6,0,15,267452,0,1,993,588
26,10,16,7,8,362741,31824,136,6827,451
10,7,3,0,7,90258,0,2,0,572
22,7,15,4,17,236862,6654,72,1243,417
12,5,7,0,8,112786,0,9,2828,511
5,1,4,2,6,14609,5974,25,0,477
7,4,3,5,7,251670,251670,96,20083,491
31,9,22,6,14,100504,38937,102,10440,609
7,1,6,3,7,71759,71759,58,67360,516
17,7,10,7,7,184196,26601,305,7384,439
8,2,6,1,10,0,41289,11,0,539
24,10,14,0,8,1812588,0,8,0,626
7,5,2,1,23,32274,26068,24,26068,555
15,9,6,7,19,564173,127829,0,0,421
55,7,48,3,7,71278,15575,21,8662,464
18,9,9,1,18,1652294,379,46,0,529
25,10,15,5,12,97809,55357,92,21133,523
7,4,3,0,8,45262,0,0,0,702
6,3,3,0,13,28854,0,0,0,596
23,12,11,0,14,355203,0,8,0,581
14,8,6,0,8,260311,0,9,0,669
15,12,3,12,7,89122,114827,231,26541,346
22,4,18,3,10,17805,15303,63,7793,483
4,1,3,0,14,0,0,0,1538,766
15,9,6,10,8,254844,232193,193,12135,476
16,8,8,0,7,57829,0,34,0,514
20,7,13,0,8,239982,0,1,0,633
11,2,9,0,10,53754,0,3,0,629
10,6,4,1,3,48607,276,22,4270,535
15,4,11,2,4,41698,6433,14,7136,486
33,8,25,8,9,98341,105338,310,28437,412
10,7,3,1,3,68710,265,1,265,512
4,1,3,3,9,1150,11266,9,1150,527
13,10,3,6,21,508223,55622,0,0,566
13,9,4,11,15,605122,196092,0,0,455
20,3,17,4,12,37172,37172,23,11831,445
16,6,10,6,14,54758,47250,215,264500,529
14,1,13,2,10,0,30640,42,0,643
5,3,2,3,14,9533,9533,62,5440,612
18,3,15,3,15,376684,61229,64,25430,470
12,8,4,1,4,883175,424,5,571,494
20,2,18,0,17,0,0,26,3136,716
13,5,8,5,7,28285,45655,94,5809,470
9,3,6,2,5,20228,13283,48,7763,454
17,4,13,3,21,22321,119832,102,12499,479
7,2,5,3,8,12172,13161,87,1250,632
7,0,7,0,6,0,0,3,1625,632
12,3,9,1,18,10557,37823,41,2512,593
5,2,3,0,16,0,0,0,8076,465
21,8,13,4,11,326131,77601,33,26383,392
9,7,2,2,3,320214,2901,51,0,510
24,7,17,5,9,34965,29387,86,10030,451
4,0,4,0,12,0,0,0,50535,627
6,4,2,2,14,10142,4554,28,2787,638
5,3,2,4,7,14935,32925,68,17990,464
27,12,15,0,23,573338,0,2,766,608
25,3,22,1,9,20343,20343,35,4375,468
18,9,9,1,13,621877,997,4,6576,397
5,2,3,2,8,22876,22876,16,649,507
13,7,6,0,8,36499,0,2,0,664
15,9,6,0,10,729487,0,7,6890,517
5,3,2,0,6,17726,0,56,1840,591
19,13,6,1,8,1101146,406,0,0,480
11,8,3,5,16,68636,45291,50,5968,448
31,9,22,9,16,67891,60307,96,17791,433
59,10,49,1,15,144634,2849,54,2849,482
14,7,7,6,7,27982,28326,130,17045,434
3,1,2,1,3,19191,19191,10,19191,540
77,9,68,9,13,93760,82253,93,17856,447
8,6,2,5,8,35778,35778,60,10439,423
3,1,2,1,6,4366,4366,95,4366,494
36,7,29,6,10,97826,32259,222,15134,478
22,15,7,4,7,253940,24422,7,5954,483
16,6,10,4,15,195621,47651,24,18168,425
14,6,8,0,11,56587,0,0,9027,612
6,2,4,2,7,8599,5517,63,0,490
47,2,45,1,14,9679,374,30,1447,547
4,1,3,2,6,6965,11659,28,6965,534
10,4,6,2,16,16106,1558,2,1139,493
23,14,9,0,23,1178548,0,9,0,501
37,13,24,0,8,170228,0,53,23,505
15,5,10,3,8,182101,33298,72,0,466
14,5,9,8,12,262209,318220,84,69005,483
8,2,6,2,15,433783,10688,16,10503,496
19,2,17,2,13,23353,23353,243,22626,503
20,13,7,9,10,1143501,74880,93,1106,442
9,7,2,3,15,98795,115907,61,7822,434
10,4,6,2,14,37433,5272,26,0,526
36,13,23,6,12,168997,48543,151,22834,404
7,3,4,0,10,20346,0,0,3059,601
11,9,2,4,6,84651,2356,41,568,470
37,19,18,2,13,469974,6391,1,2083,501
19,9,10,7,6,25254,25253,385,9452,453
4,1,3,0,13,7983,0,3,3080,634
12,6,6,2,9,266864,659,0,0,476
31,4,27,4,15,119763,77826,190,36766,503
10,4,6,2,11,670549,378162,72,11420,459
8,6,2,1,9,59206,1526,11,3259,528
12,7,5,5,7,81642,66682,42,47781,450
8,6,2,6,5,21509,20028,87,7263,425
10,7,3,6,35,12186,8388,218,1787,487
4,1,3,0,13,8931,0,0,0,614
12,5,7,3,7,479058,24705,308,13587,462
19,7,12,1,34,468979,114799,14,705,424
34,3,31,1,11,692409,26216,23,26216,633
24,6,18,6,7,238611,63797,26,18640,425
27,11,16,8,12,28675,79428,109,8903,501
17,7,10,3,12,43659,19279,18,16943,449
7,5,2,3,6,138012,7858,0,0,497
17,8,9,2,21,97957,850,44,0,555
13,5,8,3,17,409472,15610,28,10792,464
8,2,6,2,10,9100,9100,34,7314,393
12,3,9,4,15,1612567,415086,58,0,501
8,4,4,6,16,52598,18300,86,5821,454
8,3,5,1,8,382317,9277,50,0,614
12,3,9,0,10,4906,0,163,3846,521
5,3,2,4,6,8872,14384,94,5065,507
27,1,26,1,11,63867,65035,44,1793,521
4,1,3,1,7,8851,3116,15,3116,576
4,2,2,3,4,49273,73546,0,0,453
9,3,6,3,8,19170,19170,52,0,462
33,5,28,6,14,214911,172479,137,57606,436
11,5,6,3,8,47303,1306,6,518,526
8,6,2,6,7,66604,68767,57,9278,460
17,8,9,5,14,120958,13511,32,7658,394
23,6,17,7,18,344606,68693,13,9763,484
6,2,4,0,16,137219,0,5,930,671
12,7,5,1,5,87887,341,3,341,573
16,5,11,6,9,28458,38205,98,15620,471
42,13,29,1,11,133197,10586,9,7018,479
20,6,14,6,8,447844,48013,143,3202,451
6,4,2,3,7,13703,13703,74,10384,532
19,10,9,0,14,399404,0,5,0,683
43,9,34,0,7,263746,0,61,10780,431
36,17,19,20,23,1165141,1122784,315,95499,447
12,5,7,3,2,30264,11385,17,4945,413
20,8,12,0,12,5219934,0,41,1,517
5,3,2,1,4,10901,13148,11,13148,619
19,6,13,3,8,550154,59600,36,2500,451
38,18,20,4,10,67861,26680,3,2892,478
8,3,5,4,9,42920,44575,39,10953,603
28,9,19,2,13,274293,18970,63,0,458
12,7,5,5,19,305498,34742,66,9717,495
18,8,10,8,34,31841,149648,236,117807,489
6,3,3,0,11,99110,0,33,0,601
47,5,42,1,18,22137,14387,106,14387,639
21,5,16,0,12,456060,0,1,0,645
7,3,4,2,10,224674,16732,42,17144,476
38,1,37,1,11,3870,47673,4,913,615
7,2,5,0,16,4101,0,4,5271,570
18,12,6,6,7,164887,86002,4,841,444
66,16,50,6,21,314278,31912,423,9398,481
16,12,4,2,15,2141124,22980,7,0,422
16,9,7,8,19,481712,342122,86,6512,436
9,7,2,3,25,97301,93987,15,97263,582
23,3,20,0,6,3667,0,9,0,603
14,8,6,6,12,114268,44300,116,21170,459
13,8,5,2,8,101668,19864,123,14742,505
15,1,14,0,13,216119,0,0,0,690
4,2,2,0,2,75775,0,1,0,560
8,4,4,5,7,249779,217188,116,61445,494
42,8,34,3,13,176230,25310,42,11817,492
8,4,4,5,7,11812,11812,55,4341,499
18,8,10,7,9,50680,50680,404,19382,489
8,3,5,1,12,1560,1560,28,2476,560
18,2,16,2,11,14777,14777,155,8636,497
5,1,4,1,10,0,3497,4,3885,651
53,17,36,1,14,806942,15124,7,296,475
16,8,8,0,8,353029,0,6,0,536
9,4,5,3,7,46684,44408,89,39430,518
8,4,4,1,4,198902,32413,74,225,487
6,4,2,0,2,46816,0,0,0,588
6,4,2,5,5,28723,54907,256,4612,509
16,12,4,7,8,56027,50295,253,9602,451
5,3,2,1,7,33150,259,36,578,522
3,1,2,1,9,0,11928,0,0,648
16,12,4,7,7,299411,106155,89,1243,516
15,11,4,0,6,305287,0,22,0,471
7,4,3,2,13,3835,3835,27,7842,466
20,6,14,4,11,279354,37096,27,9119,469
5,3,2,1,4,20690,957,5,957,532
26,9,17,3,14,311399,45069,28,24338,431
24,5,19,3,21,12760,4753,44,5518,510
4,2,2,1,11,9321,9021,24,9021,531
26,2,24,0,20,300429,0,0,3967,681
10,7,3,2,11,10516,2960,42,1350,501
16,12,4,0,18,433852,0,5,0,705
25,8,17,10,22,522839,141703,186,3332,476
12,7,5,0,18,766188,0,1,0,677
4,2,2,2,3,101099,10772,27,0,522
6,4,2,3,12,15834,13354,67,11672,501
12,9,3,0,9,79957,0,0,0,599
11,8,3,5,13,801770,120085,90,0,451
9,3,6,5,6,20528,35613,0,0,469
15,5,10,3,16,15168,9886,36,5515,493
46,12,34,0,11,242435,0,26,2229,577
11,6,5,6,8,147328,164577,76,1123,462
12,6,6,4,15,233617,173877,46,152205,436
55,18,37,0,21,102839,0,40,10798,519
12,3,9,3,5,26443,26443,26,4608,464
55,8,47,0,14,310703,0,89,1960,378
11,3,8,5,11,73028,88350,84,0,474
17,11,6,10,26,136097,106636,196,18395,460
6,4,2,3,8,296739,9380,77,0,469
4,2,2,0,3,11041,0,15,55,660
8,5,3,4,6,343715,23705,72,0,472
26,4,22,4,8,18724,7078,71,4030,466
6,4,2,2,15,33054,13388,46,0,637
10,4,6,3,16,22635,15306,240,11440,533
8,5,3,1,20,491067,111556,39,202418,556
13,8,5,5,5,39052,26250,198,15833,447
12,2,10,1,14,13535,13535,65,14535,548
28,7,21,3,11,106150,18573,350,16615,486
24,10,14,9,22,58543,40365,136,11069,371
13,6,7,0,4,110466,0,0,0,591
23,8,15,8,12,359280,66868,134,17051,455
73,13,60,5,8,160881,11727,116,7173,501
6,4,2,1,8,1000,33285,11,33285,683
25,11,14,8,22,646566,131319,123,72580,446
31,8,23,4,11,351371,7305,66,4814,462
16,4,12,2,5,23397,2589,19,1851,634
12,6,6,1,12,491153,11031,23,11031,555
14,10,4,0,8,93390,0,2,0,628
7,5,2,2,15,12095,2754,12,15916,484
13,9,4,1,11,209088,2093,14,33,478
14,5,9,5,7,105597,30803,73,6340,577
16,6,10,3,12,46775,1457,14,1153,465
6,4,2,1,5,8054,7403,56,0,496
9,3,6,3,19,43272,61964,49,1751,435
21,4,17,1,15,77486,4997,37,4997,528
33,9,24,10,17,909945,168654,113,24363,433
6,3,3,2,10,9620,9620,56,0,512
46,4,42,4,9,231470,132246,0,0,474
111,11,100,0,14,129172,0,12,1220,553
58,20,38,3,27,590874,19660,247,18818,418
37,13,24,13,9,418513,103722,322,38376,490
9,4,5,5,9,14685,37392,44,6958,468
45,5,40,4,8,33423,30787,52,10104,491
12,5,7,2,9,105297,8336,11,7224,580
14,4,10,0,9,629861,0,0,0,601
11,2,9,0,14,570839,0,7,30070,525
25,9,16,7,13,148333,63431,224,13320,390
28,10,18,3,13,213993,29937,30,3848,447
37,11,26,3,18,69603,25076,53,12775,512
12,7,5,2,11,125237,37841,29,1052,463
11,3,8,4,9,24956,31366,153,11897,533
13,6,7,5,6,32157,16953,49,6471,444
21,7,14,5,11,324105,59992,395,12388,423
16,7,9,0,32,495747,0,7,0,651
24,9,15,1,6,46880,516,43,3196,454
7,5,2,4,16,30490,29962,0,0,520
13,3,10,5,11,31993,41322,32,5836,550
19,5,14,1,7,21147,1216,9,3213,579
33,7,26,4,14,183807,57193,46,17733,426
4,2,2,2,3,10046,17434,16,0,493
21,13,8,7,13,1283041,811741,87,0,474
20,12,8,7,25,232933,182111,56,0,450
20,9,11,4,9,69240,15459,71,3194,443
3,1,2,0,7,0,0,0,978,686
5,3,2,1,12,997,997,7,6069,436
26,8,18,6,10,36457,48838,200,5196,464
22,2,20,2,13,13089,30131,35,4713,646
12,5,7,2,11,46015,15950,50,100,608
20,6,14,6,10,190448,164728,137,9382,418
12,7,5,2,9,59322,15689,25,2500,442
7,1,6,0,3,450,0,0,0,634
65,11,54,1,15,42722,529,110,8448,586
36,6,30,6,15,103724,98049,79,23526,455
16,4,12,0,14,278795,0,13,5112,663
10,3,7,0,9,416204,0,1,0,694
16,11,5,9,9,118727,106044,163,19917,473
20,4,16,1,19,15305,9491,20,9491,577
31,14,17,3,5,288314,5049,123,6812,408
8,5,3,2,4,26162,12959,9,12226,537
18,8,10,8,9,43183,59921,155,15499,522
38,11,27,11,15,93244,90435,174,12292,480
3,1,2,1,7,9498,9498,31,950,494
5,3,2,2,16,12698,11930,33,10158,481
5,3,2,3,14,30548,30548,46,15893,422
11,4,7,0,8,860,0,0,0,610
7,3,4,0,4,8853,0,3,614,680
23,9,14,6,9,129911,40374,395,13800,442
15,12,3,3,17,470561,31695,76,28607,427
24,9,15,5,13,539954,25615,138,2536,470
13,4,9,3,14,17796,14891,43,6528,483
7,4,3,3,9,11961,6038,19,2112,397
31,7,24,5,11,187942,133614,0,0,450
22,13,9,9,15,479602,217399,144,118028,387
13,7,6,4,12,253294,25572,54,15761,465
6,3,3,4,12,350772,43496,69,19166,509
8,3,5,1,9,22114,4408,15,4441,593
17,10,7,5,6,39942,29859,86,1531,451
23,9,14,10,9,458227,155245,111,5480,424
11,7,4,3,37,602292,387793,83,7754,488
4,1,3,2,7,3312,1137,15,600,603
19,3,16,2,7,18453,18453,63,13530,663
20,14,6,6,16,935076,152808,112,54599,437
47,8,39,0,8,613519,0,0,0,616
15,5,10,1,12,166131,426,16,869,577
23,15,8,11,17,521216,460998,106,3773,469
10,6,4,3,6,313841,14254,86,953,487
21,15,6,11,7,74910,56246,549,8786,467
20,7,13,0,14,652808,0,23,0,595
25,6,19,6,8,480129,151150,132,0,509
27,15,12,7,8,169454,26142,56,9983,452
91,4,87,1,15,8789,605,194,2121,633
19,3,16,4,16,67987,18589,50,7488,466
36,15,21,10,17,116012,115470,191,17353,435
17,8,9,4,16,476574,49109,37,2181,476
9,7,2,6,7,31118,31118,494,17760,438
11,3,8,3,2,12845,11581,4,5285,385
8,5,3,4,13,139106,16426,50,3398,517
11,5,6,3,14,1114609,571608,60,360935,408
34,23,11,10,12,910085,157836,327,101424,460
15,8,7,2,9,887729,8253,24,0,512
5,3,2,0,14,26031,0,0,0,605
7,5,2,4,38,220047,11142,6,646,480
32,8,24,5,18,505118,46485,91,25000,492
8,5,3,4,21,1021616,1021616,72,358064,574
11,8,3,6,12,532846,41222,68,7415,450
14,6,8,1,14,250034,177593,2,177593,632
23,7,16,4,12,90289,51175,53,471,501
16,6,10,3,13,201297,31325,69,3520,472
34,7,27,1,9,446423,1374,22,1374,488
11,4,7,3,9,215032,10584,55,5048,597
13,6,7,0,11,1164796,0,0,0,632
8,3,5,2,9,21537,21537,44,12111,637
5,1,4,1,5,10920,10920,25,1000,494
51,8,43,5,16,260700,50938,88,20498,373
17,2,15,1,9,12303,599,14,3938,508
19,7,12,0,10,3119068,0,0,0,661
9,7,2,5,16,870206,162978,94,12770,474
54,19,35,8,13,1249622,109680,80,120472,429
12,5,7,8,8,48056,59021,87,14731,438
7,3,4,2,14,73704,73704,59,0,521
20,7,13,1,29,8895,273,24,331,546
38,9,29,4,17,106131,20177,219,13031,500
5,3,2,1,9,24192,6076,8,0,525
7,3,4,0,3,95600,0,0,1383,579
22,16,6,18,8,122392,135929,292,18003,434
26,9,17,4,13,372487,93891,34,10300,422
28,11,17,8,16,296938,296938,117,217716,577
15,7,8,3,8,33497,22710,143,9858,633
19,12,7,9,14,263089,36389,110,7798,404
5,0,5,0,14,0,0,0,0,627
14,8,6,0,22,163933,0,1,0,700
17,8,9,1,20,408655,8522,90,0,481
36,17,19,13,10,497166,56476,128,11316,364
18,11,7,15,16,711459,1002594,260,258430,536
56,14,42,6,15,313486,117912,20,23487,469
32,9,23,5,18,381344,59324,296,29536,501
8,5,3,2,6,76128,4527,30,2930,455
15,8,7,1,10,566516,72968,39,0,488
9,7,2,4,13,330455,33359,85,12901,520
48,6,42,6,5,29805,24352,73,9676,421
4,2,2,1,9,21876,21876,23,21876,543
6,4,2,1,5,442818,2807,2,338,524
66,12,54,8,11,148554,35197,96,14106,434
7,5,2,1,5,204961,13014,23,13014,379
42,8,34,1,17,159535,38353,55,34,527
25,2,23,1,13,16608,16608,137,24881,536
3,1,2,1,7,24345,24345,48,0,519
12,7,5,4,18,171194,153908,39,20616,557
59,4,55,3,14,40018,44230,25,27572,567
9,5,4,4,7,32480,28529,155,15279,521
18,6,12,2,19,109156,25069,75,21372,607
11,7,4,0,16,33617,0,113,1256,523
16,7,9,6,18,100917,96332,93,41348,435
18,5,13,5,28,272985,454696,74,0,543
26,4,22,3,9,269397,113130,95,26785,496
27,10,17,0,10,451431,0,9,0,469
29,11,18,4,16,79935,10385,182,5168,476
11,3,8,1,13,92835,5760,25,440,579
14,6,8,7,9,128242,99397,184,0,534
20,1,19,0,8,3368,0,4,0,644
8,4,4,4,3,28688,25102,13,6622,442
12,10,2,1,6,312335,3574,35,3574,412
11,1,10,0,8,0,0,114,19035,625
21,8,13,1,9,41077,3985,0,0,489
7,3,4,5,4,60043,59642,26,26120,420
7,4,3,4,9,4311,17541,0,0,505
17,10,7,8,13,1043658,198668,47,17291,440
7,4,3,6,8,52901,74104,22,5910,424
11,8,3,2,9,74722,5071,34,0,524
7,5,2,5,7,113950,108124,83,11809,452
6,0,6,0,14,0,0,0,3683,510
12,6,6,4,13,52090,39148,32,14696,429
18,8,10,7,7,150124,130843,126,30553,470
39,20,19,1,13,554770,301,114,7000,492
17,13,4,0,17,409652,0,15,0,523
13,3,10,7,15,537157,448375,64,764,511
16,6,10,1,9,142100,1505,0,0,546
19,3,16,0,12,133641,0,0,18,713
10,7,3,5,8,339240,31711,21,10972,475
7,5,2,1,8,32170,3477,14,3477,543
19,13,6,0,16,302210,0,3,0,646
15,5,10,2,5,19268,6785,395,5917,429
65,12,53,6,19,492327,101689,346,35734,439
3,1,2,0,10,2434,0,0,0,613
10,6,4,0,4,44623,0,4,1063,556
21,14,7,2,30,593172,177382,0,0,574
13,8,5,5,12,388410,145322,91,69849,521
12,4,8,1,17,23826,7524,43,698,546
13,9,4,5,6,512661,8040,101,2987,405
14,9,5,3,21,240837,7492,68,344452,483
22,6,16,8,7,38518,38518,0,0,505
14,9,5,7,13,25030,17476,146,7091,439
32,4,28,2,9,34469,731,258,950,553
11,2,9,0,10,0,0,10,0,709
12,2,10,0,20,0,0,26,980,558
12,6,6,4,23,853825,240599,91,4213,457
24,6,18,3,7,52095,26010,76,1070,513
13,3,10,1,10,7183,2988,2,3394,426
5,1,4,2,12,14975,14975,19,10833,652
9,5,4,0,17,181980,0,0,0,690
16,6,10,1,9,142718,4744,79,11368,462
9,6,3,0,14,217504,0,5,0,546
10,3,7,3,14,29852,29852,153,15096,418
47,10,37,5,14,108624,38560,244,25970,481
6,3,3,2,5,90804,4801,30,662,510
7,2,5,0,3,30246,0,8,0,556
19,12,7,2,14,767855,160742,50,85274,425
51,4,47,0,16,102108,0,12,3100,547
18,10,8,1,15,335982,2332,20,0,489
13,9,4,7,8,41854,22389,97,13428,408
21,3,18,2,8,4237,1296,8,2915,499
11,5,6,5,7,197417,230483,124,37873,425
12,8,4,0,9,452449,0,0,0,631
77,14,63,5,13,1409643,41123,139,14213,427
28,5,23,0,12,21839,0,3,1162,635
6,4,2,0,5,11602,0,1,2481,654
25,12,13,6,9,390392,26468,57,17754,469
23,19,4,19,14,279249,137099,288,13722,414
7,5,2,2,6,29844,16107,32,18999,417
10,5,5,5,15,80451,25291,61,8385,499
38,28,10,0,10,3789249,0,16,2548,607
18,3,15,0,19,103387,0,0,3500,648
16,10,6,1,22,278839,1959,21,1959,561
15,9,6,3,6,376694,5481,43,4980,440
9,3,6,4,9,7908,7895,36,3879,455
7,5,2,1,13,697,697,1,697,527
5,2,3,1,20,38317,8119,9,8119,484
17,6,11,7,17,39401,39421,128,14131,448
21,9,12,7,10,242030,69601,89,18042,452
12,2,10,1,11,12921,1813,2,738,412
11,3,8,1,14,35350,17450,72,2779,621
10,2,8,2,10,4264,18594,89,13411,528
10,6,4,5,6,35025,1337,31,1451,518
15,12,3,9,10,40486,39658,137,7273,461
3,1,2,0,6,1418,0,2,1220,530
20,14,6,0,11,365315,0,1,540,641
5,3,2,1,3,51404,48534,0,0,463
15,13,2,1,30,810105,4726,23,4726,460
8,4,4,4,10,1105617,1230670,65,482837,510
16,5,11,3,8,108919,83294,66,52768,601
48,8,40,4,9,255130,18562,145,4712,492
48,6,42,6,11,15244,12937,209,1818,478
27,3,24,5,19,54315,54315,185,29532,616
11,5,6,2,7,32080,4854,32,0,529
15,6,9,6,14,440082,125353,433,9671,482
6,4,2,4,4,15462,15462,54,4184,460
30,7,23,4,7,10163,7733,132,6585,541
14,6,8,5,12,334230,237487,139,17667,447
11,7,4,0,9,89853,0,15,0,518
6,2,4,2,11,76163,76163,0,491,476
16,6,10,0,12,130075,0,5,0,479
5,2,3,0,9,0,0,0,5860,587
8,5,3,4,10,52511,52369,32,35003,533
17,5,12,2,10,87669,7093,76,2997,541
29,19,10,0,21,3194719,0,2,3317,586
18,4,14,4,11,12312,9982,35,6957,567
9,1,8,1,10,49410,49410,22,0,563
11,9,2,0,13,196946,0,18,0,578
17,12,5,11,11,256921,229806,177,14560,402
31,17,14,0,17,859393,0,7,4838,632
23,8,15,10,11,349006,124112,122,33888,448
74,15,59,14,8,294973,89046,250,13820,410
8,5,3,3,9,37393,35165,149,23481,509
9,5,4,1,4,109968,1060,13,45833,441
18,9,9,6,9,367784,44210,34,18412,501
9,6,3,6,14,41207,197582,0,0,535
14,10,4,3,6,200516,340,76,1592,442
44,14,30,16,8,201348,197666,313,32101,420
18,7,11,1,21,282424,234766,43,2940,501
93,5,88,0,8,667374,0,17,6980,562
77,12,65,13,21,363129,281165,45,37854,494
14,5,9,5,9,28211,38125,37,15215,392
4,1,3,0,3,0,0,0,315,650
4,2,2,2,9,10313,2623,23,190,519
62,10,52,4,13,441731,23325,103,6090,464
5,3,2,2,7,197537,14473,29,9768,455
50,12,38,10,12,141380,97062,278,10253,424
77,6,71,1,19,331149,28998,145,28998,423
19,3,16,1,9,85216,16996,53,2186,455
6,4,2,2,11,9068,6070,57,5074,434
9,6,3,1,4,368636,504,16,504,522
6,4,2,4,9,335759,27887,0,0,486
57,8,49,7,11,66953,16187,93,3880,593
16,5,11,4,16,40265,40265,70,29643,488
43,6,37,1,14,60016,267,23,900,566
21,5,16,6,18,21332,13070,54,4311,442
6,4,2,0,9,27389,0,3,3022,614
9,5,4,1,7,130281,1979,14,724,660
50,13,37,6,19,833730,313911,54,34424,416
15,12,3,8,7,93391,69337,156,23136,492
14,9,5,10,11,1455999,1791010,119,45458,469
10,4,6,4,7,17575,17575,53,3527,470
3,1,2,0,9,0,0,4,720,641
21,13,8,7,9,195242,12016,62,3633,425
19,11,8,0,7,2094124,0,4,0,526
33,12,21,9,9,387416,146155,127,85411,423
26,11,15,7,11,29358,29358,161,5480,459
20,9,11,8,14,76828,63912,213,19247,508
7,3,4,0,8,75573,0,7,0,644
23,10,13,11,19,173941,185596,328,33600,465
5,3,2,0,13,20059,0,14,1,658
4,1,3,0,3,10454,0,1,260,614
34,13,21,11,10,120186,117358,308,34388,406
71,16,55,6,13,239801,24819,392,11688,478
9,7,2,0,12,206094,0,0,0,592
19,3,16,4,13,69825,26809,30,7799,459
4,2,2,2,7,7780,7780,37,5284,572
12,10,2,8,10,360485,60644,0,0,451
43,9,34,7,11,491142,88729,227,16520,481
7,2,5,0,6,134865,0,0,0,606
36,25,11,1,12,2173194,1556,16,11419,519
21,5,16,1,11,51295,2083,10,0,598
17,12,5,14,7,55266,80289,190,23687,439
18,9,9,4,12,88193,8252,26,1997,491
23,9,14,0,13,2925024,0,1,6139,629
15,6,9,7,8,32935,28786,74,7493,493
5,2,3,2,8,11766,1944,26,0,543
22,7,15,6,14,51010,43173,26,15860,486
14,3,11,4,7,25932,29396,293,12921,442
23,8,15,0,10,89158,0,0,204,562
9,4,5,3,9,67874,21676,52,541,511
16,1,15,0,15,0,0,4,18986,542
2,0,2,0,12,0,0,0,0,502
16,10,6,1,10,405651,2531,18,472,583
29,10,19,0,14,658605,0,14,950,558
37,15,22,10,8,114500,101178,643,11447,406
17,7,10,3,13,41862,12579,19,3566,443
5,3,2,2,8,498553,30462,91,1096,470
38,8,30,5,10,82750,58974,70,44390,476
21,4,17,0,11,93196,0,0,0,641
8,5,3,5,7,13853,13853,162,8031,412
111,15,96,6,14,356466,10195,422,4260,546
10,8,2,4,6,226689,12804,27,7985,432
24,11,13,0,12,80743,0,8,185,616
4,2,2,0,2,26719,0,96,1682,606
50,27,23,27,12,1022033,490904,232,79336,468
14,8,6,2,8,537923,3150,5,2599,495
25,7,18,6,12,53140,39107,425,9030,507
27,16,11,7,10,107641,43707,179,11933,474
20,8,12,0,14,599636,0,3,0,720
20,8,12,1,26,323879,67335,72,0,551
4,2,2,2,8,33482,28733,34,18283,507
51,11,40,0,15,637896,0,26,623,565
26,17,9,13,10,65579,48931,221,9423,381
218,12,206,4,9,95413,7286,56,7022,510
23,8,15,7,13,65312,51464,132,12110,477
21,8,13,7,17,420436,362976,110,6608,427
9,4,5,0,18,2675,0,2,0,637
42,10,32,5,6,56392,21712,63,16048,461
19,6,13,3,18,329635,9887,137,6670,512
31,13,18,11,10,182200,207523,0,0,466
40,8,32,3,20,515143,45930,31,13804,436
19,4,15,5,31,83466,63709,92,28585,449
11,8,3,1,8,1290372,29400,8,0,553
20,5,15,0,8,132361,0,13,0,675
12,2,10,3,7,192146,152859,51,252,550
14,8,6,0,4,157265,0,2,0,463
27,9,18,0,20,413463,0,2,1881,620
31,13,18,6,7,739468,31725,95,1350,436
14,8,6,3,19,72593,31044,35,6260,670
3,1,2,0,7,0,0,0,0,663
43,12,31,6,15,86786,21975,180,10496,458
24,10,14,0,13,165887,0,2,1253,581
59,9,50,4,8,439407,9478,66,8502,501
17,4,13,1,16,288562,228931,39,11485,600
7,3,4,2,6,19062,11543,0,0,542
15,6,9,3,18,65102,30292,89,18547,480
16,4,12,5,15,15656,22268,68,2897,478
9,6,3,4,11,48984,26754,72,8677,447
9,3,6,2,12,100357,13228,29,900,555
21,13,8,2,21,833172,1605,33,28,506
10,7,3,4,11,40333,30844,118,20293,405
11,7,4,7,14,12028,16686,33,1489,435
24,9,15,1,13,361742,959,31,959,474
48,7,41,3,24,328678,30681,71,19158,550
15,1,14,0,6,0,0,4,0,485
5,2,3,2,9,3287,8613,59,3287,555
20,2,18,2,16,14540,14540,61,7270,678
7,5,2,0,9,298807,0,0,0,592
10,5,5,5,10,59885,70897,98,30105,415
22,6,16,0,13,36241,0,11,0,628
14,5,9,0,6,185520,0,18,1275,582
8,5,3,7,15,42676,68523,116,31050,464
14,3,11,0,3,23497,0,0,1110,551
9,4,5,3,7,26402,26402,357,23013,463
15,6,9,4,10,388846,43062,102,0,462
30,13,17,2,12,231570,3264,115,1878,508
25,15,10,12,10,93235,93235,226,23981,470
45,8,37,11,14,96421,70585,235,7100,475
14,3,11,2,7,3887,1424,15,484,477
7,3,4,1,8,11638,9159,46,0,548
8,6,2,1,12,300020,1580,5,0,569
19,8,11,5,23,337225,53213,80,1351,496
28,5,23,3,9,72008,63265,66,44850,466
14,5,9,5,6,23217,18607,58,10082,436
20,11,9,13,9,375227,133537,151,7092,439
65,20,45,5,14,121960,857,9,1146,485
3,1,2,1,14,21200,21200,24,21200,595
31,16,15,5,12,661354,143796,126,3513,510
9,6,3,5,7,324708,19946,50,5349,503
9,2,7,0,14,7441,0,0,0,671
18,10,8,3,13,38106,8619,56,7685,440
9,4,5,1,12,365747,1090,23,5173,583
11,7,4,6,19,124076,119795,98,76840,447
14,4,10,2,17,16992,16992,140,15452,494
10,6,4,5,18,112756,55873,73,16602,531
12,1,11,2,15,22788,25756,38,22788,506
25,7,18,2,10,29315,6357,80,5283,524
6,2,4,0,18,3500,0,0,258,686
19,5,14,3,11,26649,12412,16,6678,488
63,7,56,2,18,947160,93992,107,91110,486
15,5,10,2,13,22714,10844,47,8941,432
6,3,3,4,8,37544,33719,76,11408,480
13,1,12,2,16,1800,10402,79,21335,518
8,3,5,0,8,209681,0,8,1006,619
19,5,14,1,11,40149,596,14,2960,506
11,8,3,3,14,37945,12406,0,490,526
9,5,4,2,13,36666,14273,21,9787,621
40,10,30,10,9,175067,151221,168,111,469
31,3,28,1,13,213880,6745,2,6745,646
3,1,2,1,6,9738,9523,4,0,672
19,11,8,2,7,348727,9165,56,9109,514
10,8,2,0,7,855332,0,0,0,517
6,4,2,3,10,129674,129468,70,107284,494
5,3,2,0,10,95832,0,0,0,686
91,12,79,3,18,173645,10418,25,8338,551
8,3,5,2,7,9498,5204,133,4850,594
15,6,9,4,15,61928,43201,34,26591,486
10,5,5,3,6,17102,13666,39,8500,491
7,3,4,0,13,151537,0,6,0,743
2,0,2,0,2,0,0,3,3548,577
33,5,28,4,15,126625,29437,58,5996,503
124,19,105,11,14,526589,317083,164,175051,414
9,4,5,3,28,116558,91005,50,0,519
18,7,11,2,5,126164,11989,97,896,440
6,3,3,2,16,10031,4251,0,8311,651
12,9,3,8,19,201498,186406,173,65643,488
7,5,2,4,17,419547,64492,307,15957,525
16,7,9,6,17,542165,51448,194,15811,465
10,7,3,3,7,42410,11743,13,4427,416
10,7,3,1,24,250411,100,23,2229,599
27,10,17,8,8,248835,96982,86,8040,470
14,3,11,1,10,14851,750,1,55,458
22,5,17,2,7,65341,790,58,1093,567
10,3,7,3,10,797146,118192,40,0,491
28,3,25,4,14,37762,37762,58,21810,570
42,6,36,1,7,63890,273,62,829,608
12,7,5,1,19,270467,51195,4,199,529
7,4,3,0,8,49894,0,2,1153,645
8,4,4,3,6,31635,7466,73,4900,486
17,7,10,1,11,321266,750,58,0,582
19,10,9,0,10,1005221,0,3,0,495
14,7,7,0,8,301942,0,52,0,492
6,2,4,3,14,78159,78159,46,12120,606
10,4,6,4,14,38521,38521,150,15096,445
5,2,3,2,11,12255,1785,39,497,542
6,4,2,0,3,34364,0,4,0,484
8,5,3,5,8,17309,17309,347,13435,519
15,9,6,1,13,415336,5123,16,0,630
23,9,14,0,18,487072,0,1,965,621
8,6,2,3,9,323981,17989,66,8724,477
12,7,5,2,17,664292,15035,46,16234,530
17,4,13,3,9,24886,4927,11,7218,485
20,7,13,7,8,280397,448154,0,0,467
18,13,5,2,18,218466,18058,128,8248,483
22,9,13,1,13,1472562,2027,18,0,571
13,9,4,7,17,33066,23942,88,17457,447
20,8,12,0,26,882068,0,57,2673,450
8,6,2,0,7,153093,0,0,0,621
17,10,7,0,14,614819,0,22,0,628
4,2,2,2,13,66574,44321,0,0,578
19,6,13,2,8,83469,1182,163,2113,511
10,3,7,1,15,427579,6501,0,0,543
10,8,2,2,17,328721,7913,8,7123,460
31,11,20,4,14,262615,18028,42,5605,465
28,6,22,7,10,554721,127714,128,23578,451
12,3,9,1,14,1056,534,26,59,542
9,5,4,2,10,29325,24572,45,0,542
14,7,7,5,12,31082,28072,101,12010,464
27,11,16,5,13,312876,239013,55,91200,447
8,6,2,6,7,23236,34280,103,17593,619
9,5,4,2,8,304970,60591,45,44927,528
10,6,4,4,13,484623,37518,11,7003,433
15,12,3,7,16,118684,64675,77,11732,436
5,3,2,1,6,26025,4497,10,4497,533
6,3,3,3,19,30790,22801,54,2800,507
26,5,21,0,13,425912,0,147,1679,434
52,10,42,2,21,51319,7558,44,10567,457
14,9,5,0,8,392030,0,1,220,685
5,1,4,0,13,326298,0,0,0,657
13,5,8,0,7,53152,0,0,0,550
20,8,12,0,13,442882,0,76,5931,664
15,9,6,5,19,271056,23924,154,7427,434
13,9,4,7,5,62832,38570,267,10154,449
11,2,9,0,16,392694,0,23,432,562
21,7,14,5,15,162967,34561,42,8933,459
6,3,3,2,7,19429,15644,47,9191,517
3,1,2,0,8,0,0,0,716,739
7,4,3,0,4,42821,0,0,0,642
32,8,24,0,9,214649,0,7,0,560
6,4,2,3,6,45831,38588,7,4980,463
3,1,2,0,28,8029,0,0,1064,632
7,4,3,3,4,2570,2570,29,1963,435
42,11,31,2,13,543364,323482,216,4558,654
20,3,17,0,6,6835,0,12,3398,549
6,4,2,2,8,155442,4645,6,1916,499
13,6,7,5,11,175942,75442,108,46013,459
10,3,7,1,19,420,21314,19,0,656
52,9,43,0,16,445378,0,70,1999,479
22,16,6,1,18,566756,1764,27,2708,587
21,8,13,2,11,178835,11272,32,1350,532
16,6,10,3,23,1659796,1358803,57,449,481
29,4,25,4,13,27129,27129,34,6480,547
9,2,7,1,7,14280,92,16,246,561
3,1,2,0,21,0,0,0,3050,666
25,8,17,4,9,31494,11585,206,5994,463
61,2,59,0,11,24424,0,250,3607,676
6,4,2,0,14,497647,0,2,1763,499
6,3,3,2,6,3339,14412,20,14169,485
24,19,5,0,27,702164,0,0,0,677
33,14,19,5,19,203202,77025,179,44793,476
10,3,7,1,8,39106,1541,41,1541,514
7,5,2,0,6,334395,0,0,0,540
15,10,5,2,23,301608,185247,18,0,542
13,6,7,8,15,172408,182275,168,0,453
205,25,180,9,16,988613,22886,87,7050,414
10,5,5,2,4,16362,1671,100,2067,462
25,10,15,9,7,331603,318599,245,20675,420
8,4,4,1,7,21346,8265,2,8265,664
7,4,3,2,9,5007,2507,31,1875,537
7,5,2,1,10,95557,3469,30,904,539
42,14,28,9,16,271839,31708,86,13219,436
3,1,2,2,10,1425,46283,12,1425,573
3,1,2,1,5,758,7499,22,7499,510
5,3,2,1,5,197896,21410,22,21410,675
7,5,2,1,7,21032,2467,18,2467,522
10,7,3,7,9,90920,69526,110,5923,476
3,1,2,1,7,6101,6101,11,6101,642
10,7,3,3,10,160109,117229,32,12426,512
18,14,4,12,11,431365,234277,271,21288,446
36,7,29,4,11,119040,85489,160,7439,455
19,6,13,9,14,50951,56067,116,17976,447
12,2,10,1,7,18299,6800,84,6800,644
15,10,5,11,8,107213,129954,290,19695,414
13,10,3,9,19,63740,63033,429,20097,446
38,11,27,8,12,191417,127672,134,19917,447
13,6,7,5,14,184367,55772,31,27626,446
34,17,17,12,8,705398,248686,161,14573,413
22,5,17,0,10,20134,0,1,0,620
18,7,11,4,13,91733,22651,56,10366,382
7,4,3,1,6,148683,73663,12,0,508
37,10,27,5,9,47771,33605,56,7248,403
13,7,6,6,24,77934,180469,153,73975,394
47,15,32,2,19,45721,13406,46,12254,518
23,12,11,0,12,814035,0,1,3790,571
6,4,2,1,41,17503,8839,8,1253,515
27,14,13,0,12,604688,0,26,833,562
15,9,6,6,5,140136,59255,236,18268,404
16,3,13,2,8,32486,32486,35,5306,517
13,4,9,1,4,21627,1192,1,1192,489
12,5,7,2,13,296413,17617,25,8674,411
20,3,17,1,18,38581,843,10,3166,468
9,5,4,0,11,94717,0,97,4154,468
43,10,33,2,12,342392,32908,74,9359,509
14,6,8,1,7,122614,1439,2,292,590
10,5,5,2,24,18480,3194,6,6658,431
13,2,11,5,6,33422,57189,47,0,493
5,1,4,0,7,3993,0,4,4587,558
36,8,28,2,13,295714,11730,117,9916,567
10,2,8,1,8,2306,2747,1,380,545
15,4,11,0,14,251582,0,82,8167,495
19,4,15,4,14,617987,56923,133,23613,617
18,9,9,1,6,408600,364,7,611,445
11,7,4,0,6,27147,0,56,343,647
5,2,3,2,9,16810,16810,4,13413,600
6,3,3,2,16,419896,21618,0,0,521
12,7,5,4,10,466841,52320,72,12725,473
8,4,4,3,12,94561,33727,40,3641,521
28,4,24,2,20,404319,9489,21,7939,502
8,3,5,1,13,15913,15646,42,0,466
24,12,12,0,16,667124,0,0,0,697
7,4,3,1,6,10606,512,0,0,500
6,0,6,1,9,33269,33269,0,0,603
6,4,2,0,14,119682,0,0,1625,627
24,13,11,9,38,620117,48821,126,11025,380
6,4,2,4,12,551948,8301,80,11449,534
29,5,24,3,9,52148,50150,73,3647,540
11,8,3,3,13,674047,38341,61,18796,470
16,5,11,1,11,25280,2065,1,5416,526
12,10,2,9,9,80426,31447,61,6927,355
22,8,14,3,8,44359,28174,15,13504,537
18,5,13,4,7,26015,22559,44,10661,415
19,10,9,1,9,484410,3817,18,0,463
26,11,15,0,17,1601184,0,0,0,708
5,3,2,3,8,47831,47831,75,0,484
19,12,7,0,21,452919,0,2,0,618
11,2,9,0,12,664519,0,0,0,663
5,3,2,1,2,72746,512,122,1523,599
18,9,9,2,5,71639,3900,14,2246,425
5,3,2,3,10,11580,11580,14,8134,504
12,3,9,2,17,9407,56112,31,779,529
8,5,3,3,8,242411,15300,26,1103,488
13,4,9,0,11,37316,0,173,5440,588
13,5,8,1,10,44927,16877,5,16877,593
17,13,4,3,11,589823,20168,16,0,498
15,3,12,3,15,110181,133152,44,1448,494
11,9,2,2,13,830354,8364,30,0,447
20,6,14,0,7,336576,0,7,0,501
16,8,8,0,12,293026,0,2,0,653
15,10,5,1,12,195350,12813,25,12813,654
3,1,2,1,10,31952,31952,0,0,534
20,13,7,9,9,132781,108454,10,6085,442
5,3,2,4,6,23122,23122,75,10816,457
10,4,6,0,2,395196,0,1,3300,591
4,2,2,1,10,8600,8600,9,8600,574
35,10,25,5,8,1547482,24773,239,8968,420
10,5,5,4,13,21436,21436,39,14079,510
6,1,5,2,7,11942,6843,16,2700,531
11,4,7,5,9,19515,15999,79,11109,400
14,9,5,4,9,52268,9290,16,8434,443
15,9,6,5,18,145049,65758,24,4218,456
7,2,5,2,8,2688,95001,0,0,553
19,9,10,10,9,80221,94949,112,20805,407
20,5,15,4,8,67023,67023,24,8911,544
15,5,10,2,12,11257,9917,30,4114,520
16,4,12,3,9,13952,11946,45,7428,475
13,7,6,2,18,47383,28474,56,3720,408
39,18,21,11,13,97552,40484,72,8115,453
10,4,6,7,9,66278,116077,14,31983,466
12,8,4,7,10,46944,31299,55,9626,423
17,2,15,4,15,1400004,128566,86,36468,481
18,9,9,7,13,104557,103369,101,34478,422
18,10,8,13,13,56930,123746,214,19953,436
61,23,38,7,16,614358,25278,101,14466,437
7,5,2,1,4,79475,1620,2,0,522
8,3,5,2,6,33734,2096,16,2565,548
23,6,17,3,5,36485,8769,279,5594,475
47,29,18,0,10,2077498,0,36,0,567
6,2,4,2,8,2710,5420,45,2710,554
23,9,14,4,18,529473,75769,33,25458,444
6,3,3,2,11,6574,6574,52,3287,568
6,4,2,3,8,7871,4672,15,2050,449
14,10,4,4,6,232272,28553,51,2705,488
96,11,85,7,15,589958,217940,194,72663,438
9,3,6,2,12,18804,8241,31,4506,656
29,12,17,3,10,146109,26482,92,13569,432
25,13,12,0,16,604382,0,4,0,623
55,15,40,4,20,699562,48731,130,21942,439
13,9,4,8,30,522863,110882,122,19180,444
8,3,5,6,7,86983,182647,68,0,576
8,1,7,1,3,0,1586,10,4727,602
15,2,13,3,13,45787,57174,69,18956,548
37,4,33,2,13,33439,29751,32,3141,516
17,11,6,10,16,17002,23213,143,5592,449
10,8,2,3,5,29293,7813,52,4581,595
37,6,31,1,17,347284,39935,16,4380,493
21,7,14,5,8,21476,14493,46,4690,417
102,2,100,1,11,7167,6357,96,12714,652
31,6,25,2,19,159123,10795,37,8861,496
19,10,9,8,14,64769,49758,105,21155,404
23,9,14,8,11,197094,199590,93,8592,443
13,3,10,0,13,72897,0,9,8059,508
67,14,53,0,13,404757,0,243,2322,486
18,7,11,1,12,73264,8188,5,8188,633
20,11,9,3,14,158056,28709,31,647,480
4,1,3,1,3,2979,2979,4,2979,525
8,3,5,1,9,10199,9661,37,508,557
9,6,3,6,6,15623,11591,21,0,494
30,5,25,2,15,47072,35959,15,34749,529
63,10,53,6,12,57391,29524,38,4857,523
8,4,4,3,5,678,63368,30,426,461
5,2,3,2,9,4137,5082,41,5933,590
13,5,8,2,14,376111,20159,38,1761,531
33,7,26,7,7,118153,30891,124,8582,429
16,9,7,0,8,457194,0,5,0,607
25,5,20,1,9,36014,3766,11,4976,462
56,12,44,9,18,109810,66486,145,6641,425
19,9,10,0,28,593707,0,2,0,676
3,1,2,1,8,625185,5026,0,0,642
25,8,17,4,11,99740,46087,84,3212,492
27,10,17,8,13,53653,53146,34,14001,433
10,5,5,5,8,22045,31522,43,9332,394
21,10,11,1,14,124011,7448,0,1730,543
10,8,2,3,13,127324,18479,14,0,456
15,8,7,5,9,389246,45039,44,19368,484
17,8,9,6,14,193804,149304,33,59238,502
5,1,4,1,12,0,6622,0,0,492
6,4,2,4,7,27031,13808,30,8354,560
14,6,8,4,10,187249,187249,94,15393,446
14,9,5,0,4,110538,0,7,110,674
9,7,2,7,9,394012,34257,118,0,478
18,8,10,1,10,73028,50,28,462,504
28,4,24,0,15,30850,0,4,4790,544
20,8,12,3,20,370833,109390,42,0,501
29,11,18,12,14,472881,188062,22,61038,449
8,6,2,2,8,37891,3829,3,683,477
12,6,6,3,10,254075,31766,39,19500,482
39,14,25,17,16,817444,1187006,75,414006,341
33,5,28,4,11,70450,58369,211,25935,484
9,5,4,6,7,42827,49703,140,15803,425
17,7,10,4,8,68683,20263,50,13918,462
30,8,22,1,9,43535,278,12,658,464
17,8,9,10,17,177544,214182,71,37930,499
4,2,2,2,8,49294,69257,28,0,483
7,4,3,2,6,55236,28274,30,21067,444
9,4,5,1,20,171431,1447,11,9685,523
2,0,2,0,1,0,0,0,0,613
19,3,16,1,9,7582,890,9,4270,531
22,5,17,4,5,24294,12353,0,0,449
15,8,7,4,13,535903,8916,36,4184,433
14,3,11,3,17,89499,89499,60,36651,475
11,5,6,3,6,103900,1446,83,543,578
16,9,7,0,15,756414,0,18,0,498
45,11,34,3,17,66522,26357,89,15501,474
6,4,2,0,3,25671,0,1,0,550
7,5,2,0,6,426726,0,0,0,696
22,10,12,8,14,138916,46209,46,12596,418
15,9,6,7,14,133168,130586,381,113151,457
20,2,18,3,12,54800,54800,51,25717,475
18,7,11,4,19,206066,11199,45,6462,452
59,10,49,2,14,58681,5033,327,4462,436
13,4,9,3,12,25487,15854,24,9837,473
7,4,3,5,8,256106,255219,140,686,490
7,1,6,2,5,13530,17744,46,13530,573
3,1,2,0,3,16828,0,0,1501,612
4,2,2,0,9,33130,0,23,1201,601
58,19,39,0,28,94221,0,5,2110,592
15,10,5,0,12,148926,0,0,0,697
49,9,40,3,14,57783,7251,104,6716,522
16,10,6,0,4,206737,0,0,0,652
23,7,16,5,12,72736,28703,28,9321,549
36,4,32,4,11,30084,54239,350,4563,536
28,5,23,3,7,30331,21117,121,12113,484
21,7,14,3,6,145937,42487,68,0,506
35,7,28,1,17,204450,23856,106,23856,434
20,10,10,6,10,510337,303725,112,10841,484
22,10,12,0,14,916985,0,9,0,641
15,10,5,7,11,126010,69086,251,3298,427
9,4,5,0,7,12390,0,27,5137,482
5,2,3,1,7,19006,9568,37,0,554
21,7,14,0,22,511604,0,5,0,594
7,4,3,0,8,40902,0,23,7378,515
12,6,6,0,20,57122,0,2,0,627
39,2,37,3,6,5345,4270,19,3526,454
9,5,4,0,10,1120383,0,18,0,489
7,5,2,1,6,61881,1414,0,0,570
22,6,16,5,7,86395,35348,78,19675,416
5,3,2,3,8,74396,10121,1,529,555
47,3,44,3,10,52382,52382,89,1350,518
20,13,7,11,11,295318,89228,82,29201,402
25,14,11,8,14,723970,189204,49,9460,446
10,8,2,2,14,114040,27912,24,4333,526
17,8,9,4,16,384505,37955,66,18536,442
43,6,37,0,7,28492,0,19,1390,549
5,3,2,0,4,51584,0,4,3103,577
8,4,4,6,8,33087,38783,82,9821,441
16,8,8,6,8,82097,33170,332,17920,433
3,1,2,1,11,1132,1132,8,1132,532
12,3,9,3,8,10348,140203,81,4622,486
11,4,7,2,11,16874,3015,85,1994,523
21,4,17,4,12,249971,249971,309,212443,469
4,2,2,0,2,23067,0,2,212,591
23,18,5,16,9,1979079,394203,229,0,497
33,5,28,4,13,39747,39747,284,23347,506
4,1,3,2,8,70750,70750,13,0,588
6,2,4,2,6,18249,8536,8,611,370
44,24,20,13,33,2457336,401373,91,0,493
17,6,11,7,12,97782,75089,128,3590,432
36,9,27,4,9,476796,35439,21,14992,427
16,7,9,2,13,798688,298268,98,12216,509
15,9,6,1,3,906250,1814,4,1814,549
8,4,4,2,13,733031,30203,45,0,516
15,5,10,3,10,86077,24749,30,6789,509
25,6,19,3,13,62112,48482,13,1677,443
6,3,3,4,7,30970,36831,89,0,506
4,2,2,0,3,37954,0,6,1555,555
73,5,68,3,10,28891,397501,53,3804,500
14,12,2,7,7,629766,11341,21,4102,466
12,8,4,5,3,102183,11493,47,3361,355
13,5,8,3,15,184896,15321,16,3987,500
9,7,2,1,14,318107,9708,11,0,569
13,4,9,0,6,21586,0,138,990,484
20,6,14,4,17,12919,10419,87,7605,571
9,1,8,0,13,0,0,23,552,741
29,7,22,4,14,425814,42866,77,19523,527
19,12,7,5,14,287665,4643,7,0,587
58,18,40,10,8,73865,80311,162,26736,461
17,12,5,2,23,355567,106418,36,0,589
5,3,2,1,8,21415,21415,45,1365,520
10,4,6,5,10,150620,37345,41,5791,466
9,5,4,3,11,25470,25470,216,17336,450
13,6,7,3,10,18026,4855,28,2960,526
6,4,2,3,12,53262,24612,32,0,475
21,6,15,6,15,141947,151173,56,14004,517
7,4,3,6,11,39790,58984,102,0,478
12,5,7,3,13,38018,7596,32,3030,443
17,11,6,5,7,59758,37214,86,6268,466
8,2,6,1,10,81302,10112,33,10112,560
11,8,3,2,10,25836,7777,23,362,486
11,1,10,2,13,1042,17027,0,0,560
36,10,26,11,13,225834,201826,139,3880,437
19,7,12,2,8,1992555,893,25,477,566
28,7,21,3,19,56482,12047,37,7029,507
13,7,6,5,10,20577,20378,41,4805,450
13,4,9,6,13,35487,133051,0,0,495
7,4,3,0,9,375010,0,36,0,531
11,8,3,4,18,167991,137055,54,124277,402
9,6,3,5,12,74727,14961,31,7300,546
10,6,4,7,14,17755,25862,108,9736,521
7,5,2,3,3,70913,8066,6,0,393
9,5,4,0,32,568760,0,0,0,722
8,5,3,0,7,269359,0,4,0,592
3,1,2,0,1,11368,0,0,0,602
16,9,7,8,12,389738,281809,244,0,518
20,10,10,5,8,45946,12052,86,6492,442
15,8,7,7,15,56139,48315,101,21579,435
10,4,6,0,14,88950,0,0,0,657
25,11,14,4,13,178100,46080,29,573,489
3,0,3,0,12,0,0,0,0,647
9,6,3,0,7,251735,0,2,643,563
18,16,2,5,5,735919,65744,16,0,448
14,6,8,6,11,13802,28391,71,4702,477
10,6,4,1,18,41474,291,28,5405,491
9,4,5,4,9,37749,23090,87,6915,522
27,5,22,2,69,92515,12928,24,12869,462
6,2,4,3,9,53133,71392,36,38803,507
20,5,15,3,10,12427,6174,285,5809,485
19,4,15,4,7,73499,74554,89,7507,465
7,0,7,0,9,0,0,3,72,571
6,2,4,2,7,11466,30734,35,693,647
14,6,8,4,35,42950,30226,299,14632,472
25,9,16,8,10,105776,132016,46,36662,399
11,7,4,3,13,187289,69579,49,19597,469
12,7,5,0,9,128353,0,0,0,653
14,11,3,0,9,384379,0,1,375,487
9,2,7,0,10,19956,0,0,0,640
27,13,14,6,17,310417,50291,48,12867,369
100,4,96,4,10,436145,47394,36,21156,480
7,1,6,1,9,8965,8965,96,8965,625
42,4,38,3,11,21511,8796,57,6843,504
13,7,6,1,14,375914,11198,15,11198,411
10,6,4,4,25,55804,54922,75,41174,434
36,13,23,8,8,80047,99808,73,29318,462
17,8,9,0,14,193035,0,59,621,494
7,4,3,1,14,48848,2429,98,4758,498
5,1,4,1,11,1522,1522,19,1522,600
22,7,15,1,7,93992,25894,10,25894,482
13,10,3,1,10,413362,3048,26,2710,459
9,2,7,0,12,40835,0,0,0,612
11,4,7,2,9,23387,15390,125,10013,506
6,4,2,4,34,143848,75252,47,19224,440
28,12,16,6,13,95021,53818,0,0,459
9,7,2,7,9,329874,67197,134,11048,434
23,3,20,2,14,20817,20817,31,20627,486
39,20,19,1,16,667608,2684,67,749,469
16,9,7,6,10,26157,27682,71,7998,458
39,8,31,5,15,68854,10068,108,1691,423
27,18,9,0,22,1274961,0,6,0,611
17,5,12,0,12,475529,0,3,0,612
21,9,12,2,12,383180,21365,36,12729,452
6,1,5,1,5,3181,3181,5,3243,556
13,8,5,3,7,354727,5333,46,2690,460
14,11,3,0,8,266143,0,0,0,657
34,12,22,8,12,75262,74161,208,19170,413
9,4,5,2,8,8447,1521,134,4539,471
34,22,12,6,12,544411,199069,133,29763,379
24,12,12,8,10,757933,88145,327,20370,415
27,12,15,7,12,735756,75922,247,12999,517
6,3,3,0,8,541805,0,0,0,587
5,3,2,2,19,30422,1072,26,536,608
6,2,4,1,18,31092,31092,31,470,609
23,8,15,0,9,34676,0,52,874,524
15,5,10,1,21,225781,1208,13,1208,428
103,25,78,12,12,764029,85712,222,12226,418
6,4,2,0,8,11984,0,29,0,574
13,8,5,7,15,423304,55604,101,16800,486
76,9,67,3,17,93717,7092,66,2484,468
25,8,17,5,11,97099,26605,0,0,580
30,7,23,0,9,24894,0,116,2774,595
25,5,20,2,13,49950,727,86,6809,612
43,6,37,2,17,29399,14381,73,10774,394
28,3,25,1,9,5898,3050,140,17129,610
20,8,12,4,18,288548,18499,60,14182,490
11,6,5,3,17,52678,20720,50,15520,480
3,1,2,2,10,29131,28766,27,10231,508
21,6,15,4,13,303172,29722,88,18117,521
4,2,2,1,7,3276,3276,24,4226,505
11,5,6,8,17,1130683,838226,142,65345,480
22,8,14,5,27,513694,18519,99,6376,417
4,2,2,2,2,27147,24364,26,0,494
241,10,231,7,10,51132,43075,163,6848,455
13,4,9,1,14,34696,1195,51,1063,463
18,5,13,5,8,77820,51917,58,2921,493
12,4,8,0,3,13187,0,1,0,544
9,4,5,0,7,193,0,23,0,692
8,3,5,2,7,1810,1810,36,2200,575
10,8,2,5,6,627606,125643,0,0,440
13,7,6,3,14,618044,21412,97,8599,521
7,2,5,2,12,19699,14756,41,14430,470
31,7,24,7,17,38302,44403,125,11030,611
17,6,11,4,17,31728,17449,2,1609,494
23,13,10,2,18,753449,14192,29,1684,489
9,5,4,4,8,24086,15098,129,17718,512
34,8,26,4,13,57193,18043,6,64660,567
11,5,6,8,6,1240258,1240258,56,262,472
6,4,2,1,10,161623,10958,7,11111,448
6,3,3,0,3,84329,0,0,0,658
14,5,9,2,5,400600,11922,73,0,525
5,3,2,0,3,33003,0,1,380,584
16,9,7,11,8,62924,79260,173,40113,434
24,5,19,3,15,124770,120826,71,93484,406
18,3,15,1,9,1300,400,11,3350,517
6,4,2,3,12,7942,7942,18,4976,501
33,10,23,9,6,35734,52585,514,10550,489
17,7,10,2,7,173139,12155,205,5676,458
10,7,3,0,5,42269,0,5,43,623
14,10,4,0,7,146396,0,4,424,639
15,9,6,9,8,311827,95872,111,18500,449
19,17,2,2,7,60574,2631,9,1741,491
20,9,11,5,8,27626,26067,75,8468,488
9,2,7,3,16,18674,36991,40,357,504
19,8,11,4,20,117901,90753,215,84958,534
5,1,4,0,5,1557,0,2,178,603
12,5,7,1,14,213327,24926,13,24926,453
12,8,4,0,9,495468,0,34,0,530
31,9,22,2,19,398812,1958,17,2140,443
27,9,18,2,14,292853,8604,21,1237,470
7,4,3,4,18,18106,18106,116,10615,486
8,6,2,0,5,35553,0,3,0,547
34,8,26,4,7,257419,15699,16,7233,510
7,3,4,1,16,10246,9472,0,0,583
16,5,11,3,16,20330,8166,9,7117,466
35,19,16,0,69,799763,0,151,2377,562
7,4,3,5,7,396055,47531,72,17720,488
19,5,14,5,13,191679,149152,48,22667,455
7,5,2,0,8,869,0,53,2569,525
5,1,4,2,7,0,29390,0,0,593
5,2,3,2,9,22299,7540,67,4382,525
9,5,4,1,7,193117,433,42,433,491
10,2,8,4,9,86420,105753,48,0,532
13,11,2,1,12,387790,11310,23,0,470
16,10,6,1,26,426998,405,19,0,578
8,6,2,5,8,20907,18039,310,13666,475
5,1,4,4,6,4141,30661,0,0,651
29,7,22,7,14,112525,117963,92,69684,504
212,17,195,9,15,160232,21653,76,1455,453
30,14,16,1,23,632662,3334,14,7158,526
7,4,3,3,8,32221,35092,0,0,626
5,3,2,5,4,10053,12945,46,5944,608
7,2,5,3,25,784243,1123708,51,0,490
6,4,2,3,13,40895,38112,47,149,461
24,4,20,3,12,895931,16769,71,11589,514
17,6,11,2,15,575115,31820,32,1227,520
8,6,2,0,17,218416,0,6,2200,611
12,6,6,3,5,51069,26923,52,19564,484
11,5,6,4,9,91090,91090,245,8771,469
35,8,27,3,14,10849,10849,64,11445,466
22,6,16,6,14,561467,121502,2,34308,455
13,9,4,0,11,243012,0,0,0,602
12,6,6,1,4,7774,5075,28,0,491
6,1,5,1,4,25080,9028,23,9028,437
8,4,4,1,3,21485,11833,15,2635,490
24,8,16,2,16,103168,5146,35,3438,590
19,7,12,0,10,1537774,0,14,0,620
20,14,6,0,37,170973,0,7,848,690
8,0,8,0,10,0,0,0,2079,645
46,15,31,12,12,1240420,49821,95,12419,443
5,3,2,0,9,427906,0,0,0,621
25,13,12,0,15,181370,0,74,780,583
34,10,24,3,12,42468,23745,22,10440,424
17,7,10,4,5,207358,22021,137,5209,419
13,8,5,5,7,365526,42246,61,14091,402
4,1,3,1,7,3205,3205,5,3205,525
12,8,4,1,11,27616,993,45,993,623
15,10,5,1,28,558318,96695,60,1959,551
19,12,7,5,6,117763,2623,13,852,569
5,3,2,2,10,14415,11702,12,9648,516
25,15,10,7,12,487018,62791,0,0,544
15,1,14,0,13,7263,0,0,0,682
5,3,2,3,4,5217,5217,31,2605,523
28,18,10,8,14,730421,109171,141,24691,478
50,9,41,5,15,650041,43553,380,35154,455
13,8,5,7,7,275324,33307,53,17272,446
22,9,13,2,13,287162,26566,34,0,556
16,7,9,3,26,124140,28652,142,12200,461
6,3,3,2,10,243079,10142,18,12762,383
14,10,4,3,13,117718,24354,13,508,546
15,4,11,3,11,30487,14941,0,0,477
15,6,9,4,13,113625,23770,95,2621,521
61,12,49,4,11,388963,8858,123,5914,443
2,0,2,0,3,0,0,1,0,661
6,4,2,2,15,275600,23327,32,15172,559
4,2,2,1,11,231729,322,4,2898,453
11,4,7,0,6,17106,0,0,0,607
22,9,13,7,12,113527,81200,3,2210,474
29,6,23,4,11,52163,52033,117,7412,511
18,12,6,14,17,272171,368950,263,35215,488
14,7,7,7,10,574902,75518,142,54713,430
6,3,3,1,7,269824,6335,25,0,673
28,8,20,13,17,862886,639920,203,51335,392
26,17,9,18,6,70101,78565,435,23442,436
56,12,44,12,10,104327,76258,225,21676,462
27,11,16,0,13,258280,0,36,219,589
6,3,3,3,12,10850,31587,51,5018,637
11,5,6,4,9,77958,61255,85,0,454
10,4,6,0,12,329364,0,3,1644,489
8,3,5,2,14,54163,54163,84,0,560
3,0,3,1,6,0,2883,17,0,569
69,12,57,9,9,76348,64777,185,9088,407
27,16,11,1,26,617849,322,8,1025,580
12,6,6,7,15,43843,42367,122,8696,448
4,2,2,2,14,70804,70804,6,35402,559
9,2,7,0,8,754,0,0,0,681
10,6,4,4,7,165445,48884,5,3187,440
13,5,8,5,13,105518,76637,31,27319,544
7,3,4,2,9,245786,245366,74,124990,506
30,20,10,3,27,2428501,6925,23,11769,526
9,7,2,2,12,93842,6397,20,2170,536
9,4,5,2,7,302719,4135,38,3721,504
6,4,2,1,8,10983,8068,0,0,539
45,9,36,6,23,150155,134215,107,34712,507
11,9,2,7,6,33755,30898,154,11843,407
13,6,7,5,13,439868,19821,69,14032,393
9,4,5,5,7,51081,51081,62,18788,466
20,14,6,0,6,191640,0,0,0,557
21,6,15,0,6,7167,0,3,178,684
23,10,13,2,11,102015,14549,31,378,460
15,7,8,5,14,77405,57617,63,12376,503
16,7,9,0,29,23805,0,1,199,681
8,4,4,2,8,8355,6600,56,6260,641
7,2,5,3,16,8922,26402,36,3832,610
15,9,6,5,11,620009,180348,116,14646,470
9,3,6,2,7,38080,14035,0,0,444
10,3,7,0,9,448976,0,4,0,573
28,13,15,2,17,539274,5947,96,20086,544
27,12,15,2,22,459879,8611,41,2349,522
8,1,7,1,6,20887,4049,7,3840,648
19,6,13,3,12,46538,29922,74,14645,481
8,6,2,0,15,29608,0,22,0,523
7,4,3,2,10,423760,27269,19,2416,545
4,2,2,4,7,25783,36426,96,15733,558
15,13,2,12,8,363583,474793,372,16935,424
9,6,3,4,12,160492,282690,75,50741,498
15,2,13,0,8,48922,0,20,2962,652
22,4,18,3,8,296846,7349,35,611,490
11,6,5,5,4,24844,23287,23,8570,470
31,10,21,4,10,206248,10856,43,1464,464
5,2,3,2,43,104416,104416,30,9786,568
4,2,2,1,7,532820,8640,8,18640,608
10,6,4,0,7,93557,0,2,0,511
8,6,2,0,7,26811,0,2,0,664
29,13,16,14,11,280996,105847,762,26605,467
3,1,2,0,19,73091,0,2,0,526
35,12,23,4,19,44071,20265,102,12413,423
6,2,4,2,8,15812,2637,32,1183,578
27,5,22,6,12,156572,106863,324,71201,498
4,2,2,1,7,5989,272,22,272,515
15,7,8,0,6,74509,0,0,0,499
16,13,3,11,11,133298,115411,97,16679,382
45,15,30,7,15,1041567,55277,102,24164,495
28,17,11,13,14,222554,222554,308,37645,352
21,8,13,6,17,47874,95957,131,1709,515
39,11,28,11,7,238058,236748,171,210500,449
7,4,3,0,13,166089,0,0,0,602
65,16,49,2,9,324429,216,191,5935,585
16,7,9,2,15,184832,32973,56,4214,478
54,32,22,0,8,13016915,0,15,15166,649
18,5,13,0,14,51136,0,0,0,614
12,9,3,5,17,461030,17827,87,3784,504
25,3,22,0,8,24226,0,202,2766,664
6,3,3,2,4,150542,13486,45,0,456
18,4,14,5,13,57431,23128,47,4091,451
29,4,25,3,9,323484,29028,48,3956,512
29,8,21,4,17,156498,21965,42,7567,461
5,3,2,0,7,160235,0,0,0,584
8,3,5,2,7,128114,3552,41,9433,557
6,2,4,3,6,6420,19678,5,605,480
45,17,28,13,11,676093,878364,232,73042,448
6,4,2,3,9,48251,47101,64,11626,467
28,10,18,0,10,89815,0,5,620,512
7,2,5,0,18,0,0,32,42331,628
20,9,11,5,13,39968,33829,45,9295,436
31,9,22,7,10,71444,37432,268,13022,459
10,5,5,3,12,16154,38236,41,0,551
6,2,4,4,6,6037,26551,42,2648,493
27,10,17,10,8,42107,58084,125,9630,445
23,8,15,7,7,313366,346394,96,124423,433
12,7,5,7,16,62204,62101,94,10693,434
34,14,20,1,11,1541146,3652,24,3652,664
30,7,23,9,7,88375,101866,176,31011,391
38,10,28,3,15,157947,36319,40,13949,506
27,19,8,12,13,1260260,335015,76,58516,446
25,7,18,3,9,73145,15489,150,12033,439
12,10,2,9,7,84910,45098,95,5625,385
9,5,4,3,8,53783,51174,115,41684,455
7,5,2,3,9,275574,89212,29,27074,444
13,7,6,0,9,15553,0,10,737,661
7,3,4,1,13,1452,562,9,1486,490
12,3,9,2,13,94251,84002,34,1771,530
18,14,4,1,13,1496152,33028,24,33028,544
11,8,3,5,8,395331,45293,320,20686,566
14,3,11,2,10,67854,31405,41,21786,507
5,2,3,1,10,10525,10525,129,10525,660
54,11,43,2,16,188430,27051,69,24434,477
16,9,7,1,8,2443,318,84,1049,527
7,5,2,6,5,10175,16253,88,0,639
13,5,8,0,3,18128,0,1,0,456
12,6,6,7,9,27266,31976,93,2384,425
47,12,35,11,12,87665,56017,156,15579,437
12,5,7,0,10,658100,0,21,2814,646
63,13,50,5,13,408753,43386,154,24065,426
10,4,6,4,18,59184,52213,57,21343,496
10,6,4,6,10,64488,57873,108,33217,430
14,11,3,10,12,63108,58931,173,11260,447
12,10,2,10,15,114158,95537,71,15691,471
4,1,3,0,13,182394,0,0,0,709
18,9,9,0,17,162635,0,3,0,563
12,4,8,8,9,53959,61022,5,8165,466
15,9,6,2,7,358116,9977,67,11654,532
17,7,10,3,5,82852,8975,92,8723,364
36,5,31,0,22,150051,0,0,2926,686
54,9,45,3,10,635317,39497,94,33369,532
21,0,21,0,3,0,0,0,0,677
10,3,7,1,18,15746,194,35,1543,609
27,16,11,6,20,9602130,169540,40,848,477
3,0,3,0,12,0,0,0,1126,656
18,11,7,11,11,416551,66954,49,11429,426
23,5,18,2,13,212241,146415,4,145797,501
10,3,7,0,20,39400,0,10,10180,658
18,14,4,1,21,192171,223,43,0,614
12,5,7,6,15,7569,22662,69,1556,541
3,1,2,0,4,8858,0,11,816,463
7,4,3,2,15,478006,3492,96,2993,425
12,8,4,3,9,652369,10812,24,11250,493
14,12,2,6,18,472662,77967,110,11238,409
4,1,3,0,11,11160,0,0,0,653
13,6,7,4,21,103520,131411,0,0,461
37,9,28,3,19,321424,93153,44,72639,421
37,9,28,5,9,560799,59593,54,20911,383
39,7,32,0,17,14151,0,157,1031,656
9,2,7,2,12,10622,27485,26,10622,582
10,3,7,3,14,94986,172832,0,0,631
3,1,2,2,7,361,3886,10,361,494
11,9,2,0,21,789629,0,22,10678,521
10,5,5,5,8,58683,53536,36,2180,424
4,2,2,1,7,798879,45764,13,0,455
13,9,4,10,16,435769,374635,266,23887,462
12,7,5,1,5,22088,1285,23,1285,383
12,5,7,5,9,37448,45737,93,13640,467
13,4,9,3,14,19161,19161,91,375,521
50,13,37,6,13,1102485,166113,73,1935,469
19,13,6,1,19,323225,2712,4,0,584
17,5,12,5,24,31182,56554,133,23602,519
3,1,2,1,9,3353,290,34,1253,646
7,4,3,2,23,375404,8033,36,0,531
16,13,3,12,11,687949,320899,144,83834,479
11,9,2,5,14,120578,105719,53,86090,499
11,4,7,5,14,64154,52689,94,3565,617
5,1,4,3,5,14596,18950,27,10881,574
12,5,7,5,19,177832,177832,48,6676,425
4,2,2,0,6,0,0,0,0,648
93,12,81,14,12,98434,139738,448,36890,462
25,9,16,3,6,52344,7385,49,3560,467
7,3,4,1,28,15642,3022,18,29535,577
13,9,4,2,12,832741,9220,25,7799,405
15,12,3,9,13,142121,134978,103,33708,486
76,10,66,1,11,115150,1780,65,5120,503
12,8,4,8,14,46445,37203,82,7572,392
52,23,29,0,18,3054171,0,14,0,619
4,2,2,1,6,147092,6188,8,0,600
31,4,27,3,20,179066,170833,61,0,474
15,9,6,0,69,363924,0,8,0,606
6,2,4,1,6,48069,48069,126,48069,505
21,4,17,4,9,10639,10639,48,6136,507
64,8,56,7,11,107426,85190,122,44805,466
14,6,8,1,6,18100,2740,32,2740,608
20,4,16,4,9,11407,15651,147,10028,513
11,4,7,2,15,149704,143496,53,0,597
60,11,49,7,19,108172,87446,479,29296,433
5,3,2,4,7,22780,22514,23,11537,441
26,9,17,9,18,175980,82309,178,2814,505
7,5,2,4,11,83999,83999,114,38085,469
15,7,8,2,8,45510,1151,19,3441,621
8,4,4,1,8,606924,2538,14,0,621
12,4,8,0,5,103225,0,0,0,553
14,7,7,4,16,465592,54296,76,615,459
41,8,33,1,14,282535,3667,99,3667,556
33,9,24,0,10,66865,0,2,398,588
16,5,11,0,9,37600,0,12,1500,447
26,6,20,4,12,679709,110287,0,0,531
21,11,10,11,17,770624,204183,443,7440,438
5,0,5,1,11,11840,11840,8,11840,567
31,6,25,0,13,36369,0,20,11665,544
41,25,16,3,12,1859179,9418,4,0,467
27,14,13,0,14,716893,0,0,29,586
11,9,2,2,15,99746,38925,45,32590,535
18,7,11,3,10,32794,26435,221,12889,439
7,2,5,2,10,21876,264,18,258,646
31,10,21,9,18,65068,65068,155,28861,419
9,7,2,5,9,16800,16028,71,10025,456
4,2,2,0,4,131519,0,9,1490,491
11,5,6,1,4,83585,4350,11,4350,423
8,3,5,4,3,19325,19325,45,0,436
7,1,6,1,9,2650,2555,14,246,637
34,8,26,4,16,205226,18816,57,15446,552
8,5,3,4,15,395576,34863,31,11000,494
11,9,2,2,8,291490,1540,11,1039,481
23,4,19,3,13,61176,21329,9,661,550
14,8,6,8,19,46140,67181,102,1085,441
12,5,7,1,11,275873,6390,0,0,682
10,4,6,3,4,6888,6467,11,3788,475
19,10,9,0,13,436263,0,2,0,557
183,2,181,0,17,100706,0,2,225,632
11,2,9,1,12,7862,7862,24,7862,599
16,11,5,10,16,281797,90454,63,20047,456
28,3,25,3,15,8688,18216,62,7129,530
10,3,7,3,8,146531,68661,60,36496,552
21,13,8,12,9,671850,105044,199,33264,425
4,2,2,1,6,7593,3444,24,3444,573
22,4,18,4,13,14506,14578,46,0,567
7,2,5,0,15,1000,0,0,1540,649
9,4,5,3,15,32331,36705,100,22115,528
16,9,7,0,16,173412,0,5,0,609
15,6,9,0,19,254937,0,32,4960,616
10,1,9,1,14,505112,21252,31,936,580
8,2,6,3,12,517950,287146,63,0,478
12,7,5,0,14,87178,0,0,0,591
10,6,4,0,8,34415,0,0,0,643
23,4,19,3,17,992031,30330,104,577,511
5,3,2,2,10,279866,13151,9,0,532
3,0,3,0,4,0,0,0,0,618
13,0,13,0,14,0,0,0,9923,632
10,3,7,3,15,32966,45782,54,13074,550
33,10,23,4,8,59272,35255,120,11510,512
10,3,7,2,5,3108,3108,167,2229,489
39,9,30,14,8,97466,108960,184,37883,404
7,2,5,3,9,58351,29223,75,0,589
12,8,4,0,15,41035,0,4,2940,670
34,12,22,5,10,109498,75390,96,29568,466
45,21,24,9,15,472481,36546,147,1720,409
5,3,2,2,18,397496,4256,4,1150,564
4,2,2,1,12,14543,14543,17,21368,626
15,4,11,3,9,348871,14162,318,6631,458
17,8,9,0,9,195899,0,0,0,628
8,5,3,1,20,321870,2902,16,13161,591
12,7,5,2,11,38949,5779,8,909,500
30,5,25,1,14,450470,8941,60,1481,501
23,8,15,1,6,145857,963,0,0,586
20,12,8,4,7,1072387,96889,61,1200,443
7,2,5,1,12,27956,3319,10,0,629
10,0,10,1,22,0,22966,39,956,636
9,4,5,1,11,20600,9216,40,9216,537
10,4,6,1,23,279890,1384,38,6751,519
14,10,4,4,11,76602,17931,47,2219,486
3,1,2,2,7,6891,16796,37,0,488
17,14,3,8,69,260139,46251,404,20320,411
22,20,2,8,6,58792,5057,26,3939,551
11,5,6,3,12,901292,143237,26,136362,445
21,7,14,2,5,47985,2014,16,1919,499
10,4,6,6,7,52638,52637,335,22230,463
24,3,21,6,16,313356,82121,26,8193,443
6,4,2,3,12,20123,20123,200,15940,455
16,5,11,5,17,12881,22316,43,3597,519
15,5,10,0,12,330088,0,25,68,518
14,7,7,8,8,82298,84828,288,51350,418
34,5,29,6,12,142787,144346,76,46553,495
14,1,13,0,5,18879,0,7,0,632
24,9,15,8,12,194835,103730,137,32600,466
8,5,3,3,10,443886,44616,74,26722,459
14,6,8,7,27,822719,716911,189,526417,556
18,9,9,6,8,343780,66823,111,239,486
24,11,13,10,10,1168758,1115709,256,154085,491
11,5,6,4,11,27132,31655,38,10453,523
40,3,37,4,8,30010,28467,174,5924,451
42,7,35,0,13,386949,0,4,6327,628
12,8,4,0,8,784483,0,4,761,659
22,6,16,7,7,61978,85860,78,2245,402
9,4,5,5,14,220804,29959,39,14866,459
26,13,13,6,13,440919,135610,363,43457,446
10,3,7,3,9,6015,20922,24,9291,633
10,8,2,0,4,43960,0,1,0,662
10,7,3,0,9,72636,0,6,0,581
27,10,17,10,17,275265,111315,191,10462,446
13,2,11,1,12,62726,27960,0,1057,575
8,4,4,5,6,54568,92558,124,0,517
6,2,4,4,6,12078,22375,39,5500,476
21,10,11,5,29,1065820,233884,70,0,501
7,4,3,0,14,53255,0,34,0,613
26,3,23,6,13,377509,404828,50,0,461
28,6,22,9,13,178452,209988,170,0,533
7,2,5,1,8,8602,2571,48,2571,519
21,3,18,4,10,92945,92945,126,66111,460
7,4,3,3,10,17189,14814,10,7482,405
8,5,3,0,11,223789,0,23,459,509
12,6,6,8,14,30661,29247,89,3420,461
16,9,7,5,12,207439,64000,75,3947,536
29,14,15,0,10,360936,0,1,0,630
10,4,6,1,12,66014,22297,31,0,624
21,5,16,0,5,15469,0,5,5972,618
10,6,4,2,7,124952,35419,16,0,448
6,4,2,0,3,218899,0,5,0,587
7,3,4,0,7,40039,0,1,0,572
20,9,11,5,11,256936,19952,56,0,459
29,19,10,18,8,285536,75875,253,12247,440
24,11,13,15,8,80662,95827,426,23679,431
6,2,4,1,9,15424,833,25,615,534
6,4,2,5,7,23659,27712,123,10747,493
7,2,5,4,10,304684,106380,0,747,556
6,1,5,2,20,9442,16204,21,0,569
16,9,7,3,12,61085,11140,58,764,528
16,7,9,2,11,13100,6954,28,5958,564
15,10,5,8,6,184534,28129,136,6721,451
16,6,10,0,7,1896,0,50,2982,629
16,10,6,7,5,87018,48503,71,16486,451
14,9,5,5,9,235544,104843,87,0,455
23,6,17,8,19,3828,215566,85,2865,601
14,6,8,0,13,349147,0,0,1911,603
30,8,22,1,6,391284,8331,30,0,447
11,7,4,4,11,326474,63968,73,2518,450
8,5,3,2,9,28606,3843,37,2200,473
41,9,32,4,14,1031211,203169,25,70927,479
14,3,11,2,10,32728,34655,42,22655,423
48,10,38,6,15,33713,15974,100,7099,435
7,2,5,1,16,8619,5357,17,0,551
8,2,6,2,17,39026,38609,27,10,577
19,10,9,7,14,276574,41896,150,11736,387
11,6,5,0,6,49423,0,0,0,523
3,1,2,2,5,16182,42044,26,0,664
6,4,2,0,7,32129,0,23,490,480
26,6,20,0,8,109967,0,17,0,600
16,7,9,2,9,883471,1987,34,1847,656
8,6,2,4,15,1253267,1928931,69,695667,418
5,3,2,3,4,33819,44862,61,15177,509
46,5,41,3,14,15756,11552,37,896,471
2,0,2,0,4,0,0,0,0,555
4,1,3,1,16,45024,39430,0,0,609
18,9,9,1,13,25716,3376,31,3209,460
30,12,18,0,7,142994,0,21,1025,492
36,11,25,3,16,117112,11939,59,7150,469
12,2,10,2,11,906,62943,175,11281,612
11,5,6,4,7,29141,23769,53,1542,553
23,8,15,0,12,95430,0,9,207,574
12,8,4,4,14,72374,58545,61,33989,495
85,15,70,13,14,420941,89128,495,37758,418
35,12,23,9,19,147577,51481,231,17628,489
32,10,22,5,7,53477,11431,59,4066,489
10,7,3,4,7,23604,5492,9,3207,499
14,8,6,6,6,45118,14474,162,7600,483
10,5,5,0,3,175650,0,10,0,541
14,7,7,7,14,764494,241262,175,0,546
39,10,29,12,7,238137,233795,133,163721,475
36,1,35,1,16,8226,8226,0,4305,513
10,3,7,2,12,16764,14536,12,10821,582
11,8,3,8,11,28237,36277,100,12783,454
20,9,11,7,10,27142,25137,53,0,439
20,7,13,5,12,723661,134991,337,81748,433
4,2,2,1,12,8190,8190,24,8190,539
13,5,8,6,3,16115,17970,58,3304,472
21,10,11,0,18,25196,0,36,1272,514
7,4,3,0,3,55939,0,56,1322,622
23,14,9,11,13,728905,80157,209,26868,432
28,12,16,1,12,953802,298,4,298,543
125,5,120,3,13,28626,7453,126,4450,458
12,9,3,0,7,41461,0,0,0,682
10,7,3,6,14,243604,34379,94,1509,471
17,3,14,2,11,18348,10635,120,6918,548
5,3,2,2,12,1366,1467110,35,0,503
11,9,2,0,17,292432,0,15,0,634
16,5,11,2,26,21574,7989,246,7592,636
7,3,4,2,13,15708,15708,39,1977,433
5,2,3,1,10,3419,2534,19,7867,632
9,7,2,3,3,48934,2337,24,1583,501
8,3,5,4,8,36366,25070,91,0,513
44,7,37,0,27,199013,0,1,11256,656
15,6,9,3,30,257001,240487,43,127457,408
19,10,9,8,15,84023,57326,72,15450,459
5,3,2,1,5,39120,465,3,0,526
12,8,4,3,9,266768,1274,30,1125,575
16,10,6,7,12,1774014,47840,55,0,450
113,14,99,4,10,499270,141617,62,109848,440
7,5,2,1,4,79475,1620,2,0,522
19,9,10,11,10,102914,103655,38,16530,384
12,10,2,6,7,26717,14613,129,7642,395
28,17,11,1,13,1258488,1699,4,0,511
21,10,11,3,11,449781,20419,155,18001,570
13,9,4,0,3,550280,0,0,0,659
23,10,13,4,10,429540,56129,48,36667,466
21,6,15,5,15,48636,27028,205,7687,535
9,7,2,1,6,492305,35318,0,0,567
10,5,5,0,12,183706,0,8,0,632
27,23,4,0,5,251754,0,11,0,599
59,6,53,1,14,335632,2460,35,2866,600
26,11,15,0,9,180372,0,32,1246,482
11,4,7,2,9,75080,55748,52,343,517
21,4,17,4,12,61824,61824,95,0,518
15,8,7,1,11,41396,345,53,3333,540
55,8,47,4,11,145232,76320,227,28200,457
5,2,3,2,7,7956,11064,34,0,581
19,9,10,0,16,64176,0,2,6544,594
85,3,82,2,10,22396,27535,35,1734,507
44,5,39,1,10,27094,718,100,2367,427
5,3,2,4,12,187970,176329,2,1010,467
20,8,12,4,24,38129,8779,52,3071,422
19,7,12,5,9,1631602,57446,71,0,487
6,2,4,0,17,0,0,3,0,709
5,1,4,0,7,4218,0,0,0,613
10,4,6,2,8,11082,8968,27,7927,537
11,5,6,5,5,684502,180289,15,5264,428
23,7,16,5,13,268174,27157,91,22123,453
19,1,18,1,19,9626,9626,20,9626,511
13,6,7,2,14,504699,205750,28,8521,470
25,6,19,2,17,10011,8546,72,11800,600
43,2,41,3,13,38416,38416,72,11239,468
73,10,63,4,14,68534,26163,51,8686,423
6,3,3,4,7,18431,27336,6,7220,517
40,13,27,6,18,206753,60515,62,9211,433
21,8,13,3,6,27902,12014,148,6277,508
11,4,7,0,9,33788,0,12,2689,592
9,6,3,6,15,457544,88927,92,61655,445
6,4,2,1,10,397061,5775,24,5775,636
7,5,2,0,4,9636,0,4,569,637
38,13,25,10,32,39927,36121,55,10562,329
54,10,44,7,20,453562,52526,166,31593,598
9,4,5,1,14,87254,9380,25,0,525
11,2,9,1,9,3683,2954,16,2954,552
23,2,21,3,8,59629,60278,50,4379,550
17,7,10,6,7,58093,24556,163,1641,496
18,9,9,6,21,184873,37655,100,2200,528
9,6,3,3,9,14829,3002,32,4711,411
21,18,3,9,12,747392,655297,76,143195,527
13,7,6,6,7,86447,21314,194,18200,475
11,7,4,1,21,206510,20283,46,0,531
3,1,2,0,6,14701,0,9,358,604
29,19,10,10,13,68292,47077,17,6295,431
19,9,10,1,24,171429,356,8,1558,611
17,7,10,3,13,202777,30745,66,14570,478
5,3,2,1,6,24187,24187,46,3300,514
4,2,2,0,9,14796,0,0,0,649
8,6,2,5,8,244464,20783,99,0,533
21,5,16,4,15,51393,66879,181,35176,396
13,1,12,0,9,0,0,16,630,716
6,1,5,0,3,115,0,0,0,615
11,9,2,0,3,48463,0,8,1044,505
15,11,4,10,13,81874,65454,126,15657,441
30,14,16,11,11,188219,41750,337,11033,520
12,5,7,0,8,886202,0,0,0,591
17,12,5,0,10,74920,0,1,0,613
37,4,33,4,8,6391,1181,108,1506,497
56,6,50,5,9,118462,21673,30,7459,418
6,3,3,0,2,26230,0,0,0,612
11,7,4,0,12,1032938,0,2,0,716
28,8,20,0,27,1917984,0,94,0,674
27,7,20,5,30,119386,49606,64,95951,459
6,4,2,1,25,540293,47357,21,0,573
14,6,8,5,13,35042,35042,290,17568,493
12,6,6,0,16,467130,0,0,0,702
5,1,4,1,5,8681,8681,106,8681,512
17,4,13,3,20,23094,22682,32,13847,440
9,4,5,1,10,14616,986,25,2185,543
22,9,13,5,12,576391,63762,61,39241,492
10,5,5,2,10,405630,100395,34,4798,430
11,8,3,9,6,25823,26996,108,10284,439
10,7,3,2,13,119132,4220,15,1030,418
9,4,5,2,10,108898,15791,0,0,464
17,13,4,10,16,876148,444386,156,43820,514
12,8,4,5,6,2355417,983423,72,70029,434
8,3,5,1,5,193421,1400,16,1400,609
10,4,6,6,7,49717,56479,109,16367,448
16,4,12,2,8,44926,2001,64,1087,519
39,6,33,3,19,262454,66024,336,63101,509
16,6,10,4,13,403279,225999,70,3577,458
32,10,22,3,13,564329,57518,129,36189,422
8,6,2,2,7,6787,327,2,1522,511
12,6,6,9,5,21375,28098,122,5545,437
13,5,8,3,12,264480,10304,75,0,618
8,2,6,2,8,8330,8330,85,7426,503
21,15,6,4,8,276360,5596,81,1833,494
9,4,5,1,17,182167,384,5,0,600
8,3,5,3,6,118238,16000,1,61,449
15,5,10,1,18,20866,3205,32,0,491
7,3,4,2,9,14555,14555,54,4692,468
28,10,18,6,8,619480,73722,122,6900,443
3,1,2,0,6,5677,0,4,199,677
17,1,16,1,13,0,9888,134,9888,578
14,11,3,7,5,626617,193986,23,0,464
4,2,2,0,2,25728,0,2,803,609
31,7,24,6,12,70179,36642,138,13414,465
88,10,78,11,19,108555,137127,318,34769,424
17,4,13,0,8,10362,0,34,1796,646
43,9,34,8,9,31523,1194,36,1665,488
8,4,4,3,8,60407,11271,48,1679,536
2,0,2,0,9,0,0,26,1886,513
14,3,11,1,7,14768,10000,81,1082,625
11,6,5,2,13,7004,5131,4,3914,451
29,8,21,1,19,122527,6975,5,3683,618
24,6,18,5,14,13398,9857,65,6478,447
7,5,2,0,9,77037,0,0,0,575
8,6,2,6,17,71994,59412,102,24291,383
12,10,2,7,39,575216,266954,99,216748,363
8,2,6,1,9,30400,29970,9,29970,608
23,15,8,4,16,183542,504,136,288,545
7,3,4,0,9,45504,0,0,0,651
9,4,5,4,8,37951,37951,153,15832,501
6,4,2,2,9,5394,2165,5,247,465
9,6,3,6,15,340145,37333,84,14016,437
13,3,10,4,9,10952,48289,39,7396,547
12,4,8,0,6,99541,0,0,0,584
18,6,12,4,13,62731,51481,256,38388,514
13,3,10,1,2,4972,133,6,2805,562
47,12,35,6,14,268703,11154,107,7273,443
15,8,7,9,8,78496,59112,125,512,474
11,1,10,3,7,1500,16404,66,5300,502
25,18,7,0,21,836087,0,14,0,641
18,3,15,2,17,16199,16199,32,5763,454
12,7,5,0,9,169606,0,10,0,646
4,2,2,0,11,317215,0,8,2568,637
3,1,2,0,5,4994,0,1,0,720
14,12,2,6,9,406418,11165,12,633,450
24,4,20,1,19,172824,8195,0,1653,546
7,0,7,0,1,0,0,1,1228,537
8,5,3,0,6,259478,0,2,2305,569
20,4,16,1,13,96947,10638,28,0,573
6,3,3,2,6,10627,12739,17,7666,545
34,15,19,5,9,1551489,88437,34,36559,463
7,1,6,0,8,8747,0,20,1070,577
27,5,22,2,16,301065,186822,74,8905,474
7,2,5,0,13,0,0,12,1404,448
24,13,11,9,10,126758,56882,260,16796,410
32,11,21,16,14,105254,123817,145,28640,418
68,19,49,11,12,665181,100444,13,7138,481
19,10,9,8,10,712817,54378,161,34154,405
9,5,4,2,15,675202,16367,48,129,529
7,3,4,1,4,100917,2112,26,2112,656
5,3,2,3,4,31987,16045,161,8544,504
8,4,4,2,13,388211,66632,44,15401,640
17,5,12,2,6,11517,11811,11,1097,603
12,7,5,1,14,85671,1537,5,3028,524
26,7,19,2,6,196689,3949,20,0,468
11,5,6,3,9,16389,10404,57,2935,529
25,7,18,6,18,84736,79188,67,3268,466
34,6,28,3,18,302925,10221,107,18163,426
22,5,17,3,6,38048,30991,63,0,537
16,6,10,6,8,22545,29960,87,6667,469
16,3,13,2,13,20439,20439,204,19499,533
4,1,3,1,11,537869,153115,24,342,635
29,12,17,4,15,376135,120985,75,4344,524
27,7,20,6,10,26345,26345,176,12233,435
19,12,7,12,9,101887,96823,428,8505,486
14,7,7,7,7,96178,90935,188,2294,484
58,5,53,3,9,17051,12899,320,6332,529
8,6,2,6,6,25825,18031,308,6160,487
15,5,10,3,6,635858,195641,11,13165,425
10,3,7,1,12,60190,4797,24,4797,610
27,7,20,6,9,71758,60052,76,10466,446
6,4,2,2,14,17992,3704,118,6578,525
12,8,4,0,11,638582,0,2,0,550
15,10,5,3,7,50187,5686,0,0,460
5,3,2,1,13,196568,5796,51,0,606
6,3,3,2,29,36126,36126,19,35818,488
16,12,4,1,35,591707,348,0,0,612
31,7,24,6,9,167340,132678,130,2633600,435
7,3,4,0,6,12079,0,1,0,587
7,3,4,4,3,139418,159983,48,0,418
10,8,2,0,8,1152836,0,1,0,627
16,3,13,0,8,3818,0,23,325,582
4,2,2,2,8,21898,21898,17,16241,599
10,1,9,0,2,0,0,0,0,641
7,3,4,2,6,9098,9098,193,3054,573
9,7,2,3,15,223498,22349,27,10829,449
48,6,42,0,13,129925,0,6,2424,623
20,15,5,0,25,755687,0,0,2504,594
13,4,9,1,20,31103,6979,1,1250,627
21,6,15,4,4,36923,23166,56,3963,577
6,3,3,3,11,836882,815388,52,0,494
10,4,6,2,19,5685,25093,65,4699,505
30,10,20,11,11,20086,28653,726,8545,481
31,7,24,0,10,8168,0,2,2195,624
12,7,5,4,21,785972,152717,48,23511,434
9,4,5,0,18,282185,0,6,2870,547
5,2,3,3,19,15968,29328,41,3059,506
12,5,7,4,17,381628,20790,34,15174,430
46,15,31,6,9,216133,9423,226,2042,508
15,6,9,4,14,17631,11804,66,0,525
13,8,5,4,5,104780,22913,21,7357,449
21,10,11,5,14,1412804,221205,0,2800,500
9,7,2,8,7,41185,42548,183,10523,526
40,5,35,4,19,138125,88149,17,6510,481
32,8,24,3,8,54667,35737,179,14753,547
5,2,3,1,9,191289,20331,4,60,525
20,8,12,1,19,135512,7456,43,1995,518
12,4,8,0,11,137591,0,3,0,704
8,4,4,0,16,226438,0,0,0,710
20,6,14,2,15,423666,43228,27,23399,510
7,5,2,7,5,16186,27164,109,2125,472
21,7,14,3,11,67387,50663,45,3049,429
12,2,10,1,13,419451,14078,0,0,510
28,8,20,0,20,488464,0,12,3315,600
25,7,18,0,15,322232,0,7,2703,702
6,4,2,4,14,493653,24791,53,6340,533
3,1,2,1,8,694,1012,15,2628,603
16,9,7,3,7,74248,1747,39,3140,496
8,3,5,0,8,22903,0,6,378,626
28,12,16,9,9,87196,19916,75,8141,451
3,1,2,1,9,825589,240560,26,1025,687
3,1,2,1,6,771,771,20,771,605
7,5,2,1,4,40790,1506,1,1506,540
36,16,20,7,14,128073,49104,215,19026,463
21,3,18,3,8,93978,28406,18,856,617
16,5,11,3,8,18765,17270,253,5610,429
13,7,6,2,3,234022,4296,31,6214,480
21,8,13,2,5,18627,4177,99,3400,526
6,3,3,1,7,58638,2951,37,2951,529
13,7,6,0,9,20131,0,84,1728,513
5,1,4,1,14,183006,68272,32,0,490
3,1,2,2,13,18976,18976,0,0,466
31,23,8,2,14,489530,1060,32,738,545
14,12,2,0,9,240445,0,15,0,480
10,2,8,3,9,853137,18971,55,8541,530
18,4,14,2,9,52582,6043,47,2743,491
3,1,2,3,7,25271,25271,57,0,500
11,8,3,3,7,43910,39451,53,0,519
4,2,2,3,8,11879,11879,29,9910,558
8,5,3,0,17,4562,0,26,75,708
6,3,3,0,5,110601,0,0,0,648
20,9,11,6,12,210600,53364,125,25279,512
14,6,8,3,19,140099,9389,31,5100,529
27,15,12,6,15,340503,51961,87,12262,447
25,8,17,7,9,43064,79637,235,11558,540
22,7,15,4,9,301102,18955,15,3978,487
22,5,17,5,11,147484,83308,11,2858,456
6,2,4,2,13,1180,17989,18,4305,622
27,14,13,1,16,134863,722,46,4291,469
10,5,5,3,8,10721,7221,41,5772,444
3,0,3,0,12,0,0,0,1606,687
50,19,31,13,16,503476,226329,366,45780,417
19,10,9,0,9,566509,0,10,0,505
26,15,11,10,12,491355,214659,3,8680,447
8,6,2,2,10,410535,8597,48,4299,540
15,7,8,1,13,348850,1582,39,388,500
14,8,6,5,14,92544,24092,31,3358,481
16,3,13,1,10,228,76,17,3052,532
15,8,7,5,8,7390,2137,43,732,498
13,5,8,9,19,44919,61952,189,8675,453
22,5,17,4,16,10379,9527,23,3879,398
6,4,2,3,17,349382,28776,40,4640,478
15,11,4,1,5,414606,3139,39,3139,473
31,16,15,0,18,1240847,0,8,15486,655
11,7,4,7,9,28451,28772,54,11504,478
7,2,5,0,19,274662,0,0,1159,635
13,8,5,3,12,20582,8481,105,3854,474
10,3,7,0,12,216787,0,17,0,584
11,6,5,6,18,1049650,281948,101,1808,468
36,9,27,2,18,96826,13568,22,7052,559
21,7,14,1,17,109284,3980,79,17170,522
19,11,8,2,6,442724,152624,20,5570,522
26,4,22,1,8,21476,140,92,4227,524
18,7,11,1,13,158022,4350,15,4350,640
33,6,27,1,13,226291,11905,0,1155,531
7,4,3,4,9,45160,4092,66,2500,493
5,1,4,2,7,20892,20892,30,13772,491
14,7,7,5,8,69277,85930,162,1140,453
24,1,23,2,4,4877,9742,21,4865,427
19,2,17,0,17,151557,0,0,5975,736
27,3,24,2,14,18283,8630,59,7360,503
22,5,17,3,13,36252,20287,14,18558,560
11,4,7,3,14,57893,84237,0,0,544
16,11,5,1,12,186763,620,21,1840,545
8,6,2,6,7,41414,36789,220,15772,446
5,0,5,2,9,151952,330677,4,19892,591
18,3,15,3,12,30329,30329,59,14980,551
6,1,5,3,10,8998,33523,118,5715,571
25,4,21,1,10,16125,854,24,2829,513
15,2,13,2,11,4091,3820,20,3145,478
3,1,2,1,4,957,957,24,957,530
3,1,2,0,3,0,0,0,0,707
36,17,19,0,18,982701,0,4,149,711
37,8,29,2,28,783595,23782,54,730,535
32,12,20,11,11,109517,67043,64,8713,382
9,5,4,2,7,17415,400,0,0,522
14,8,6,5,10,220269,9194,25,9001,459
12,4,8,2,14,86937,78243,62,0,521
45,13,32,8,12,63241,107078,89,11609,504
13,11,2,10,9,54043,71021,0,0,493
23,11,12,8,14,321443,55347,78,26206,467
9,7,2,0,4,191290,0,0,0,574
14,10,4,4,10,412495,183174,116,88990,591
14,3,11,2,6,5170,1648,20,2555,574
5,2,3,1,5,265106,5050,3,5050,634
45,10,35,8,11,26545,24436,328,16877,424
5,3,2,2,8,44272,24411,47,2431,495
9,6,3,4,16,32253,15920,11,12600,443
14,2,12,1,18,299484,60112,5,60112,674
12,4,8,0,10,58682,0,4,0,633
13,2,11,0,5,5279,0,1,0,656
14,8,6,1,17,353659,45639,31,1018,603
41,17,24,8,10,297836,81928,148,8091,460
31,8,23,6,12,349954,27567,74,8915,405
39,5,34,4,15,48838,36242,52,3102,490
7,5,2,3,10,222218,5987,56,0,459
17,5,12,6,10,137111,103245,63,1014,463
8,4,4,0,10,359,0,0,0,697
17,12,5,0,11,464888,0,15,2849,557
13,9,4,4,11,301032,24052,55,12722,367
23,11,12,5,7,171098,76967,107,5367,415
25,9,16,6,18,438457,151891,90,2985,438
6,4,2,1,19,425542,704,1,704,510
25,13,12,16,18,187103,223861,396,60344,428
14,9,5,0,17,52988,0,54,804,543
8,3,5,3,14,52381,52086,20,1871184,641
20,8,12,6,7,23677,15218,36,18979,416
37,9,28,4,14,53052,47190,121,10685,389
9,3,6,4,6,341010,80826,44,7741,638
21,8,13,5,9,117153,53864,53,21979,462
23,4,19,2,9,29482,18493,51,15418,618
16,9,7,11,6,52455,55791,257,18816,496
9,1,8,1,8,40979,21424,53,21424,557
43,25,18,0,20,1320283,0,7,714,646
34,15,19,3,4,314912,43008,14,18365,513
21,9,12,8,12,130120,128920,117,1904165,472
24,10,14,1,12,276663,1609,7,160,604
6,2,4,3,8,2559,4959,41,2400,556
12,2,10,2,8,14322,7167,22,2245,466
46,3,43,2,8,29982,14824,5,3610,454
11,7,4,6,10,38633,38415,226,23328,433
11,5,6,7,9,104663,125709,116,41464,436
6,3,3,1,4,7506,7506,14,0,616
33,16,17,1,15,2391435,1185,11,1532,641
26,3,23,1,18,17672,634,1,2590,550
22,10,12,5,12,57406,30973,102,10930,485
16,7,9,6,12,642694,607835,101,81782,447
19,7,12,1,5,147323,966,30,1435,382
4,1,3,1,5,2175,2175,23,785,657
8,4,4,3,15,11623,11623,54,5628,516
32,11,21,5,15,216568,26055,243,5920,519
11,4,7,1,9,193076,7994,11,0,521
12,5,7,2,13,235288,10693,25,14298,463
18,12,6,8,9,323379,247958,215,80449,423
20,9,11,8,9,52255,32766,239,10944,383
8,5,3,5,13,313375,92579,55,45730,436
10,5,5,3,8,20370,1182,24,642,478
141,11,130,5,6,89980,10736,118,5023,421
16,12,4,8,10,155257,151167,154,35610,417
4,2,2,1,5,2560,2560,22,2560,480
9,4,5,7,7,51366,59451,98,20832,470
10,6,4,4,6,96381,17225,24,7291,547
6,4,2,2,11,8936,8936,0,0,462
77,5,72,3,16,52344,10903,180,5296,645
8,4,4,5,8,30691,45361,0,0,478
20,9,11,3,7,251850,1814,211,47885,500
7,4,3,4,7,3430,6613,81,7003,456
7,5,2,0,16,780784,0,0,0,669
25,11,14,9,10,530495,66191,45,6341,407
14,5,9,2,17,3322,51372,60,3587,462
11,1,10,0,11,0,0,0,1819,658
5,3,2,0,7,332598,0,0,0,557
9,6,3,6,12,106277,76808,93,28446,470
9,0,9,0,10,0,0,0,74,545
15,9,6,2,21,1204449,61017,46,54720,648
28,8,20,6,15,92855,85790,44,41728,419
16,5,11,2,8,18394,6795,74,0,614
10,3,7,0,19,0,0,0,6297,608
27,7,20,0,9,182067,0,20,0,606
48,9,39,8,7,118935,63508,153,17445,548
24,9,15,6,34,42055,21166,98,1945,498
11,2,9,2,9,18034,3868,25,13000,443
74,10,64,3,9,412427,68045,82,44560,517
61,10,51,5,16,70465,43823,161,9345,411
18,2,16,2,9,7716,7716,287,23261,526
19,8,11,6,9,7586,12906,63,3289,508
103,6,97,3,12,18868,12356,31,6590,424
26,11,15,3,18,180434,7210,11,5900,570
8,4,4,1,17,362276,204,9,0,546
12,5,7,2,18,9530,5652,50,3330,486
6,4,2,1,6,16709,7151,237,3452,455
32,10,22,2,10,179699,23582,14,0,520
26,12,14,7,7,269088,191852,85,358,494
20,11,9,2,6,361372,10039,3,0,527
17,6,11,0,8,357351,0,2,0,613
21,14,7,11,10,119842,95035,41,14232,438
23,13,10,4,14,373030,13968,86,9770,469
15,9,6,5,16,466998,122291,19,111206,485
26,9,17,4,7,146981,54150,84,5921,461
7,5,2,3,13,77771,4341,9,115,440
8,6,2,1,13,10009,1407,5,1407,631
11,8,3,9,7,20999,22665,92,6088,579
13,3,10,2,13,11934,11934,58,1350,546
8,4,4,3,15,28440,10479,29,7700,454
13,7,6,7,9,26798,37769,119,13949,464
11,7,4,3,4,39795,776,29,706,540
17,3,14,2,18,777,1221,6,5730,546
11,8,3,0,8,130028,0,3,0,642
12,4,8,3,36,372178,76689,39,45000,417
20,11,9,10,15,203353,191332,77,15504,389
5,3,2,0,7,11391,0,0,750,713
17,14,3,1,18,1543687,8192,5,8192,488
9,7,2,3,14,54281,52893,30,7229,434
8,3,5,2,9,336664,41150,70,30179,471
9,4,5,3,7,55549,41677,31,24854,591
21,9,12,1,6,219527,36192,0,0,559
11,8,3,10,14,239413,215413,170,0,448
13,4,9,0,4,32551,0,0,1525,626
14,9,5,3,9,29084,17761,69,9721,462
12,4,8,3,17,364991,39424,88,20597,490
16,6,10,4,15,47494,45796,42,10491,433
14,8,6,6,21,71541,47396,49,22945,480
18,6,12,6,16,65611,46025,11,2755,492
40,7,33,1,7,259699,538,20,0,609
4,1,3,2,7,14425,14425,37,0,637
31,6,25,1,12,46331,29043,71,700,555
12,9,3,8,15,162194,149649,141,5100,504
4,1,3,1,9,309102,5131,23,5131,629
3,1,2,1,13,14454,3792,29,0,520
10,7,3,2,9,66425,65763,0,0,577
22,20,2,14,18,759476,327979,206,91095,388
6,3,3,1,7,11022,8716,96,8716,546
4,2,2,0,18,12901,0,16,1320,685
19,11,8,10,7,473755,88523,11,2385,437
19,4,15,3,12,134179,34118,7,1352,469
3,1,2,0,6,1293,0,0,0,639
21,8,13,4,8,45919,28831,166,12762,460
12,7,5,6,9,10881,23048,241,9960,518
33,6,27,3,19,42240,41575,66,22528,517
40,17,23,14,14,8889805,8876893,385,4561781,550
11,7,4,3,7,840033,89732,91,46526,400
9,5,4,2,9,10190,1611,25,0,490
5,2,3,1,12,515314,7979,0,0,544
42,10,32,8,19,452773,153489,141,25417,457
20,12,8,9,7,41736,53252,174,16854,410
6,3,3,3,5,3072,2515,0,0,428
9,4,5,4,13,10133,5778,47,2388,417
18,12,6,2,14,632493,29635,16,1931,421
9,4,5,3,7,17558,17558,74,5980,480
22,7,15,3,9,198650,19628,74,3467,492
8,4,4,4,1,14238,14238,12,6953,357
40,6,34,7,14,95246,95246,156,9044,469
13,8,5,6,11,98605,5642,14,2908,524
6,1,5,0,9,205382,0,35,0,633
4,1,3,1,19,13983,13983,0,0,490
7,5,2,2,11,174536,3813,24,1855,443
32,13,19,4,14,72215,34123,86,851,513
14,5,9,3,4,24718,3756,42,3821,451
12,2,10,1,8,6193,424,6,424,632
20,11,9,10,15,31822,31822,160,13016,432
34,5,29,1,14,33118,691,79,4166,558
8,3,5,2,12,69290,69290,15,6997,521
6,4,2,3,9,410012,28761,20,30671,439
7,5,2,3,14,19439,15988,122,9723,449
23,12,11,0,4,776030,0,2,11798,613
40,13,27,7,37,1629471,789128,114,0,693
48,7,41,3,10,373806,7240,45,2839,446
10,5,5,0,7,762162,0,13,2593,605
27,13,14,8,9,20256,16051,107,5151,433
7,4,3,1,19,353838,5453,50,5453,596
186,75,111,2,13,150293,43176,31,23211,500
6,1,5,0,13,0,0,0,0,746
61,14,47,10,13,335207,94015,161,12112,442
12,6,6,3,7,62978,9520,38,660,494
25,13,12,4,14,544458,13374,69,2898,474
43,20,23,1,20,1214061,80,6,5518,593
29,8,21,6,10,26832,11778,90,4456,457
10,4,6,2,15,68240,19606,0,0,593
7,5,2,0,9,17922,0,9,2488,469
10,4,6,3,18,199391,51090,31,32265,471
11,5,6,2,5,53049,16256,44,14684,503
8,1,7,3,8,26590,26590,42,12276,556
26,3,23,4,11,38700,37620,76,28306,461
19,13,6,1,27,1054345,83323,15,0,462
30,7,23,5,22,430914,23532,24,5114,453
15,6,9,3,7,32880,5402,0,0,626
12,9,3,6,5,39357,41407,74,11279,437
12,5,7,3,12,78952,60723,80,12127,439
15,3,12,0,14,65983,0,11,0,574
10,3,7,0,12,78251,0,6,0,574
19,7,12,4,25,50199,33110,87,15748,523
10,5,5,5,9,333299,55629,0,0,475
5,2,3,0,9,84896,0,1,1028,589
76,5,71,0,14,57354,0,8,2871,643
27,3,24,2,17,534290,81444,22,0,465
24,4,20,3,18,156413,152719,80,38868,492
12,5,7,4,15,659331,145600,75,114285,424
17,3,14,2,8,43838,17668,25,5001,466
8,4,4,2,19,31235,6039,68,2465,640
6,4,2,3,6,20201,20201,288,11088,525
4,2,2,1,8,388360,14760,25,14760,678
21,6,15,0,11,966532,0,3,4065,498
15,8,7,5,12,310045,50252,53,8089,469
13,6,7,0,5,180498,0,3,0,539
26,13,13,10,25,239545,130490,226,2200,453
8,5,3,2,4,66929,10448,50,194,464
11,6,5,5,11,14360,13338,44,2774,447
79,11,68,3,15,119297,102027,108,8380,459
4,2,2,2,8,44966,17392,50,0,490
6,4,2,1,18,109604,108943,24,108943,487
18,10,8,0,29,183748,0,2,4234,666
5,3,2,1,7,32845,4221,0,12000,623
7,5,2,4,7,371488,33909,42,752,422
14,1,13,0,8,0,0,0,0,598
15,9,6,9,7,37754,36197,105,9147,412
18,10,8,0,8,549824,0,19,0,597
15,5,10,4,17,47813,46290,74,16360,496
3,1,2,0,6,18114,0,1,1807,542
33,2,31,1,3,12056,1427,40,6430,403
25,11,14,4,12,116629,10492,33,6713,463
16,6,10,6,14,54758,47250,215,264500,459
9,7,2,5,5,178687,93503,170,8305,418
11,1,10,2,7,2456,2456,15,1944,524
8,2,6,1,12,4880,4880,23,4880,597
25,6,19,5,9,11244,15459,239,9069,438
24,14,10,13,7,65430,24658,36,3632,417
15,8,7,1,9,74739,2985,9,2985,482
11,7,4,0,10,86306,0,19,23621,526
16,8,8,1,24,495314,1132,2,1132,453
8,5,3,4,13,34873,25433,106,1512,474
7,5,2,7,6,43816,43350,58,11319,520
10,3,7,0,10,8689,0,50,1372,679
12,6,6,4,11,19873,19873,44,10587,428
28,12,16,2,16,143725,8718,150,0,522
32,19,13,4,12,625697,30821,8,102785,493
20,13,7,1,10,1812922,448,14,1382,669
60,9,51,2,19,312172,1096,158,3387,494
14,8,6,8,7,31284,54879,141,164,416
17,6,11,3,12,14311,9465,34,3901,432
18,7,11,3,28,83507,507298,2,13108,417
20,6,14,2,12,23390,7924,21,5961,633
17,7,10,1,12,170494,925,83,124,466
8,6,2,2,7,23760,19199,12,1017,514
44,2,42,2,7,25869,25869,49,24469,525
10,3,7,1,15,9525,5446,96,10892,489
4,2,2,0,8,548,0,0,0,651
25,17,8,2,9,830744,3211,21,0,524
7,4,3,0,9,107903,0,9,4215,661
30,10,20,5,11,59630,53869,178,20625,466
19,5,14,4,15,74217,47558,124,8094,427
23,8,15,6,21,416284,14819,59,11782,533
16,4,12,6,7,46540,46735,46,22706,422
33,11,22,10,9,155105,95867,149,14555,438
12,6,6,6,13,44843,43636,93,5048,460
17,3,14,0,7,2900,0,0,0,602
11,6,5,6,17,396943,90220,122,5927,474
10,6,4,4,19,202300,81451,85,281,461
45,9,36,8,17,140773,160801,230,37397,402
29,6,23,4,7,80163,42676,12,13686,508
14,5,9,6,9,31530,28997,76,5647,417
14,4,10,0,13,0,0,130,11010,462
23,8,15,1,22,353728,2340,8,2340,550
6,1,5,1,12,0,886,13,0,628
34,4,30,1,19,148864,26425,49,33215,551
5,3,2,0,3,742097,0,25,27205,580
11,5,6,4,17,213617,32020,63,16833,494
35,5,30,2,14,67146,18180,162,18359,489
19,7,12,1,13,328640,2358,11,3312,514
30,6,24,2,8,35738,7421,24,6506,595
8,5,3,5,12,50081,47441,69,4148,498
6,3,3,6,6,473966,906078,90,305817,463
16,8,8,5,13,281020,13389,42,4664,447
24,12,12,9,13,506940,153002,133,13606,414
15,7,8,5,15,25063,245541,82,837,478
14,9,5,9,14,391858,61585,148,8510,418
10,4,6,5,8,33896,59817,99,25921,550
9,3,6,1,9,14394,12465,40,0,579
9,5,4,4,15,123987,56169,95,22803,396
5,2,3,0,11,0,0,0,2620,717
22,6,16,0,29,716559,0,3,2616,612
42,9,33,4,19,26595,10573,327,4625,481
20,13,7,15,6,92516,90669,185,5908,416
6,4,2,2,8,12211,12211,31,11577,532
16,9,7,2,12,2048933,7180,22,3397,491
6,0,6,0,3,0,0,5,0,606
12,4,8,2,13,474426,202524,39,144942,405
4,2,2,3,3,6767,7172,12,1893,495
5,2,3,1,11,38682,4631,11,4631,641
9,7,2,6,9,992679,35148,0,0,481
12,9,3,5,14,686372,25155,0,0,528
20,9,11,5,12,414562,19307,93,2209,498
8,4,4,1,9,362416,14132,36,510,459
4,1,3,1,6,32773,32773,96,32773,486
24,10,14,1,11,250142,4651,8,658,612
15,11,4,2,11,383560,41894,65,41664,600
13,4,9,3,15,128378,25291,20,4206,466
11,5,6,2,14,203404,101976,45,14675,474
11,3,8,4,12,329602,291084,0,0,528
11,7,4,1,7,73241,948,8,2474,545
18,9,9,5,12,84777,53503,287,9893,447
11,7,4,4,10,43073,18029,55,1085,446
9,7,2,5,2,53974,750,70,259,523
53,15,38,11,23,171368,212875,415,25309,450
15,12,3,2,20,853005,33900,9,683,481
64,10,54,1,24,37560,1096,90,1957,451
32,10,22,6,8,376923,11729,144,5716,398
6,4,2,0,2,5574,0,1,0,577
6,3,3,5,6,36064,45486,64,8611,425
19,9,10,4,15,645428,433924,0,0,469
10,2,8,2,9,21841,43803,0,0,544
48,18,30,7,10,471112,17259,204,11237,431
20,12,8,11,9,272422,475764,130,81873,522
13,2,11,2,13,11070,11070,60,7425,535
3,1,2,1,7,10324,10324,23,10324,601
16,6,10,6,8,75898,67727,152,7120,438
9,2,7,3,6,8166,16816,55,3358,448
30,5,25,2,16,542186,163069,61,117691,502
23,12,11,0,11,73496,0,73,16048,455
22,9,13,0,15,1384183,0,2,2289,584
5,1,4,0,7,0,0,2,1056,638
8,4,4,4,13,21513,33685,0,0,474
28,8,20,7,12,82760,67185,116,0,443
16,12,4,0,8,323177,0,9,0,504
27,9,18,0,16,26009,0,13,473,578
26,23,3,21,15,962729,962728,166,303549,517
15,4,11,0,6,17196,0,0,2768,542
34,4,30,0,4,86724,0,47,19792,561
15,1,14,2,19,9763,9763,1,17467,600
6,4,2,3,6,8763,5726,49,1380,438
10,1,9,0,7,238,0,2,0,694
6,2,4,1,8,356575,270,6,0,613
13,10,3,5,15,540151,150153,110,65488,460
12,3,9,0,13,18657,0,0,0,574
7,2,5,1,11,420244,20234,18,840,636
3,1,2,0,3,0,0,0,0,639
33,16,17,0,29,429715,0,6,0,589
10,8,2,6,18,552833,50008,85,3958,446
27,4,23,1,10,41103,3628,10,3628,620
8,2,6,4,69,24111,68193,26,35001,483
14,12,2,7,7,191386,10930,66,7169,481
6,4,2,3,11,18404,13562,55,1451,548
12,7,5,3,15,277252,14457,28,13385,490
30,13,17,4,19,2801225,9574,0,0,561
29,7,22,4,18,457802,34316,84,13481,412
172,10,162,9,21,481711,37481,242,9337,421
12,5,7,7,10,1503053,210940,24,2449,484
23,10,13,5,8,228743,23743,221,16135,454
5,3,2,3,16,16233,101257,70,1350,606
42,2,40,2,8,23058,23058,87,11529,495
8,2,6,0,11,16517,0,2,0,604
30,15,15,2,19,547460,5876,56,460,495
9,4,5,5,15,175148,175148,93,293,525
8,1,7,1,21,3327,3327,43,7336,544
30,19,11,0,9,1461289,0,1,0,605
7,3,4,1,11,115170,13993,9,13993,543
7,5,2,1,9,214831,3513,16,3513,501
9,3,6,1,13,10477,1526,26,0,536
9,6,3,3,8,19358,1564,88,1517,480
8,5,3,0,5,52615,0,1,0,586
9,7,2,1,4,96994,598,14,598,618
13,7,6,6,16,272503,22951,97,3737,439
14,8,6,2,34,227918,720,10,0,628
18,9,9,7,15,1121305,261639,54,7893,394
28,1,27,1,7,6281,6281,26,180,498
10,5,5,0,11,367343,0,0,0,602
28,11,17,2,17,78469,68751,121,17748,461
21,13,8,2,18,262215,22939,99,25810,492
36,7,29,3,15,62122,244715,77,0,555
11,4,7,1,7,78961,78961,33,1259,539
33,13,20,10,11,744665,101534,212,9667,376
14,6,8,3,13,383278,27463,41,21357,539
8,6,2,1,22,1101672,1028,8,2216,565
8,5,3,2,20,2693,2693,25,698,456
13,5,8,3,6,43953,11731,31,0,486
18,9,9,0,15,676122,0,10,715,529
11,5,6,4,8,22306,21178,71,3837,519
35,6,29,2,18,531495,12127,55,7667,491
17,7,10,7,8,312139,269289,158,53724,450
39,10,29,7,12,43195,28359,144,7080,414
10,6,4,2,8,465857,9268,2,1272,491
20,10,10,5,20,835376,93893,74,8366,425
6,2,4,2,15,8416,263,30,475,585
8,5,3,0,14,102669,0,0,0,691
6,2,4,3,8,11953,12197,56,10448,430
17,6,11,0,13,188024,0,9,0,619
24,18,6,22,30,417171,473762,326,78011,474
20,5,15,0,17,2264541,0,2,0,648
3,1,2,0,4,2395,0,5,0,625
18,1,17,3,13,37646,37646,35,0,505
7,2,5,0,16,0,0,5,978,640
5,2,3,2,7,189330,19291,55,0,482
28,11,17,5,12,83793,79706,64,54785,446
40,21,19,13,12,659389,82681,162,10460,414
12,5,7,1,6,322738,2214,6,0,677
4,1,3,0,3,0,0,1,1000,600
18,7,11,3,10,42291,30449,32,12939,579
53,5,48,3,8,30260,6415,58,3268,460
18,8,10,4,14,122088,118650,80,4102,525
8,4,4,2,12,25153,25153,117,13409,494
102,7,95,1,6,213317,78,1,78,502
28,5,23,1,14,133141,3109,22,3109,506
9,5,4,4,16,105434,82680,0,0,447
4,2,2,2,4,9656,9656,16,6848,506
13,9,4,7,8,122571,72942,75,3205,527
13,6,7,0,16,166801,0,0,0,675
18,7,11,3,18,195568,87018,44,1878,450
18,7,11,2,14,39052,3684,81,329,528
11,5,6,0,24,31552,0,33,0,612
3,1,2,1,8,8059,3417,5,90,497
20,5,15,1,69,231092,8200,28,0,582
19,5,14,2,17,23269,8621,60,5053,473
34,7,27,3,11,46510,5867,27,3375,531
9,4,5,0,13,17070,0,12,2471,490
9,4,5,1,16,314712,850,2,2101,446
13,10,3,0,7,206860,0,2,0,613
8,2,6,2,10,600372,69460,47,65643,537
14,5,9,5,4,33662,9345,86,4526,454
13,5,8,2,7,23897,8780,26,8656,569
7,5,2,0,6,20077,0,1,200,616
5,3,2,3,13,50471,58471,14,8000,489
10,1,9,0,14,0,0,0,0,541
12,4,8,6,10,190220,272538,92,94667,523
9,6,3,1,6,52971,410,10,0,546
9,5,4,3,9,73835,56131,25,29632,460
80,11,69,6,11,301848,33783,20,7710,449
10,6,4,0,11,102104,0,31,7820,477
13,5,8,0,6,172455,0,4,79,610
7,5,2,4,8,27693,21294,46,12905,464
20,7,13,7,13,253712,66444,0,0,487
20,11,9,6,14,363053,221001,35,11107,458
11,3,8,0,7,50391,0,2,1857,691
13,5,8,3,12,43303,12827,45,1267,576
15,8,7,9,22,79877,75663,28,2952,453
6,4,2,3,11,15642,3094,43,2560,489
11,4,7,4,8,24297,37335,68,8681,425
19,5,14,2,15,30798,196,111,8880,574
29,7,22,1,11,1090816,3263,13,0,560
40,4,36,3,8,11117,9383,22,6347,471
41,19,22,22,15,1219822,1908959,339,674,447
17,7,10,0,9,277394,0,13,0,524
12,3,9,0,7,8892,0,55,3442,621
23,7,16,2,16,48277,35822,48,7476,491
11,8,3,1,9,45274,1760,20,208,579
29,15,14,0,11,229798,0,24,1133,652
12,7,5,1,20,190613,26105,35,2043,628
14,12,2,11,11,242589,14517,18,5555,510
9,6,3,1,4,32033,477,26,477,482
21,13,8,12,8,371422,48719,114,13096,407
21,7,14,3,3,37598,22108,14,15878,463
8,5,3,1,9,12386,8162,26,8162,577
13,3,10,0,21,280082,0,2,5691,519
18,7,11,6,12,105398,517641,164,4238,478
19,8,11,5,10,247229,29801,34,10490,450
11,6,5,2,11,131803,27469,50,1916,584
22,17,5,13,22,1217296,395272,5,1734,459
22,14,8,13,7,503423,117599,55,29680,431
25,16,9,1,10,1854143,444,1,444,579
15,6,9,8,14,808473,262152,167,0,543
39,3,36,2,6,16595,11238,33,10224,538
14,4,10,7,10,21607,72424,14,2980,461
17,13,4,0,5,507341,0,3,0,585
18,2,16,2,7,22897,21805,222,20869,492
7,2,5,4,15,144496,162420,61,44434,514
2,0,2,1,8,391,391,16,391,530
6,2,4,1,14,67249,66691,8,5162,537
20,13,7,0,9,60805,0,1,439,592
3,1,2,0,8,0,0,0,676,680
19,8,11,6,7,69542,19423,100,5444,427
27,9,18,3,9,263202,2163,133,952,422
9,1,8,2,14,2071,4488,26,2417,633
28,8,20,9,8,37913,34796,250,19338,450
47,24,23,0,10,3603687,0,12,0,533
14,5,9,0,9,23663,0,5,0,636
22,6,16,0,8,174796,0,5,4949,567
13,8,5,5,16,443580,316089,108,774,515
25,8,17,4,4,223394,7719,30,4114,495
111,6,105,2,9,429100,19151,66,6791,497
7,2,5,0,6,3318,0,28,153,676
41,15,26,12,26,320475,163308,313,36953,434
10,8,2,2,11,347976,10143,22,2632,477
9,7,2,0,9,4144,0,1,672,686
24,1,23,1,13,95145,8042,28,1985,665
48,6,42,2,16,70015,29219,40,20498,464
16,9,7,7,21,444780,542196,60,322537,441
20,9,11,8,19,572666,364811,126,75224,426
14,5,9,0,16,26793,0,3,2312,473
60,24,36,10,8,215147,11574,57,1296,466
35,9,26,11,8,68285,75566,130,1116331,398
33,9,24,0,13,975558,0,9,0,683
12,6,6,3,11,43383,43383,21,40182,493
8,4,4,0,9,221047,0,4,3085,570
4,2,2,3,13,16521,29914,27,16521,567
6,4,2,3,8,30121,30121,219,19044,525
22,5,17,5,9,41675,22648,27,7711,491
3,1,2,0,4,0,0,0,0,606
10,5,5,3,12,352760,19952,32,12100,391
11,6,5,3,10,234377,11648,19,0,552
19,12,7,4,6,710000,13929,51,7308,425
24,14,10,7,19,348234,90586,185,64401,497
14,6,8,5,21,347191,374166,74,0,552
48,6,42,1,19,19004,4435,13,7686,523
17,5,12,6,19,758355,25271,41,28676,497
6,1,5,0,9,0,0,4,0,634
62,8,54,9,7,68759,70176,122,4619,382
10,5,5,8,8,91654,120871,119,10799,508
16,6,10,2,7,24490,12935,40,11755,494
24,6,18,7,8,34845,39373,97,12964,451
17,4,13,2,9,35774,12428,41,0,621
7,3,4,2,13,141244,69698,34,512,584
5,3,2,1,2,237119,8845,2,1880,532
9,6,3,0,2,553581,0,3,0,612
12,4,8,0,6,0,0,14,0,590
12,4,8,2,9,15976,6769,197,5687,477
22,15,7,1,12,662338,6276,0,0,495
38,12,26,9,11,1211886,435507,140,4733,443
13,10,3,2,21,515867,129480,32,239960,477
4,2,2,1,4,49127,2110,1,1636,514
35,6,29,3,12,124504,26294,16,15507,435
27,10,17,8,17,134925,134925,248,35335,464
7,2,5,1,8,4101,57,2,1583,604
9,5,4,1,4,20850,999,5,0,496
10,2,8,1,1,2932,1415,3,2110,538
16,10,6,5,5,167158,93893,75,360,533
11,2,9,1,7,19085,10887,42,10887,549
6,2,4,1,6,9430,1532,5,1532,504
13,5,8,1,7,11032,142,8,0,656
12,8,4,4,13,67996,33900,0,0,524
6,3,3,3,5,7300,7300,26,3683,502
5,3,2,4,3,10245,10245,211,4059,505
27,7,20,6,10,26965,10594,161,5400,547
8,3,5,3,11,283623,169655,51,146546,513
21,10,11,0,12,319657,0,5,0,542
18,4,14,1,8,23311,3314,32,883,605
59,4,55,2,10,31914,487,9,2972,594
3,1,2,0,1,868,0,0,0,611
13,6,7,6,9,23378,23378,90,10145,542
5,2,3,1,7,2857,2857,55,2940,524
14,7,7,1,11,982708,1218,14,0,513
6,4,2,1,13,174967,31691,22,0,618
57,12,45,0,15,112581,0,8,970,602
11,5,6,0,5,21511,0,62,3922,614
7,2,5,1,15,702,667,9,418,582
10,4,6,2,10,305825,2352,102,16821,449
11,7,4,3,9,63106,41466,46,25325,496
14,2,12,0,14,2756,0,5,1940,716
19,13,6,5,20,357003,37768,138,5905,411
7,4,3,2,8,6755,3519,20,3169,622
50,14,36,2,7,877759,5030,148,3524,486
9,3,6,3,12,26544,35885,25,12873,545
5,3,2,3,7,39407,8134,33,0,454
9,4,5,3,7,50539,26480,179,3040,443
8,5,3,2,15,241710,21360,48,1047,525
4,1,3,0,9,6547,0,21,2864,523
13,6,7,2,11,456211,36840,3,14660,453
10,4,6,1,13,458274,3957,55,129,425
13,6,7,4,10,191812,38127,2,2564,439
33,21,12,7,14,587330,48136,234,19662,419
9,7,2,4,7,19834,16432,75,2705,488
20,5,15,6,8,20773,14777,62,10804,437
13,5,8,4,25,597396,135096,146,38020,621
3,1,2,0,7,0,0,10,0,643
5,2,3,1,8,17924,12071,25,3696,577
5,2,3,1,3,16872,930,2,0,491
25,15,10,7,18,605889,261397,150,7235,447
10,8,2,5,8,51631,41421,36,5591,454
11,8,3,4,5,25426,5674,30,2264,487
12,5,7,0,10,121833,0,6,0,681
18,12,6,0,7,406299,0,0,0,627
11,6,5,3,11,30790,2300,20,7621,488
40,12,28,1,16,594599,26858,341,26858,446
14,1,13,1,7,10927,1945,38,943,512
23,10,13,3,13,809094,90847,42,6467,451
38,8,30,5,9,24446,19626,228,18886,427
10,2,8,1,14,14708,14708,14,14708,519
14,8,6,1,16,431436,91431,23,0,690
5,3,2,2,12,11492,9952,116,7648,538
7,3,4,2,10,6733,16718,4,3192,440
9,4,5,0,5,14900,0,15,1632,435
15,9,6,5,13,308631,43951,85,31883,476
13,3,10,3,15,9394,13002,228,25387,475
18,8,10,0,18,580050,0,6,3022,587
9,6,3,2,4,65292,10124,9,9769,494
14,8,6,4,13,66233,6023,55,2976,528
33,7,26,6,13,10152,10364,137,1453,459
21,9,12,8,17,112489,101064,80,20099,523
9,3,6,6,8,36850,64719,0,0,456
60,6,54,4,8,71720,61963,106,12552,450
11,7,4,1,11,132376,5887,34,0,539
4,2,2,1,4,5398,528,3,619,560
21,4,17,0,13,297457,0,4,12,563
23,13,10,15,18,88627,114404,153,11330,388
17,3,14,3,4,2260,13570,57,6827,546
45,11,34,4,18,318932,11287,87,6798,494
10,7,3,2,18,561477,64883,50,34331,606
38,9,29,3,6,34926,16963,89,2331,434
7,1,6,0,8,11047,0,9,0,644
21,7,14,1,17,317095,687,32,3553,517
6,4,2,5,8,34621,42860,42,2449,413
15,5,10,5,8,5046,5046,292,2091,526
47,18,29,2,14,1931632,2406,67,2422,660
33,10,23,7,10,190043,118970,79,6047,431
17,5,12,2,15,459966,6760,1,15141,467
20,9,11,0,8,363655,0,3,234,653
12,7,5,7,9,40817,25510,78,5970,488
5,3,2,1,2,7071,6311,10,6311,501
49,9,40,6,10,182895,133033,156,51965,427
20,11,9,0,9,478466,0,23,718,605
31,3,28,3,12,496858,3300,150,2503,574
18,6,12,4,15,428235,320640,83,4713,455
16,9,7,1,13,180170,21750,16,21750,667
60,8,52,1,11,199975,12694,54,12694,496
8,5,3,1,30,1363577,86967,40,0,558
29,19,10,20,17,5820634,2241186,434,321335,425
27,12,15,11,9,114468,84726,126,20143,435
81,18,63,5,14,268907,154802,118,46694,551
6,3,3,2,6,46012,4728,7,0,429
9,2,7,2,5,44130,29435,68,1398,478
33,5,28,0,8,241035,0,2,441,625
11,8,3,3,10,361198,13715,66,7004,493
20,8,12,5,13,116538,60040,96,54314,394
22,4,18,2,8,81703,2159,54,2677,527
8,4,4,1,16,34781,1298,5,0,687
14,6,8,0,11,594875,0,2,0,543
6,4,2,2,14,26385,26385,30,24229,529
123,16,107,5,14,513518,20762,55,10350,447
8,3,5,1,10,345269,316,10,5483,530
21,6,15,4,18,39391,36420,333,25740,572
25,11,14,3,12,339819,6009,86,6003,484
6,2,4,3,6,17139,9529,0,0,500
15,4,11,0,9,46337,0,0,0,625
15,6,9,10,7,453909,642393,146,7694,462
7,4,3,4,6,350222,25701,35,16860,486
13,6,7,4,7,541731,12829,66,7206,466
64,10,54,9,15,277067,61101,43,6990,428
21,6,15,5,14,387912,158795,78,7525,446
6,4,2,3,8,362906,24369,46,4814,461
77,18,59,9,18,390891,36248,379,3211,481
12,3,9,0,7,0,0,5,0,660
6,4,2,4,7,1024318,419312,60,246934,434
13,7,6,10,8,162140,170533,260,96047,421
20,11,9,1,13,439764,18176,37,696,546
12,4,8,0,13,56590,0,4,4998,636
15,8,7,8,12,389069,478376,183,49645,540
7,5,2,5,13,23475,23475,159,11600,511
22,12,10,1,4,1436956,1241,6,580,598
11,9,2,5,12,49354,15403,61,0,471
10,8,2,1,10,323500,419,20,419,482
12,5,7,4,20,644887,16035,51,21670,457
21,11,10,0,19,377563,0,2,540,598
11,4,7,0,10,71790,0,1,35,606
41,8,33,2,8,13728,12782,0,0,517
13,3,10,2,7,5063,96,76,250,636
11,4,7,1,16,47225,253,32,2173,497
64,15,49,0,18,383612,0,59,13556,514
11,6,5,1,17,268628,2988,25,4261,484
5,2,3,1,3,5237,4163,4,4163,510
16,8,8,5,19,179307,87342,66,4321,465
13,7,6,7,7,89292,27464,80,1929,437
13,5,8,0,9,619515,0,0,0,628
14,8,6,9,13,35503,36901,226,12197,427
3,1,2,2,11,29719,66989,55,0,590
7,3,4,4,8,10579,12858,59,3696,476
5,2,3,1,12,2444,2444,2,2444,590
5,3,2,5,7,34589,23879,88,12313,438
16,9,7,8,11,542160,296726,148,1600,455
14,4,10,1,10,371783,12680,32,12679,609
8,6,2,3,7,53816,11198,47,7367,515
25,13,12,10,8,517141,235347,170,106074,439
11,2,9,2,5,13881,13881,189,13356,504
14,12,2,1,19,427244,12277,1,12277,578
16,6,10,3,10,553806,31442,42,14094,516
14,8,6,0,13,47663,0,8,0,607
12,4,8,5,9,30254,34101,0,0,517
16,7,9,4,9,319956,16050,367,9844,525
15,10,5,7,9,80802,20939,105,4375,432
48,12,36,7,14,143514,79285,102,26154,416
22,3,19,0,18,96701,0,26,8493,630
5,3,2,3,5,18600,2581,22,1707,380
3,1,2,1,4,16425,1477,7,0,487
41,7,34,2,14,223091,17993,27,17626,563
14,3,11,3,13,8333,13462,45,5389,612
12,8,4,6,7,20560,19363,71,5170,416
10,6,4,1,5,281900,1,7,0,536
3,0,3,0,6,0,0,15,0,570
11,2,9,2,10,902,24405,0,0,599
29,15,14,10,5,87237,35177,85,11978,404
10,7,3,1,17,240431,7046,14,7046,466
36,16,20,15,10,1070493,351666,328,17092,490
58,11,47,1,24,1578291,13572,16,0,583
21,12,9,9,13,79668,44928,167,9117,443
41,2,39,0,12,11020,0,79,6496,624
9,4,5,1,29,1215885,20000,16,4328,533
14,3,11,9,8,24073,59051,343,11305,476
15,6,9,3,14,374982,17985,35,13066,494
14,9,5,1,8,677226,1846,7,0,380
26,6,20,5,9,1429615,163654,93,123803,497
11,4,7,2,13,74991,10685,21,12759,494
7,4,3,3,12,29740,28972,15,6554,428
13,5,8,3,16,266339,29301,22,3292,509
7,2,5,0,14,0,0,0,1281,645
16,11,5,7,9,108237,128781,105,47294,512
9,5,4,1,7,14715,3504,28,3504,450
21,7,14,7,11,63380,24931,117,11123,463
3,1,2,1,13,415,415,1,0,719
10,4,6,1,9,67441,246,25,378,480
18,6,12,8,10,337259,133467,156,8933,465
18,9,9,4,7,105264,36911,30,6057,415
28,11,17,0,19,1024637,0,10,292,602
22,11,11,5,24,261185,90840,94,0,519
10,6,4,3,11,38633,36433,286,21591,507
42,12,30,9,19,465134,254795,265,70427,438
12,9,3,7,14,632689,56056,124,3464,445
9,4,5,0,10,152042,0,6,28,586
47,11,36,4,18,651664,238743,62,185880,529
14,8,6,1,5,89276,658,9,0,576
7,5,2,3,8,35401,31923,14,0,482
15,9,6,8,6,80831,66773,130,22935,469
46,8,38,2,14,67258,4814,26,3428,477
9,5,4,4,6,6117,5366,43,3104,475
4,1,3,0,2,2603,0,0,0,603
9,4,5,2,8,19594,7720,61,4720,541
5,1,4,0,12,7125,0,0,0,626
31,8,23,1,7,253135,16561,38,0,460
4,2,2,1,8,16619,2001,2,2001,409
13,10,3,6,21,508223,55622,0,0,566
87,21,66,7,13,80842,51644,104,4044,412
8,4,4,5,10,106561,54573,43,17219,483
5,1,4,1,8,1219,1219,26,1219,445
9,7,2,2,9,57993,30552,29,0,451
34,9,25,4,10,32405,1788,242,2573,432
12,9,3,11,14,45635,59486,115,8909,356
30,5,25,1,8,119018,2412,22,2412,536
11,5,6,4,6,46696,16635,103,5390,432
47,11,36,1,17,363578,2359,14,300,463
33,5,28,5,8,56696,39614,410,12252,476
19,2,17,2,10,10110,10110,27,5055,531
212,6,206,4,10,32119,2146,60,1745,550
24,12,12,3,8,58113,4709,19,2203,531
33,10,23,4,10,103534,20594,176,17520,435
15,3,12,3,10,10282,1635,35,5000,537
35,9,26,8,18,38704,42879,359,19794,489
2,0,2,0,6,0,0,0,50,641
30,15,15,12,36,189500,152346,162,7366,474
7,4,3,0,6,5650,0,0,0,634
15,8,7,4,13,183096,42321,209,1050,447
5,2,3,1,6,41252,9020,3,9020,473
10,2,8,1,11,6624,6624,102,10811,520
13,6,7,2,19,293045,16993,28,13942,561
12,1,11,2,7,8964,4804,11,732,517
7,3,4,3,6,42785,28925,59,15280,452
9,5,4,7,11,288226,35696,119,4534,490
5,0,5,0,3,0,0,5,0,553
48,24,24,3,21,411288,15203,56,12998,495
12,6,6,3,14,747329,8949,51,1521,524
11,5,6,0,13,231867,0,12,0,667
28,10,18,1,12,667267,17120,22,10187,496
60,8,52,5,19,57495,32281,71,11583,441
46,8,38,7,17,132049,120141,45,15806,489
8,6,2,6,13,318427,16512,66,3088,479
26,8,18,3,10,58260,89580,35,183,594
7,2,5,3,8,45261,30230,76,17258,495
39,9,30,7,13,33011,29277,163,5820,421
16,9,7,1,16,121775,173,109,1233,554
11,7,4,2,17,233868,22669,12,771,480
14,4,10,0,9,56526,0,34,0,624
10,3,7,0,69,1000,0,68,3220,652
15,7,8,2,15,54886,25955,119,2527,500
13,8,5,1,9,57349,1103,3,0,604
36,12,24,7,69,336432,58658,187,10550,417
6,0,6,0,11,0,0,15,255,653
5,3,2,2,2,31009,11249,6,9828,424
52,20,32,11,17,940830,40412,151,7807,453
13,6,7,7,10,62088,71779,131,15056,465
7,2,5,0,15,24106,0,0,0,638
16,5,11,7,12,116240,99645,78,30,476
8,4,4,3,18,20116,20114,61,12281,449
6,4,2,3,3,44353,5233,72,998,471
10,7,3,1,13,103181,772,0,0,576
17,12,5,11,22,27501,25005,55,331900,478
13,6,7,3,8,346022,19455,25,0,456
21,11,10,1,8,81558,2265,54,2265,522
17,6,11,2,12,35973,20197,47,3553,446
9,6,3,5,7,72892,12656,59,3470,343
19,7,12,7,18,47888,59450,16,14163,454
13,6,7,5,8,74300,61724,241,30281,447
12,6,6,2,19,378118,7394,43,7066,526
39,10,29,1,13,111301,1045,222,2494,531
24,10,14,9,7,62554,15500,119,2423,407
5,3,2,2,11,15888,15888,114,11750,567
9,2,7,1,9,15322,8655,144,1654,507
13,6,7,2,10,124083,34229,22,33033,536
9,5,4,0,5,49990,0,3,229,638
9,3,6,4,13,46351,57719,0,0,504
4,1,3,0,8,52731,0,13,0,576
12,10,2,0,36,356208,0,28,0,538
7,4,3,5,7,66416,69353,47,43484,486
23,9,14,1,4,106758,7030,3,7030,574
20,10,10,1,12,401235,6938,30,0,470
8,6,2,0,8,180969,0,12,0,575
36,11,25,0,12,163575,0,147,2095,586
11,6,5,5,12,475083,71394,90,18936,427
17,13,4,1,6,127026,244,7,0,535
22,6,16,4,9,399025,50417,30,0,439
19,13,6,15,5,41125,52340,469,8372,431
12,3,9,2,13,50197,27283,58,0,545
12,5,7,3,8,21227,4397,52,3389,486
16,7,9,11,8,140512,149796,187,32513,486
17,6,11,3,7,12215,4470,53,1975,454
17,10,7,1,11,465925,2354,9,0,526
25,16,9,8,8,322808,57413,141,25482,382
50,6,44,5,7,94032,61385,77,11090,442
13,5,8,1,10,40984,226,41,518,512
3,1,2,2,9,29944,37942,7,1921,678
16,7,9,3,4,27472,1460,13,947,518
37,10,27,8,15,207529,43742,169,3874,469
50,13,37,6,13,365135,25067,76,8957,500
18,10,8,5,8,60094,6990,42,4225,445
22,9,13,3,6,121515,2777,11,1232,504
25,9,16,4,18,84360,69209,46,63413,469
9,4,5,5,19,54969,72883,105,35584,502
11,5,6,1,7,95838,1024,15,429,603
4,2,2,4,15,24886,26447,37,21123,565
21,6,15,2,13,409499,39729,42,24596,510
25,17,8,0,32,637677,0,33,0,503
27,13,14,1,14,189951,32782,63,0,582
5,2,3,0,8,27933,0,13,0,629
40,12,28,3,15,838366,3730,7,3434,545
9,4,5,1,12,143351,8826,27,8826,580
4,2,2,2,10,345452,10306,23,0,620
4,2,2,0,2,14151,0,5,1687,530
10,2,8,0,4,15742,0,0,0,630
46,8,38,6,16,156283,42600,95,14200,464
17,14,3,1,9,125813,798,13,971,511
9,6,3,5,5,166553,13219,46,6117,479
10,6,4,1,6,33101,906,19,906,433
16,7,9,5,7,33094,8326,76,4332,463
5,3,2,3,7,4654,22236,20,0,463
17,5,12,3,14,40550,11366,57,2424,498
22,11,11,5,21,52003,17776,8,15946,434
11,1,10,0,4,740,0,5,449,610
17,11,6,2,10,1087009,4952,7,517,509
27,4,23,1,7,12828,3110,6,3110,526
7,5,2,1,9,222780,2859,23,1638,540
5,2,3,2,5,21651,27817,24,21038,495
7,5,2,1,7,1192,591,12,591,543
16,10,6,1,15,112399,42795,52,0,612
16,13,3,12,9,107711,104218,51,28270,401
40,11,29,7,8,89786,79604,363,48344,456
23,10,13,0,16,696928,0,0,0,691
8,5,3,2,13,277529,4359,2,2810,666
40,13,27,0,17,791257,0,28,4797,533
10,8,2,7,7,278593,145681,84,51317,518
14,6,8,5,6,50618,42310,121,3162,452
23,20,3,0,5,2358157,0,0,0,632
6,2,4,3,5,10623,23903,59,4410,436
29,5,24,3,17,28915,28572,154,14736,517
25,9,16,8,14,417958,53895,132,24303,431
29,17,12,6,6,372442,16601,61,9310,449
8,5,3,7,5,209774,171877,89,17989,456
16,6,10,5,17,150349,153422,63,15333,480
15,9,6,2,7,29916,506,100,720,476
23,4,19,1,11,20216,131101,18,569,592
3,1,2,0,7,17102,0,12,3077,630
12,9,3,3,10,1357962,33128,20,0,447
16,5,11,2,9,92632,49074,39,1189,493
7,4,3,2,18,454693,60038,36,9959,592
7,4,3,0,5,229362,0,0,0,550
29,11,18,9,11,404968,86317,218,57053,439
19,10,9,7,11,85080,55280,180,16131,422
13,6,7,1,13,75531,114,6,737,616
11,5,6,6,14,617780,121008,92,67080,438
22,5,17,7,13,337276,233656,0,0,449
57,5,52,3,4,55691,62120,64,0,453
23,11,12,5,18,224019,15587,40,6221,471
35,10,25,8,17,477843,188853,83,5889,458
10,8,2,9,4,44106,63392,106,2457,450
15,7,8,6,20,220579,37728,78,15052,425
17,8,9,8,7,37984,34902,79,9572,451
9,6,3,0,6,44999,0,0,0,544
18,5,13,5,9,43862,51327,340,13144,498
12,2,10,0,6,10160,0,0,0,602
12,6,6,2,22,265823,14988,38,13851,514
8,4,4,3,6,30974,11230,147,6671,497
7,5,2,4,11,27369,18075,97,349,560
14,6,8,0,4,188375,0,2,6775,647
8,5,3,4,14,8085,11325,0,0,497
12,3,9,0,13,81121,0,0,414,689
20,14,6,1,13,942326,54976,11,0,504
9,3,6,0,5,11260,0,4,399,601
44,13,31,10,8,39475,12310,215,5909,451
5,1,4,0,12,0,0,0,2766,726
3,1,2,1,5,3909,2915,21,0,645
19,5,14,6,12,83390,104297,92,18345,572
14,6,8,1,15,176132,14027,17,1005,544
50,9,41,2,13,149804,4825,22,8700,484
18,12,6,4,7,149286,95156,62,55982,456
11,7,4,7,13,180800,175622,60,86145,471
38,14,24,6,12,195529,40418,146,7100,455
27,12,15,0,7,1047549,0,2,0,590
53,6,47,1,9,127246,117129,56,3173,497
14,8,6,4,13,147542,39970,82,19224,521
11,7,4,8,7,41601,492611,2,2117,448
21,3,18,2,11,584038,574038,14,175840,508
9,4,5,1,3,32682,16505,7,0,464
7,3,4,1,12,82122,11024,26,11024,577
7,4,3,0,9,20256,0,4,0,501
10,5,5,0,5,9064,0,0,0,594
4,2,2,0,21,10450,0,0,0,639
17,7,10,4,12,75634,67995,1,1006,446
27,6,21,6,9,33811,23975,81,20262,454
7,4,3,2,8,25021,5260,0,0,477
47,8,39,4,9,92645,16022,0,0,501
20,14,6,17,10,832443,448677,130,149044,439
10,5,5,5,14,121684,49614,67,25786,396
13,7,6,9,5,63581,61073,107,18454,413
9,6,3,2,19,13693,12926,39,0,465
6,2,4,2,6,346128,27729,32,0,598
26,14,12,16,9,165554,188516,157,9773,423
11,5,6,1,17,22379,4349,31,6218,415
42,20,22,12,17,690095,91171,217,7048,424
17,8,9,3,8,50043,7227,43,6190,477
10,6,4,6,11,341278,169360,0,0,442
6,1,5,0,8,0,0,24,1632,565
16,3,13,1,9,3294,694,47,18332,513
46,15,31,2,10,199493,20325,45,5826,550
19,5,14,3,14,17192,9053,74,10239,496
4,2,2,2,9,5582,5582,12,4786,532
29,3,26,3,19,44225,32982,33,12380,471
8,2,6,2,15,63671,63671,50,6604,483
5,3,2,4,6,18916,18595,72,8108,542
16,5,11,2,10,263105,11138,38,5897,470
7,5,2,3,5,147074,59596,41,6340,456
33,4,29,2,9,16768,9028,29,6881,622
24,10,14,4,11,577465,9539,47,8244,459
37,18,19,13,25,79817,69430,256,8684,483
7,5,2,0,8,48400,0,0,0,607
107,13,94,5,14,139791,78720,224,21966,455
22,4,18,0,1,12438,0,3,2900,412
8,6,2,2,7,11036,365,47,669,504
10,3,7,1,19,359848,18345,41,32158,521
15,6,9,4,16,413285,29221,98,17009,535
9,4,5,2,14,13708,5738,51,0,531
12,3,9,3,16,19152,19152,283,15070,480
14,2,12,1,13,67438,67438,23,67438,640
6,2,4,3,6,12531,13315,0,0,467
52,5,47,6,12,452828,144366,135,6904,400
11,5,6,3,15,72810,17152,30,10047,509
17,8,9,0,17,415722,0,12,2725,575
28,7,21,2,13,910356,35973,41,11949,392
8,4,4,2,13,7716,6886,71,1250,545
14,9,5,3,9,940521,109409,43,0,469
11,3,8,4,10,75228,69410,47,4306,575
5,2,3,1,10,17172,17172,0,17172,626
10,1,9,1,7,1389,1389,33,1389,537
8,5,3,5,10,23161,23161,60,6008,423
11,6,5,0,10,104685,0,0,0,706
35,3,32,0,14,489528,0,42,1924,731
14,7,7,3,17,38899,23139,33,19182,414
6,4,2,3,3,10978,6756,27,4636,460
23,7,16,2,7,94979,15950,23,13338,480
12,9,3,0,11,185498,0,1,0,662
9,7,2,0,29,91642,0,0,0,709
14,2,12,1,13,8229,7229,95,10646,511
6,2,4,2,6,238,476,22,2585,533
26,8,18,7,10,177909,129286,171,11765,471
6,4,2,3,17,48581,16781,12,14405,513
17,10,7,4,13,476116,41927,57,15326,465
7,4,3,6,9,214007,218645,35,54215,458
7,5,2,4,7,41963,35202,66,29165,451
12,4,8,2,36,7319,59278,36,918,623
10,6,4,1,5,66645,560,7,909,571
19,10,9,6,13,185141,83552,47,75182,440
9,5,4,3,7,345157,10926,0,0,460
3,1,2,1,5,723,723,6,0,476
13,2,11,2,17,66730,68128,37,544,509
25,4,21,2,7,27543,13020,63,1033,468
11,4,7,3,11,6283,5660,36,2284,543
8,2,6,6,7,81338,181513,68,0,549
22,1,21,4,9,147845,307709,77,0,593
25,13,12,0,15,230176,0,2,6714,540
10,6,4,0,5,32884,0,0,0,630
27,7,20,6,9,77353,28324,139,9952,432
10,7,3,7,18,119683,60382,102,4670,464
8,4,4,2,8,34607,15615,60,1125,551
17,9,8,4,12,193402,5095,15,10226,433
5,3,2,5,5,364220,489548,84,181885,438
15,2,13,1,8,4088,4088,168,4018,445
19,5,14,5,19,66949,66947,321,21268,509
18,5,13,2,17,428869,11779,33,3949,697
6,4,2,1,16,242430,2049,10,2049,600
41,3,38,0,9,44571,0,29,236,627
7,5,2,2,11,55650,12572,41,15871,481
9,7,2,4,7,89034,31123,46,17973,528
13,10,3,0,10,581636,0,29,12773,557
3,1,2,2,7,3371,9916,0,0,502
7,4,3,4,5,39081,42128,19,4836,438
14,12,2,5,9,332992,27484,328,22668,433
17,6,11,5,8,92009,99714,112,429,519
5,2,3,1,2,5354,535,14,0,610
4,1,3,1,7,380,4406,30,0,585
6,2,4,5,17,30294,33385,23,5463,569
17,5,12,2,9,135032,13315,43,10187,491
3,1,2,0,3,3721,0,0,0,555
9,3,6,3,14,8248,37584,111,29337,551
10,6,4,0,17,276620,0,0,1572,664
19,5,14,5,7,209097,32139,38,11666,429
5,0,5,0,6,0,0,8,0,642
21,8,13,7,8,21127,15907,48,10524,441
13,5,8,0,10,0,0,5,291,607
8,2,6,0,14,6570,0,0,18617,650
6,3,3,0,9,72499,0,21,1100,625
4,2,2,3,9,2362,3441,0,0,499
18,9,9,5,26,1053765,51501,67,34255,464
40,12,28,7,15,591373,69222,332,3355,434
10,6,4,0,8,322051,0,0,0,681
9,7,2,1,4,82631,280,4,0,575
11,7,4,5,8,44187,16407,115,7654,454
9,0,9,1,18,0,1973,9,11980,451
11,4,7,2,10,75193,5701,18,9067,453
7,4,3,0,12,0,0,9,0,619
7,4,3,3,6,16858,6844,38,0,480
24,12,12,7,9,110011,57177,20,3755,429
6,1,5,2,7,2822,8089,10,2822,591
42,12,30,0,29,544424,0,1,6159,545
13,8,5,4,6,416570,7067,68,526,491
19,6,13,2,14,516709,13197,48,0,499
15,2,13,2,11,3667,3667,47,2694,576
16,7,9,7,9,45106,35378,408,19200,487
15,8,7,12,10,166273,206120,0,0,480
12,2,10,0,12,853,0,0,1477,612
7,2,5,1,12,50295,18892,42,11718,613
40,14,26,8,7,500574,54814,160,41782,444
56,10,46,9,8,217023,47106,251,9290,418
13,7,6,0,12,506425,0,3,3457,517
33,8,25,2,11,176433,5245,161,2937,494
4,1,3,1,10,3540,999,6,13571,486
18,4,14,2,8,16580,16580,40,595,617
11,5,6,3,12,447702,25758,40,22573,494
13,2,11,1,15,7625,7625,2,1382,592
7,3,4,1,8,8016,18776,43,0,541
19,12,7,0,26,272739,0,17,2339,524
4,2,2,2,7,27663,26014,8,910,483
23,12,11,8,14,113885,57002,165,16214,492
6,3,3,2,5,16341,10885,176,9460,505
6,3,3,4,6,2931,6070,69,844,507
25,10,15,1,11,58322,436,52,436,474
28,5,23,1,10,86171,4945,11,4945,545
23,11,12,2,9,495688,8728,10,4705,478
13,8,5,0,32,151665,0,0,0,670
9,5,4,0,11,19324,0,49,2144,559
4,1,3,2,5,9451,5833,9,4782,651
4,2,2,0,4,345467,0,0,0,566
21,7,14,0,13,241362,0,5,177,486
9,7,2,1,19,189627,1043,0,0,507
11,6,5,2,12,15708,4494,55,1514,447
13,8,5,0,17,20783,0,0,1347,630
6,4,2,3,8,164084,6044,37,0,517
27,11,16,2,13,40396,1921,32,7373,497
22,6,16,0,8,23623,0,73,2228,579
17,11,6,9,13,459800,353745,150,99076,446
10,8,2,8,7,56494,66260,143,19592,430
14,8,6,5,8,16254,13622,59,8767,456
20,2,18,2,10,9116,3449,35,6645,447
9,5,4,7,12,489099,57964,85,16493,463
18,6,12,2,16,232927,15892,108,24474,458
25,8,17,2,8,47770,599,26,3696,464
4,2,2,0,10,181049,0,1,0,604
45,10,35,5,10,1632171,23879,69,7387,428
21,7,14,3,17,397414,25619,56,14376,557
8,5,3,0,10,24237,0,0,598,607
41,10,31,5,18,36599,33309,311,17435,525
41,16,25,0,69,444779,0,19,4210,667
16,8,8,1,16,726693,1553,7,2457,565
21,5,16,2,7,31679,141,268,441,518
11,5,6,1,19,10472,845,12,1739,492
8,5,3,4,9,18433,11845,26,7566,439
14,8,6,6,8,59042,42356,104,15438,436
40,6,34,4,13,605544,26985,58,11799,490
9,7,2,1,9,53258,311,1,0,610
6,0,6,1,7,23520,23520,153,2292,507
9,3,6,2,10,43552,17912,54,778,554
11,5,6,3,13,225907,83767,75,0,528
9,5,4,3,6,54053,3528,29,1997,503
9,6,3,7,9,673812,186786,128,97705,460
12,4,8,2,6,34533,2446,42,0,488
27,6,21,1,19,80571,485,7,8841,427
70,22,48,13,18,658038,62105,183,11143,382
38,3,35,1,8,20768,3564,70,3564,595
8,5,3,3,16,952500,391002,57,81139,506
5,2,3,0,19,381060,0,1,0,619
6,4,2,4,12,43801,43801,81,15756,418
17,9,8,0,7,274225,0,32,0,459
19,6,13,5,7,242554,20256,130,8343,446
10,2,8,0,20,0,0,40,0,594
26,17,9,9,13,67445,60350,114,11913,414
26,10,16,9,47,332918,77702,201,21919,395
51,20,31,9,10,383384,51444,421,9777,411
10,4,6,1,12,50722,14054,14,14054,570
6,3,3,0,7,156789,0,10,0,607
13,9,4,4,15,7187,22724,81,4884,464
23,10,13,1,8,43042,1308,13,1972,413
27,10,17,0,7,324816,0,11,435,609
76,9,67,5,9,60535,33028,118,26760,452
20,12,8,3,13,373146,38064,72,16520,464
35,15,20,0,12,322280,0,1,2959,642
7,4,3,0,6,27055,0,0,0,599
3,1,2,2,7,3446,9235,40,0,490
7,1,6,2,7,18144,18144,137,15213,623
31,9,22,4,10,82774,85658,104,23067,518
9,6,3,5,9,24667,18738,97,699,438
10,3,7,0,3,65897,0,1,2378,595
14,5,9,5,12,163755,56035,51,0,526
8,4,4,5,5,12269,14867,56,4470,401
29,8,21,5,9,487576,31173,177,22650,438
27,12,15,16,16,2169941,2434107,271,617230,478
6,1,5,0,12,55566,0,0,13438,645
26,15,11,1,26,592049,322,10,1025,523
29,12,17,1,9,288553,6567,34,13134,615
17,5,12,1,12,302322,759,23,388,558
12,5,7,9,11,85181,136048,0,0,517
31,9,22,6,20,992467,159353,170,29470,475
42,17,25,4,14,334077,11344,75,569,522
16,10,6,10,4,294469,39551,134,9738,392
7,3,4,2,7,22084,1905,31,1243,609
13,5,8,1,15,70258,67062,64,0,553
19,7,12,8,12,71676,197782,202,635,535
23,11,12,10,19,1059155,367495,218,268564,429
16,5,11,1,3,82169,1014,2,1014,509
35,7,28,0,10,426054,0,17,2884,532
17,10,7,4,9,417821,67116,3,2028,514
17,8,9,2,8,54712,12126,38,0,505
15,9,6,4,3,146482,3278,4,1414,465
17,11,6,1,7,34252,284,7,284,579
15,6,9,2,10,31053,9892,104,7680,526
8,3,5,5,5,35629,40679,85,1411,457
13,2,11,1,8,39528,3000,33,8803,600
14,7,7,1,19,731177,164902,3,164902,517
12,9,3,5,6,694075,69142,49,0,460
7,3,4,4,8,11580,11560,57,2128,481
24,8,16,2,15,242587,3911,45,20786,525
14,5,9,0,14,166374,0,1,0,620
2,0,2,0,13,0,0,28,0,588
13,6,7,12,8,75442,127577,26,11971,486
34,18,16,2,14,480981,179,29,406,559
15,8,7,5,15,155286,49307,82,25473,446
17,7,10,1,13,77530,1919,29,1777,460
8,4,4,1,13,214605,15255,7,5564,436
6,2,4,0,15,1628,0,0,0,621
12,3,9,4,13,117309,117309,56,1142,598
10,5,5,4,14,18986,18986,68,16302,533
14,10,4,1,9,116422,2028,3,2028,513
8,1,7,1,11,27103,10958,12,10958,579
30,8,22,4,16,61800,131185,49,3287,440
18,16,2,0,14,199725,0,0,0,696
111,3,108,0,7,11060,0,3,0,700
22,12,10,9,16,49145,46054,0,0,541
11,6,5,0,5,103685,0,14,291,565
10,5,5,3,8,19968,24088,1,4371,454
36,13,23,8,18,172583,120788,242,31249,450
21,10,11,1,11,37770,686,14,4883,423
30,9,21,3,14,176068,22934,44,358,571
4,2,2,2,8,44903,28612,32,0,503
14,8,6,1,14,194769,465,5,11,594
28,10,18,5,13,167765,26240,42,17056,444
16,8,8,6,16,53259,52289,139,9441,418
14,7,7,2,12,8007,4291,62,33947,437
15,8,7,1,14,206268,509,2,0,533
18,5,13,4,13,21089,16508,47,9209,371
6,4,2,2,3,37975,7801,19,0,500
20,6,14,5,8,19490,18720,224,21768,502
46,13,33,0,14,1080154,0,11,913,595
24,5,19,0,9,11349,0,11,5609,524
7,1,6,1,10,55355,55355,10,55355,558
28,12,16,8,11,504528,42313,123,21778,426
24,15,9,2,12,565814,3255,16,1528,589
21,5,16,7,10,64074,78434,152,27913,456
5,3,2,4,7,5895,12439,45,3416,518
4,2,2,1,5,8879,411,2,0,688
7,5,2,4,10,16311,16311,39,11650,551
11,7,4,6,18,66928,47780,134,9386,424
21,18,3,19,14,169429,226170,78,120012,499
98,8,90,3,11,129611,4667,268,6180,419
42,7,35,0,13,30906,0,85,8984,478
15,5,10,2,23,11460,11140,55,11945,428
11,9,2,8,7,105450,104065,125,17775,417
6,3,3,0,8,8506,0,0,0,469
18,11,7,7,9,327011,45410,133,1285,486
14,10,4,1,13,136888,1475,49,1475,487
14,9,5,1,11,121863,853,19,1192,508
5,3,2,3,8,10857,26096,41,8069,489
3,1,2,0,10,0,0,0,1000,700
34,10,24,9,8,46490,59484,108,26915,423
18,10,8,0,26,165800,0,43,284,634
12,8,4,1,12,447479,2433,19,2433,529
44,6,38,4,7,7601,1187,271,662,568
34,16,18,7,14,811444,187860,201,69104,444
8,3,5,4,10,167073,538472,84,167073,484
15,7,8,1,8,235599,321,69,1780,618
5,3,2,1,17,31428,3778,25,3778,488
17,13,4,0,17,1524456,0,8,11181,482
12,6,6,5,11,279300,6805,77,4582,489
10,5,5,2,21,1642,540144,3,800,570
5,0,5,1,7,0,1439,38,0,504
87,9,78,5,27,92745,92745,668,27761,481
5,3,2,3,4,9452,8518,52,4036,438
8,5,3,3,9,441591,28133,100,3969,498
22,5,17,3,19,48288,30329,26,5836,469
23,17,6,2,5,25358,9602,30,1886,517
14,7,7,2,18,192532,8373,54,256,512
14,6,8,0,10,573144,0,0,0,632
27,16,11,0,22,660889,0,30,0,565
10,6,4,5,5,170812,101461,11,13453,441
5,3,2,2,16,373830,6295,10,4138,550
3,1,2,1,12,8225,8225,25,0,542
113,8,105,5,35,108022,35111,188,6420,473
11,4,7,3,9,220822,10837,37,5301,423
13,5,8,7,8,34710,48486,112,5958,485
32,11,21,2,7,48175,1286,111,2752,474
45,16,29,0,15,635364,0,8,0,628
6,4,2,3,12,96463,1964,77,0,652
36,12,24,8,14,298962,55506,425,14938,424
36,6,30,0,8,600931,0,0,0,615
12,6,6,4,9,12362,9275,140,11742,415
12,5,7,5,7,37298,37193,269,3326,450
30,12,18,11,8,94711,36626,678,2448,451
10,2,8,2,11,33070,32608,16,31915,458
7,4,3,1,11,94135,1332,7,4205,620
7,3,4,2,15,239708,4846,9,2820,440
9,5,4,2,18,76773,29172,28,8319,537
37,10,27,3,14,204222,44811,18,39555,424
11,2,9,1,5,7218,1399,3,0,677
6,2,4,1,5,12121,1859,12,6000,659
18,9,9,3,18,794633,2505,13,84,535
12,1,11,1,6,1085,1085,75,1085,582
4,1,3,1,10,57381,57381,22,0,606
16,10,6,9,6,52512,52512,174,16113,494
10,5,5,3,5,62569,49551,32,4751,494
10,6,4,10,8,140940,201533,0,0,440
73,18,55,7,11,333360,30886,99,350900,553
14,7,7,11,4,291407,336109,177,26740,452
5,2,3,1,8,301571,1624,7,0,535
6,2,4,4,13,11113,51605,30,1809,528
13,8,5,6,8,751798,171654,80,2171,504
8,4,4,0,13,282648,0,1,10645,589
11,8,3,6,7,139901,93524,90,42555,425
9,1,8,0,5,25571,0,204,12943,442
7,4,3,0,8,259685,0,36,3418,536
10,6,4,8,5,29699,31978,220,8442,436
10,4,6,2,4,25185,4160,4,3973,444
15,8,7,0,9,70237,0,8,370,657
7,2,5,1,13,43243,2659,24,2659,537
7,2,5,0,7,9046,0,6,114,625
24,3,21,2,9,108242,9840,0,0,568
15,7,8,2,13,99886,5649,6,3387,464
23,17,6,0,15,1692684,0,0,672,639
11,2,9,0,8,34343,0,21,5231,624
14,6,8,1,4,66168,1278,3,1278,501
24,8,16,3,8,108782,93909,81,27579,465
9,4,5,1,14,1151,1151,9,2430,486
5,3,2,2,17,40234,40234,0,0,502
9,4,5,4,10,69988,38464,62,6380,447
75,8,67,13,22,1195238,400628,425,6531,434
23,8,15,0,20,312027,0,3,3000,591
22,17,5,1,26,579428,691,15,691,674
17,8,9,1,17,142478,3945,33,24094,521
24,7,17,4,16,902344,15333,35,24824,455
17,8,9,4,11,44206,24207,7,8188,440
23,5,18,0,9,130922,0,32,0,528
7,4,3,2,10,33719,33719,0,0,595
83,8,75,1,8,197964,9611,36,9611,507
3,1,2,0,10,0,0,0,0,661
8,4,4,0,5,38378,0,6,0,515
6,4,2,0,19,50126,0,11,2633,711
9,6,3,0,6,112058,0,5,0,510
7,5,2,0,5,56072,0,3,0,484
49,26,23,2,21,379166,5087,55,619,507
14,5,9,3,8,43237,37726,68,15700,517
47,4,43,2,15,135187,104355,25,5866,555
7,4,3,2,11,11441,3735,10,2898,547
22,12,10,4,9,287785,46247,29,38524,414
19,7,12,3,6,12815,9327,58,2858,514
22,9,13,0,18,324800,0,21,465,611
10,7,3,5,10,471429,54636,41,6456,457
20,6,14,3,18,366915,15082,20,9552,561
5,2,3,3,17,38978,71649,42,33039,576
8,5,3,6,15,76353,80828,223,68473,448
9,3,6,3,6,153417,5305,32,1425,602
14,8,6,8,12,456989,126259,18,16188,575
20,8,12,6,14,78831,78831,323,14286,444
33,8,25,2,17,559125,1933,26,27312,526
26,4,22,1,6,53919,16522,42,454,549
50,9,41,8,7,642262,330907,55,10007,389
28,11,17,3,7,635243,14914,48,7311,421
8,2,6,3,9,26711,33670,31,9277,613
23,5,18,7,13,60223,82597,302,28384,516
4,2,2,1,8,9709,9709,25,149,539
10,1,9,0,5,104496,0,0,0,635
20,4,16,0,7,223353,0,14,3000,639
14,10,4,3,5,308229,7667,6,0,534
6,3,3,0,13,27626,0,1,3000,640
6,2,4,2,12,15806,15806,45,1087,530
12,8,4,2,12,1220323,18068,0,385,469
7,4,3,4,9,43425,22104,28,11960,430
8,6,2,4,5,193649,79709,42,6623,427
17,8,9,6,8,303156,88196,112,30027,468
20,12,8,9,21,1309354,1246178,48,41581,531
19,11,8,2,11,46952,20685,41,13791,449
17,11,6,4,8,756654,38038,81,1380,439
7,1,6,0,11,12826,0,0,0,644
6,2,4,3,8,26566,13648,6,317,582
9,1,8,0,4,2745,0,8,0,623
14,6,8,5,13,25187,26290,62,9083,543
18,13,5,11,7,98155,92199,253,15526,391
98,14,84,4,10,556717,30594,89,17134,485
16,10,6,4,13,108892,47904,88,1270,492
15,9,6,6,7,235008,5316,312,2459,443
5,2,3,2,8,38060,34567,94,276,517
13,3,10,3,20,55713,76806,77,0,492
7,4,3,5,7,125800,125800,136,7200,474
14,10,4,8,11,66158,56601,140,15551,463
41,14,27,7,17,436543,62503,65,10020,444
22,11,11,8,13,76960,80202,149,14643,451
13,7,6,5,19,844278,194480,132,135255,391
37,7,30,2,12,133983,24338,235,23848,512
12,9,3,1,24,2725966,2410,11,14472,520
50,8,42,0,9,155093,0,7,22138,460
7,4,3,2,5,93165,10358,17,8958,502
15,8,7,0,6,650024,0,3,0,608
8,6,2,0,7,50782,0,6,57,569
15,3,12,2,18,404782,5766,18,390,652
12,6,6,4,9,53140,4515,66,971,436
12,3,9,2,6,400,8338,64,6838,472
8,3,5,0,7,46507,0,71,13663,469
6,3,3,0,4,11021,0,0,0,673
17,4,13,0,18,135086,0,0,0,652
38,14,24,0,11,692598,0,46,3285,661
39,14,25,11,20,860188,407410,0,0,453
9,6,3,1,11,527578,1239,17,33,598
143,8,135,2,12,168042,30824,24,7989,613
8,6,2,2,15,174285,198425,21,137736,621
14,3,11,3,12,11427,10688,52,4336,510
17,1,16,1,15,0,2266,18,1200,662
85,12,73,0,9,167335,0,59,1389,571
19,13,6,13,13,203773,197491,174,109441,411
14,7,7,10,10,446899,109467,168,23439,445
22,6,16,2,16,143512,30177,55,0,474
15,11,4,8,5,141466,138068,112,2753,474
15,3,12,2,13,59859,8966,33,0,495
13,10,3,2,9,436700,1384,4,692,613
9,6,3,3,14,448301,28051,29,14964,529
6,2,4,2,10,34350,29547,53,0,476
7,1,6,1,5,689,656,19,0,703
13,8,5,4,16,38142,29629,41,3453,454
13,6,7,0,14,583000,0,0,2524,553
35,22,13,19,11,68515,47720,69,8921,488
12,2,10,3,7,9719,12606,112,3772,566
37,11,26,5,14,145468,130367,137,6505,495
7,4,3,3,69,29314,29311,48,4053,518
25,11,14,9,12,48038,29513,358,12472,411
36,14,22,9,18,317314,149394,136,32138,471
26,9,17,2,12,386335,541,50,2159,471
26,15,11,0,5,87412,0,6,1079,631
5,3,2,2,6,11162,4675,5,2066,442
11,8,3,8,17,44610,38939,154,15030,614
30,13,17,6,8,138169,18611,316,8245,557
39,24,15,13,29,236120,73579,108,7504,442
14,8,6,5,12,432655,48335,82,22711,409
9,7,2,7,8,55858,61438,0,0,579
12,4,8,3,13,13709,13709,79,7222,559
29,14,15,5,15,106353,64701,53,559,516
10,8,2,5,8,52719,21957,26,9158,480
64,24,40,12,15,378414,94824,267,13955,428
6,4,2,4,4,16745,12827,1,281,428
5,2,3,2,13,149411,36591,36,30443,490
39,11,28,10,9,61716,61490,372,19639,440
10,6,4,0,8,81929,0,2,0,595
32,9,23,4,20,307022,28010,124,10315,515
25,14,11,5,13,404094,22446,43,0,402
6,4,2,0,11,21470,0,0,0,543
41,2,39,1,17,3060,3060,48,1329,643
11,8,3,7,16,560811,115517,111,62525,411
11,6,5,5,8,32590,25994,113,6122,489
18,8,10,1,28,433151,3910,9,0,575
13,5,8,0,13,206230,0,20,0,606
12,1,11,1,35,0,2702,25,702,720
5,3,2,2,8,58643,39771,36,0,495
21,16,5,16,11,85485,95567,176,24140,556
13,11,2,6,12,61745,50771,80,32337,425
20,13,7,10,8,51803,29012,261,5404,433
17,11,6,13,8,37442,59691,214,24399,427
15,1,14,0,11,9621,0,9,1347,656
21,11,10,1,23,652778,1640,8,0,609
22,4,18,2,13,222290,10313,30,7246,612
6,4,2,5,13,62853,54575,102,0,517
20,4,16,1,13,508909,1447,2,3795,508
12,6,6,6,10,84583,78336,132,20840,539
32,19,13,3,18,657820,31576,39,2805,408
13,4,9,3,13,87011,85070,58,35275,526
24,6,18,5,13,126716,162234,123,61526,489
28,5,23,5,14,122140,36832,85,10920,488
12,9,3,3,31,640867,25558,15,16479,615
9,6,3,7,7,15053,20711,346,8743,412
15,10,5,11,8,418837,460497,253,23704,522
18,11,7,10,13,300818,206586,220,28301,432
35,7,28,2,11,130044,32573,0,0,520
12,6,6,0,7,419079,0,0,0,691
11,4,7,3,5,58398,53978,80,10200,479
6,2,4,2,12,1972,1972,36,1488,476
8,5,3,6,13,99333,96388,53,2199,466
16,2,14,3,11,29467,16858,59,6755,598
36,11,25,10,10,106083,104260,231,67357,426
9,3,6,4,11,426067,158259,0,0,624
22,14,8,6,19,1436553,452463,67,5592,461
53,19,34,1,12,128854,33155,29,0,446
25,3,22,1,7,15623,2550,12,16128,551
31,6,25,7,20,257949,48311,484,32933,443
5,3,2,1,7,20273,11779,106,16482,526
18,2,16,4,19,428262,122886,116,1147,624
16,1,15,2,6,16151,16151,15,10525,487
18,4,14,1,13,474684,217944,34,44612,528
19,5,14,9,6,52207,56039,121,17193,467
13,4,9,2,5,98427,14747,11,0,468
14,8,6,7,12,802895,251430,127,27653,450
7,5,2,7,13,111745,119010,70,83241,419
14,9,5,0,11,507349,0,2,0,708
5,3,2,2,10,16360,8642,0,0,514
17,6,11,3,13,615217,35240,62,15647,507
20,6,14,4,8,25851,17039,288,11748,481
3,0,3,1,6,6264,6264,8,6264,632
25,10,15,1,14,270674,9220,95,9220,512
12,6,6,2,9,49156,797,85,959,582
21,2,19,2,19,102579,29539,39,2972,492
159,17,142,7,10,132149,31505,71,23775,454
20,8,12,2,11,323522,541,21,3307,536
24,10,14,12,9,119524,121956,174,2012414,501
11,5,6,1,11,53936,8192,23,8192,555
22,10,12,7,10,69532,38325,328,12983,409
19,9,10,14,16,951573,691431,194,224912,420
11,5,6,2,15,23062,23062,25,10466,578
17,10,7,4,9,64836,11216,134,5112,427
19,7,12,2,21,333147,264748,28,40149,551
18,5,13,8,6,366017,684273,115,303262,502
69,9,60,9,12,48999,34110,604,13061,417
6,4,2,3,14,2116385,566653,56,66588,529
11,4,7,3,5,131874,11417,49,5288,484
29,9,20,6,12,108565,17800,95,24052,444
22,7,15,5,15,736132,214669,178,51175,455
7,4,3,5,6,26964,24640,69,19026,469
6,4,2,3,7,227380,22398,74,1099800,631
26,4,22,0,6,64680,0,0,0,633
8,5,3,2,3,8098,4008,5,3749,443
7,4,3,3,9,34187,16378,58,2998,470
7,1,6,1,16,19240,19240,23,19240,627
6,4,2,3,10,18494,12500,71,0,526
64,14,50,0,29,190822,0,9,0,567
4,1,3,1,13,39422,39422,38,91821,585
12,7,5,1,8,405746,6667,22,3478,464
13,5,8,4,21,101207,157448,92,4079,530
6,3,3,2,6,16545,16545,193,14688,505
20,4,16,1,23,26525,6218,26,956,619
28,17,11,5,25,687861,102636,84,0,453
9,4,5,2,11,12343,12153,48,8177,630
17,10,7,3,22,241711,139242,70,116212,420
34,15,19,12,19,611111,102563,122,51016,446
16,9,7,4,7,54423,38856,24,11287,388
49,15,34,0,16,422206,0,26,1322,520
14,3,11,1,15,14181,10269,36,10269,495
40,5,35,5,14,377772,144904,128,9099,462
9,6,3,3,7,4118,2005,68,1940,535
15,8,7,5,15,34879,33780,96,11731,494
8,5,3,2,6,386123,6997,0,0,449
42,10,32,1,14,381159,4810,80,1005,434
9,1,8,0,21,26722,0,0,0,658
32,7,25,2,12,18044,2152,117,7686,485
19,5,14,0,8,72598,0,0,0,489
10,5,5,7,9,39736,49841,60,9363,429
5,2,3,1,13,1902,1207,26,4054,463
15,4,11,0,12,121382,0,5,0,676
5,2,3,0,11,9080,0,1,0,561
30,4,26,2,15,39020,3591,32,4376,478
32,16,16,13,18,616711,187270,205,74215,384
37,12,25,6,10,66182,28242,157,13011,432
7,2,5,4,13,20905,234239,61,3293,497
7,3,4,4,9,107598,221422,0,0,451
3,1,2,1,16,670695,10425,5,10425,628
36,16,20,3,9,130876,7480,50,5033,432
12,7,5,0,13,354504,0,2,0,542
9,6,3,7,22,163881,199076,113,0,473
30,6,24,3,19,30518,6148,34,2400,395
9,7,2,1,6,218684,1779,18,0,538
6,4,2,0,9,0,0,13,0,613
7,5,2,1,9,50455,10924,2,10924,431
5,1,4,2,9,6242,16607,44,0,511
15,9,6,0,20,619153,0,13,4788,543
7,4,3,3,5,124353,148767,66,31516,490
43,10,33,3,7,43639,20493,65,21543,466
12,4,8,4,8,21839,34312,26,2969,409
25,6,19,0,15,265686,0,12,936,640
5,1,4,1,7,76722,76401,25,0,666
13,6,7,6,23,84364,85163,83,1565,503
26,13,13,9,10,108274,59479,228,4270,442
9,6,3,6,10,413459,69631,87,37583,433
38,15,23,14,13,85136,83838,154,6849,429
6,4,2,5,6,22838,37300,94,0,500
7,5,2,2,6,51836,8780,10,0,520
11,3,8,0,16,23605,0,2,0,627
31,5,26,2,12,225239,5789,22,601,517
25,7,18,9,14,64532,60692,165,10532,414
7,5,2,0,6,320,0,35,0,548
27,17,10,5,11,73279,29195,37,18587,454
10,2,8,2,8,12201,10196,101,4893,501
5,3,2,2,4,5662,5662,14,2688,456
9,3,6,2,8,10821,8351,2,6601,611
8,4,4,0,10,31084,0,0,0,680
13,6,7,5,21,38532,38532,179,32586,449
11,4,7,5,12,40736,43726,90,16134,432
3,0,3,0,7,0,0,0,0,531
36,12,24,5,14,107550,4487,55,3226,362
19,9,10,5,16,370276,117224,361,27792,506
19,4,15,3,12,99630,39126,19,26580,541
8,4,4,0,6,407923,0,8,466,612
10,4,6,5,8,13452,24846,364,12490,455
23,12,11,10,16,36056,15002,161,2854,459
12,6,6,2,13,359333,62069,13,41163,603
73,3,70,3,12,85758,90706,117,23955,516
10,6,4,2,11,64880,29874,48,16226,609
12,3,9,7,12,335563,378010,92,0,415
20,9,11,6,3,97681,21768,137,4658,437
107,11,96,7,15,101714,53908,84,22237,441
6,3,3,2,6,3820,3820,29,0,602
12,6,6,3,23,31189,6502,36,0,618
5,3,2,3,14,3323,2864,32,1188,521
21,5,16,4,6,86580,8107,68,3173,561
18,12,6,1,15,283433,570,9,1319,633
45,7,38,6,13,332091,259394,474,195482,519
25,4,21,1,7,37125,2000,54,13428,530
11,6,5,5,6,30005,18349,72,1076,460
7,5,2,3,6,56809,165402,5,24920,510
4,2,2,0,14,0,0,0,855,710
6,4,2,0,17,84345,0,2,0,601
71,12,59,13,8,127332,153535,52,12662,460
4,1,3,3,4,24080,38090,39,0,518
14,4,10,0,9,33889,0,43,0,588
46,4,42,7,7,73501,77108,124,28725,421
27,12,15,8,6,51181,37708,343,10513,449
25,8,17,4,17,68893,10636,97,7054,444
7,2,5,4,12,55460,61188,41,35362,492
8,5,3,1,5,73981,367,7,1129,634
10,8,2,8,19,158778,155784,170,21942,520
11,6,5,6,9,202156,199817,110,112,518
6,3,3,2,2,6798,2908,2,2685,532
15,8,7,0,11,42044,0,10,219,640
24,4,20,2,9,15995,4163,15,2761,559
9,5,4,4,26,16316,15216,73,3882,541
5,2,3,2,9,7826,7826,197,7236,493
6,4,2,1,14,330994,16808,0,1908,506
10,7,3,5,6,31999,9047,22,2092,502
22,2,20,0,19,4200,0,2,6525,548
18,8,10,2,19,67110,3944,21,2022,469
8,5,3,0,16,49983,0,0,0,673
35,4,31,6,19,60948,73964,248,51989,443
5,3,2,5,6,908858,1162384,56,455045,499
25,17,8,0,7,57273,0,5,196,616
8,1,7,2,8,249457,31186,24,25551,497
10,8,2,0,7,159621,0,29,4268,646
10,4,6,0,7,10203,0,17,4400,661
4,2,2,0,12,7282,0,2,12268,685
28,3,25,2,8,19236,19236,12,988,462
11,5,6,2,15,50851,5272,21,41557,589
27,14,13,4,7,1776135,46063,33,0,481
43,8,35,2,12,416302,12801,20,486,459
13,9,4,8,12,48011,36721,89,1279,513
6,2,4,1,11,31200,31200,11,31200,483
14,8,6,5,16,65972,25159,94,7142,492
158,19,139,1,11,149652,56015,23,3004,567
14,11,3,0,6,396775,0,1,0,546
18,6,12,2,23,188879,20348,37,3481,526
21,5,16,0,15,176645,0,7,23563,537
13,5,8,2,9,340905,7724,102,7323,440
11,5,6,3,20,98307,95455,66,2650,566
11,6,5,1,11,279125,1321,16,1321,608
8,6,2,2,28,15927,15927,23,13612,609
16,4,12,4,13,32992,32992,55,33091,470
15,8,7,11,12,686160,541541,7,11225,478
10,8,2,7,14,363057,33286,3,9632,399
5,2,3,0,10,3478,0,0,2931,617
15,7,8,2,13,376130,7008,35,4517,497
56,4,52,4,12,19989,30476,65,18984,486
9,3,6,0,10,315084,0,1,422,720
17,6,11,4,8,39992,5758,104,1478,485
14,2,12,1,14,8937,7197,103,7197,564
7,4,3,1,11,26508,9085,95,11240,482
16,8,8,8,8,12051,12708,82,3748,443
21,9,12,12,10,73115,81734,244,2480,510
10,3,7,4,9,165336,110412,0,0,460
7,3,4,4,11,42816,968195,95,6717,466
8,6,2,3,8,64682,2332,67,850,497
26,3,23,2,9,264396,6795,12,3142,478
13,7,6,7,13,504032,580402,93,59943,427
9,3,6,1,9,34632,34632,19,0,508
13,11,2,5,15,229502,213100,58,21899,525
28,7,21,2,12,24093,3850,58,2810,440
50,9,41,8,18,92850,94362,302,19807,388
18,10,8,9,19,91953,76845,20,4573,434
33,9,24,1,13,593193,1963,0,0,570
11,6,5,4,9,15291,7240,82,1699,438
17,9,8,6,20,371371,140110,0,16042,495
16,5,11,0,8,80910,0,12,0,649
19,8,11,5,7,35282,18425,115,1759,445
9,4,5,0,3,65787,0,1,0,562
32,12,20,3,13,721599,100535,59,64269,386
72,6,66,1,17,1316433,1258439,308,1258439,514
22,9,13,7,11,41912,35869,48,13525,504
5,3,2,0,2,17171,0,0,0,587
51,11,40,10,10,115194,70017,191,16941,426
8,4,4,2,9,31238,18351,21,425,628
11,6,5,4,11,534751,138678,54,123006,451
21,2,19,0,7,129748,0,10,0,625
39,16,23,3,27,2412016,44056,45,6943,480
22,2,20,0,12,3695,0,41,2365,456
7,0,7,0,17,0,0,2,615,640
7,4,3,3,19,6841,1855,47,1164,530
18,7,11,0,12,464020,0,28,1356,543
12,7,5,2,9,250310,2020,44,2269,512
11,3,8,0,18,75122,0,73,5344,558
29,13,16,17,10,154419,186565,297,30653,413
52,24,28,15,11,263648,140025,211,26720,412
19,14,5,1,8,1777289,7023,21,0,542
4,2,2,2,15,14519,14519,17,13520,451
16,8,8,4,7,77738,40504,132,28637,535
19,13,6,1,13,807373,78,10,7477,471
34,5,29,4,15,76413,26304,101,8904,472
4,1,3,1,12,12635,12635,72,398,494
50,6,44,6,18,48077,48077,402,22852,452
32,19,13,11,6,147028,120620,48,26758,462
6,3,3,0,5,43313,0,0,0,656
3,1,2,0,7,0,0,42,772,524
10,8,2,3,5,19024,2017,91,1815,497
4,2,2,2,6,18217,36066,33,0,542
7,1,6,1,6,28317,18153,14,112005,515
16,9,7,1,14,490743,4241,6,2548,513
10,3,7,1,9,32015,3266,41,737,520
19,12,7,0,19,334548,0,14,0,591
5,3,2,3,4,43142,24962,43,21698,460
11,4,7,5,18,31760,32605,45,6725,466
40,13,27,1,11,286063,340,332,4072,664
10,6,4,1,13,334767,115,7,43106,607
11,7,4,7,6,631611,48028,113,2382,474
7,1,6,0,5,10204,0,0,0,613
14,4,10,6,13,1198320,339720,135,7780,498
10,5,5,0,5,23197,0,45,94,653
8,3,5,7,8,246051,370164,8,20427,518
11,5,6,2,11,20435,8228,28,4484,536
26,7,19,5,39,10004,8540,100,1188,509
21,9,12,0,16,257997,0,6,845,667
19,4,15,1,35,344536,6251,113,36848,524
10,5,5,3,8,15671,7803,28,3109,518
22,4,18,3,10,755966,120057,55,4553,462
17,5,12,1,14,358704,701,29,12174,498
5,2,3,3,9,27090,27090,115,17487,570
37,10,27,9,10,46624,180446,13,5550,399
3,1,2,0,6,15201,0,1,0,698
17,10,7,14,8,113891,228650,213,21771,421
7,3,4,3,10,14168,13055,28,11589,473
22,13,9,12,6,405290,69159,158,20752,431
14,8,6,7,9,55116,48048,261,12596,466
15,9,6,8,12,123771,14833,34,5117,466
21,9,12,6,13,227164,131104,111,18518,497
8,3,5,0,8,39656,0,8,0,630
27,12,15,5,13,319957,25833,26,0,466
40,4,36,3,12,17244,17244,225,10543,447
4,1,3,0,8,6015,0,0,0,615
8,1,7,1,11,5672,5672,0,0,621
2,0,2,0,1,0,0,0,0,606
126,32,94,20,12,396471,323712,448,52800,414
31,12,19,0,17,1504128,0,10,716,478
20,11,9,1,18,8007,1,9,86,530
19,12,7,6,9,715083,853893,77,331534,535
9,5,4,7,6,224871,303460,127,116937,411
21,4,17,3,17,11706,955,80,12527,547
18,10,8,7,69,38025,30774,149,2714,449
11,8,3,5,14,414148,129854,114,2556,491
19,7,12,0,11,101900,0,0,0,653
8,5,3,6,11,48201,47278,80,30574,518
8,5,3,0,8,718826,0,2,984,604
20,12,8,10,16,366402,92116,164,16789,420
18,10,8,5,10,138240,4751,199,3131,534
15,4,11,9,7,94360,175630,187,52374,449
7,3,4,0,19,19608,0,36,833,568
7,5,2,2,7,102810,6094,40,15758,493
6,3,3,3,29,20890,20890,74,7650,555
15,6,9,5,10,16677,16131,78,3211,410
21,8,13,7,26,34285,88427,299,10438,473
7,4,3,2,16,29643,14235,27,7515,395
24,8,16,3,6,29191,3485,36,3185,518
10,7,3,3,14,37644,32786,72,53,526
23,12,11,6,24,2564138,425586,60,301076,356
24,14,10,8,16,90041,59791,82,28901,487
4,2,2,0,6,42132,0,0,0,570
6,3,3,0,8,6584,0,4,3114,634
7,2,5,1,14,6453,1962,0,0,600
14,8,6,4,15,300512,242016,51,24671,425
35,5,30,1,10,180489,7344,25,3616,589
38,16,22,14,8,240801,146547,255,56581,375
10,4,6,4,8,624780,220875,82,114225,461
22,5,17,1,16,9684,1481,72,2994,425
14,4,10,1,6,6465,3824,284,3824,546
9,1,8,0,5,794,0,0,0,626
11,3,8,4,5,4145,6141,87,1996,453
39,6,33,3,9,69183,1969,74,3728,550
28,12,16,3,11,82703,8344,24,8177,505
5,2,3,1,9,26422,3102,25,0,537
29,13,16,14,19,1998345,405440,126,42262,388
32,12,20,0,19,403170,0,60,769,512
13,7,6,7,22,38687,38751,139,12702,426
9,6,3,4,9,81400,46976,16,16393,449
14,4,10,3,7,25348,13011,404,10721,478
11,7,4,2,6,710447,31252,24,0,571
22,8,14,3,9,244696,750,25,2368,613
12,8,4,5,5,66091,23791,21,19926,439
8,4,4,1,24,468938,95486,15,95486,667
39,11,28,1,14,355165,13641,56,12036,440
13,3,10,3,10,77423,50103,61,4288,452
11,7,4,2,14,381285,82477,51,6994,436
5,3,2,1,5,181019,64187,0,0,486
17,4,13,4,10,24883,24883,96,7439,440
68,8,60,4,16,92490,42578,121,16657,449
11,8,3,8,26,261054,397656,157,112022,532
10,4,6,2,8,120665,120663,45,972,501
21,7,14,5,7,19646,19030,165,15229,453
8,2,6,4,13,166797,192482,0,0,633
20,4,16,1,4,366206,30687,47,0,489
24,5,19,6,7,89346,108726,359,73423,522
31,6,25,6,19,61621,54727,173,15613,411
23,8,15,0,8,42199,0,17,0,634
10,4,6,4,16,410634,86553,9,5995,431
8,3,5,7,8,63371,93011,81,1244,602
12,9,3,6,6,111890,31479,0,0,464
17,6,11,5,13,45092,32698,84,0,459
42,8,34,6,22,164510,200454,25,106418,458
8,6,2,4,11,281249,281249,43,0,465
18,9,9,5,9,60696,18452,155,91422,487
5,3,2,0,3,101841,0,0,0,629
25,10,15,8,5,97300,89861,102,0,456
41,8,33,2,13,23446,17736,67,4010,597
61,3,58,0,17,10273,0,0,300,504
7,5,2,4,9,22123,22123,211,19782,512
10,7,3,4,13,73393,28011,21,11553,459
26,11,15,9,10,39853,26682,310,8576,449
27,6,21,1,8,275311,233,100,19490,449
21,12,9,15,21,158127,197419,281,42107,429
27,9,18,5,14,96820,30703,63,14518,427
12,5,7,2,11,89176,19299,51,18736,533
16,4,12,5,19,305193,371955,167,0,527
10,8,2,7,13,671065,47787,228,12215,454
8,5,3,1,6,224424,1525,24,5125,562
11,5,6,1,21,10940,756,29,0,559
20,7,13,3,8,109413,44374,84,3695,478
6,3,3,1,8,745526,109439,47,612,610
9,6,3,3,14,829483,170692,61,151032,533
6,4,2,2,10,2377,2113,27,1240,626
2,0,2,1,14,0,47312,14,100,553
13,1,12,2,8,1876,1876,13,1506,510
38,17,21,3,19,3709677,19909,33,2643,453
5,3,2,0,2,5216,0,0,0,586
23,7,16,2,15,186914,69319,10,23130,567
49,11,38,6,11,90195,47679,120,32709,486
3,1,2,0,20,0,0,0,1466,617
5,3,2,3,8,14484,12315,16,9383,505
39,11,28,7,16,155523,122349,135,46775,420
50,3,47,0,8,0,0,3,0,635
58,5,53,4,11,21470,16420,68,8958,455
24,8,16,10,12,255381,76441,388,18899,511
14,5,9,3,27,253415,110360,48,13041,468
13,9,4,5,5,67623,29532,115,6210,475
28,11,17,3,14,188812,1552,51,1941,447
6,4,2,4,8,23527,25435,42,11017,458
39,19,20,3,11,93606,3551,63,3446,537
16,9,7,0,10,392077,0,4,0,641
5,0,5,2,6,109669,109669,0,1603,545
24,12,12,10,10,84547,51739,183,4435,423
10,5,5,0,8,26870,0,10,3916,565
6,1,5,2,6,6325,15364,20,9039,576
25,4,21,2,14,161274,5582,8,2520,531
34,12,22,9,13,319102,61555,369,15429,334
9,7,2,3,12,425539,259537,81,0,515
8,5,3,2,11,236600,14354,64,13694,481
13,5,8,1,19,160654,1752,16,1918,469
35,10,25,6,19,490223,37838,349,6509,453
7,3,4,3,12,41094,41094,54,3049,454
8,4,4,3,7,265976,46614,54,139,611
56,8,48,5,30,253067,34846,81,30259,476
9,4,5,1,13,7134,3527,35,0,497
4,2,2,2,9,4922,4922,19,3506,536
44,9,35,8,10,175696,37739,112,12988,468
8,3,5,1,7,293431,4267,29,4267,560
75,5,70,0,20,15315,0,1,15586,697
12,1,11,0,17,0,0,2,1330,624
8,6,2,0,4,131744,0,0,0,664
10,7,3,4,20,631494,122266,0,956,459
21,8,13,9,17,128572,106567,87,20099,426
37,14,23,0,7,1035694,0,2,1193,587
13,3,10,1,10,39511,4619,165,4619,544
9,2,7,0,14,22477,0,17,6565,614
29,9,20,3,10,252887,662,73,6840,552
8,5,3,1,7,16801,16801,18,652,544
7,3,4,2,13,373562,36148,44,1491,640
160,13,147,8,12,91199,17719,115,4110,435
34,8,26,9,12,32537,39275,321,6764,436
10,3,7,4,13,77146,68574,83,35432,533
88,12,76,1,15,105372,1918,35,0,521
13,7,6,6,8,326258,43989,253,15306,425
24,8,16,3,13,66083,48238,26,19219,450
7,3,4,3,16,76230,15195,57,0,492
11,9,2,1,6,186215,904,13,0,540
44,10,34,4,9,238276,50248,73,3454,489
25,8,17,2,18,121002,28802,27,1100,590
24,4,20,1,16,5808,5808,18,14836,490
7,4,3,4,5,10826,10826,495,4964,464
28,10,18,0,14,1155305,0,26,8024,613
8,6,2,1,11,58547,4691,95,4691,617
10,5,5,6,8,28662,77832,125,16899,500
7,2,5,2,6,5347,5347,29,0,495
15,3,12,7,12,44919,76785,150,6836,510
7,3,4,4,11,58520,57345,38,466,492
16,5,11,3,7,20693,14573,166,11876,478
11,3,8,2,14,60262,6975,22,5235,643
12,2,10,1,38,0,11398,44,0,553
12,6,6,2,14,28976,653,7,399,507
17,6,11,2,7,13854,1284,85,877,519
5,3,2,4,19,937233,669767,59,12671,495
15,3,12,2,10,34250,49569,29,0,606
35,8,27,0,11,160370,0,71,871,615
18,6,12,2,15,124625,26189,108,21325,439
18,9,9,4,11,259479,24910,105,2235,548
9,5,4,2,18,275024,7780,5,109,448
33,12,21,6,19,80852,9731,186,4341,470
27,4,23,1,13,130953,1771,0,0,444
19,6,13,0,12,73902,0,0,3975,628
7,5,2,6,7,404830,74545,0,0,447
10,7,3,3,3,159483,3318,6,0,588
12,7,5,8,8,108484,115843,83,37696,506
14,8,6,5,6,27617,34718,163,12944,620
36,10,26,3,14,801431,2805,174,2204,450
22,12,10,7,17,955906,469139,43,194,502
9,5,4,0,10,459092,0,9,0,539
18,7,11,2,8,52235,3680,19,2865,569
9,2,7,1,8,4269,657,9,775,556
31,12,19,10,25,932194,354904,179,4403,410
22,7,15,1,8,36678,9220,39,10220,500
24,13,11,2,27,1353167,7896,41,5725,469
34,4,30,2,14,78567,1818,32,2115,529
4,2,2,0,14,17425,0,0,0,567
20,7,13,6,10,107681,67274,365,6335,451
6,3,3,3,8,118983,118983,50,4101102,506
29,7,22,7,15,19967,20459,327,12097,476
7,4,3,2,13,693090,2473,20,5632,544
28,11,17,8,10,87758,15000,179,4063,441
6,3,3,0,15,261084,0,6,0,666
40,8,32,0,17,84754,0,15,694,624
23,5,18,3,14,116047,56771,176,6641,486
2,0,2,1,7,42267,31247,0,0,613
20,9,11,8,10,102869,85803,99,7793,384
22,6,16,1,16,315829,1707,14,0,482
7,3,4,4,9,92970,97762,99,0,494
11,4,7,0,11,89459,0,18,0,686
25,9,16,7,16,722085,659110,136,12482,522
10,6,4,4,30,8306,7679,70,0,552
77,6,71,0,5,32532,0,30,4110,494
10,3,7,0,12,203399,0,0,0,584
12,4,8,2,10,5478,4718,33,4628,493
9,6,3,0,1,82992,0,0,0,603
19,7,12,3,6,26270,783,91,1780,502
21,8,13,3,13,92834,62024,54,18864,437
5,3,2,2,9,628867,161046,26,0,510
32,7,25,6,14,18412,18412,164,7768,482
7,5,2,3,6,78055,22920,18,0,412
9,4,5,0,6,27572,0,3,0,505
18,7,11,0,14,96312,0,7,0,649
22,5,17,1,10,22349,10648,17,10648,605
14,6,8,4,8,101889,13093,45,2984,489
14,6,8,2,8,1415641,34422,1,2163,466
7,5,2,2,3,137702,1007,5,539,435
10,2,8,1,18,8471,4518,18,4518,555
22,7,15,3,11,13462,12893,75,5297,487
14,2,12,0,18,66475,0,7,794,484
36,15,21,0,11,525200,0,0,0,519
11,3,8,2,14,12510,12510,26,8917,565
11,5,6,4,7,19456,18628,242,10631,393
38,16,22,10,10,507007,42944,222,15771,406
10,4,6,3,8,41737,36112,38,0,495
6,3,3,0,7,77973,0,12,107275,522
5,3,2,2,11,519177,44495,33,3818,458
15,9,6,6,13,570350,32652,122,3669,459
7,0,7,0,8,0,0,7,0,631
7,3,4,0,8,216513,0,2,0,640
15,7,8,6,20,28986,35274,236,22428,477
23,12,11,3,9,1178250,10077,124,2422,450
10,6,4,0,5,522072,0,0,0,614
18,11,7,0,13,433054,0,17,0,552
21,5,16,0,15,353556,0,77,3507,417
19,8,11,0,10,17404,0,21,0,551
50,16,34,5,18,251134,43987,125,18014,436
15,4,11,0,28,12848,0,18,1625,613
27,10,17,7,15,979790,107147,44,30417,411
8,4,4,5,11,38159,49936,179,7340,508
20,10,10,0,10,427692,0,20,0,601
18,8,10,0,13,470148,0,15,12602,586
5,3,2,0,7,20655,0,22,0,682
10,8,2,2,12,248311,10016,8,0,543
24,4,20,3,13,14239,14093,45,1484,486
12,6,6,4,11,740220,54036,72,3793,537
15,6,9,4,13,333288,140888,32,56658,529
8,2,6,0,7,0,0,0,0,688
30,5,25,3,9,20691,8232,62,643,522
20,10,10,11,16,469118,51250,384,23188,476
28,11,17,3,17,69614,40464,102,17748,461
10,3,7,2,9,9370,3290,100,5335,528
15,4,11,2,8,94034,99090,50,0,636
20,14,6,9,14,236981,53121,94,15734,461
8,6,2,4,3,34349,23042,81,9047,383
16,8,8,2,12,194606,10418,66,9264,555
31,14,17,14,12,1290168,325724,244,64608,414
4,1,3,0,8,32379,0,0,0,696
13,5,8,3,13,7276,60798,93,10864,519
13,9,4,6,15,1518730,1517893,48,10685,462
11,8,3,5,6,71188,15871,175,1771,507
12,5,7,4,15,136396,16109,77,12133,528
8,2,6,0,22,34115,0,25,0,723
5,3,2,0,5,73487,0,0,0,675
28,9,19,5,13,310797,163278,59,5293,505
22,2,20,1,12,11121,2291,0,0,548
14,10,4,6,3,46000,17090,13,0,429
26,6,20,1,7,56071,180,110,1161,440
10,4,6,2,5,27790,6802,26,2940,415
39,8,31,7,14,143252,21228,219,11406,461
11,7,4,1,8,553455,265,23,541,557
42,11,31,10,26,108971,82345,208,21564,552
27,24,3,12,9,1942618,354914,360,65535,418
9,7,2,0,7,6144,0,2,2321,678
10,4,6,2,7,44323,12710,7,126,418
4,2,2,0,2,395251,0,0,3331,512
22,15,7,3,11,172352,15742,29,9322,574
11,4,7,3,10,58782,37953,0,0,596
12,7,5,5,10,22933,18430,170,3166,392
7,3,4,7,6,103160,90931,37,6924,487
10,6,4,4,9,26222,26222,79,18005,520
16,5,11,0,13,146221,0,38,606,542
83,15,68,0,18,255288,0,339,6202,438
19,11,8,8,19,1299031,491906,109,315264,442
50,10,40,4,13,451243,131236,63,0,506
14,6,8,4,8,14100,6681,75,3268,509
4,1,3,0,5,21383,0,0,0,739
12,7,5,4,9,86912,19230,50,13535,449
14,6,8,2,15,333497,17947,57,16558,652
19,14,5,3,8,95988,29716,48,906,454
15,12,3,4,10,15537,9916,100,3349,504
15,10,5,7,22,1199533,929482,109,0,526
15,5,10,8,8,53453,117224,9,9149,438
10,6,4,4,9,328081,18938,48,8274,447
16,8,8,5,8,83349,53501,63,12962,482
10,4,6,2,12,280069,4500,4,0,556
4,2,2,0,2,3370,0,0,0,611
7,3,4,4,6,8373,16358,46,4271,551
5,3,2,1,11,13167,4886,34,4886,521
7,5,2,1,15,47942,609,22,7853,535
75,3,72,2,12,164214,53364,66,90172,471
12,4,8,4,5,43422,37508,71,15032,475
19,8,11,4,13,572478,62899,34,40549,525
14,0,14,1,6,3226,3226,13,8612,628
6,3,3,1,11,2682,2334,1,225,455
5,3,2,0,14,196360,0,7,1146,605
9,5,4,4,7,43672,20891,0,0,546
5,2,3,1,5,10640,394,55,2080,526
44,5,39,3,11,44044,1612,254,2666,501
23,13,10,9,19,215138,148027,220,32492,434
12,8,4,1,19,98769,57812,14,57812,551
22,0,22,0,9,0,0,5,1088,660
7,3,4,0,7,188852,0,23,3511,490
13,6,7,3,12,30039,14834,57,5006,433
21,9,12,6,12,901971,223940,50,68375,420
15,7,8,0,12,825576,0,8,0,652
5,1,4,3,10,35595,35748,46,0,615
8,4,4,3,10,37926,25105,4,2374,536
78,13,65,7,11,686597,46228,67,13818,446
26,8,18,2,18,532223,17504,64,938,517
5,3,2,1,8,19602,14688,1,702,529
5,3,2,1,10,39514,31351,24,31351,519
12,2,10,2,11,385,8109,0,0,613
30,5,25,4,10,3088,3088,44,3486,632
149,6,143,2,13,53078,24241,34,2684,493
14,7,7,4,6,119415,2832,76,1149,459
10,6,4,0,9,112024,0,0,0,679
11,6,5,2,16,47683,25924,16,0,641
27,7,20,1,7,3817,2482,19,2482,468
14,6,8,8,7,47754,62339,32,15507,394
5,1,4,0,8,3685,0,21,0,610
4,2,2,0,5,363726,0,15,166,663
11,7,4,3,9,32800,46865,36,0,488
57,10,47,7,11,406076,51061,223,5373,481
4,2,2,2,11,56287,56287,45,484,493
23,10,13,5,17,56970,26296,351,14242,473
22,5,17,2,12,36372,10297,31,8912,536
25,6,19,5,7,20017,12739,95,8400,560
27,12,15,10,10,155049,68442,266,15217,410
11,5,6,6,19,15082,19948,68,23495,449
31,19,12,0,12,371479,0,25,1667,543
8,6,2,1,11,9877,1010,0,597,669
8,5,3,3,5,143305,103393,35,1895,457
9,5,4,3,9,70420,69262,51,0,486
35,8,27,6,23,153656,70231,263,47116,462
6,2,4,1,19,5802,4982,23,451443,455
10,4,6,3,10,20258,20935,123,18100,607
18,3,15,2,18,39380,33821,98,0,511
18,3,15,3,14,259008,20972,73,7930,549
16,4,12,7,7,27323,44270,80,12692,372
5,3,2,1,12,313085,219,4,0,622
2,0,2,0,9,0,0,2,1866,498
15,3,12,3,12,102215,15850,51,7592,556
8,3,5,5,7,7565,31067,96,3960,539
9,3,6,3,7,57816,57816,89,2369,491
8,5,3,3,6,38473,6849,32,5233,513
20,7,13,2,15,95558,1176,59,228,522
26,6,20,6,5,139441,17127,94,5924,477
12,7,5,2,16,869201,13346,50,69902,484
42,15,27,10,13,378465,24206,117,7959,382
15,9,6,0,10,213802,0,0,65,609
25,10,15,4,16,100522,69386,115,44286,506
72,8,64,5,8,184782,28451,266,17064,506
12,5,7,0,8,79467,0,3,3083,562
30,13,17,9,9,60406,24053,181,9102,381
9,3,6,1,7,13129,12756,38,0,528
28,4,24,2,11,77180,24178,27,22359,471
17,8,9,4,12,29531,12339,114,2530,442
43,10,33,1,13,651115,303688,188,10634,442
11,5,6,4,27,3278863,638089,83,0,538
13,4,9,4,16,34904,17847,50,7129,500
18,9,9,5,23,215711,112051,77,0,542
9,7,2,5,5,276059,34914,46,12541,384
41,4,37,2,10,133368,7932,59,8910,539
8,2,6,1,14,557834,458,26,458,577
6,4,2,0,4,22234,0,0,876,610
15,6,9,5,8,38281,31952,256,13899,455
17,3,14,4,8,20733,27003,134,8500,521
17,7,10,0,9,277394,0,13,0,570
13,7,6,2,12,63901,2964,4,0,701
9,7,2,0,6,111901,0,0,0,622
17,5,12,1,11,3740649,395210,42,38788,445
43,16,27,2,21,217612,7150,21,4158,609
14,8,6,3,6,302826,35511,146,32756,437
25,5,20,4,18,104400,41043,180,59980,499
19,3,16,0,19,37375,0,24,3120,437
27,6,21,1,8,81115,21188,4,1017,502
61,9,52,2,16,70677,40031,122,14846,494
30,18,12,1,13,989105,408,36,0,607
8,1,7,1,17,11236,11236,13,11236,458
18,5,13,4,11,92265,43847,133,31200,406
12,8,4,5,6,52213,31542,160,4775,478
40,13,27,3,13,504054,3583,81,1766,520
6,3,3,0,11,386472,0,0,0,584
19,9,10,6,15,59264,47499,40,16339,431
28,11,17,1,15,1680904,558,9,0,500
18,4,14,1,19,239009,7254,8,3011,424
9,4,5,0,8,0,0,6,543,649
21,9,12,0,18,729763,0,43,6021,618
3,0,3,0,4,0,0,0,1600,590
11,7,4,5,18,624208,171739,24,1261,539
17,6,11,2,11,526777,11630,31,0,446
10,7,3,0,13,192681,0,0,0,636
9,5,4,2,18,665286,3193,27,3847,446
15,4,11,2,9,82723,45881,90,26537,493
22,8,14,6,7,65895,66104,253,31381,520
10,5,5,4,9,457867,10300,32,6670,559
3,1,2,0,1,6710,0,5,3208,482
12,7,5,3,14,473816,5851,57,15178,440
4,1,3,1,13,0,7096,0,0,569
10,8,2,1,9,628569,1180,24,1180,482
7,4,3,6,4,18311,19954,76,9176,442
20,13,7,8,6,77706,54239,165,2500,475
14,10,4,6,13,296573,85569,64,29264,414
6,1,5,1,20,5188,5188,23,0,643
24,7,17,6,14,89165,21141,33,6764,489
47,13,34,3,6,44852,7402,39,1326,420
42,9,33,5,16,61222,22863,71,13311,496
23,5,18,4,6,67584,56598,140,32111,476
15,12,3,1,15,201004,42,0,9138,581
12,4,8,2,16,356390,14803,62,11291,513
17,8,9,2,15,1079929,6997,20,14836,433
13,8,5,5,23,479735,40624,26,3383,510
6,4,2,2,5,40291,11600,46,6000,351
45,8,37,4,12,27732,22060,298,15692,463
15,7,8,7,8,21123,23145,73,5802,452
4,1,3,0,9,0,0,0,0,610
17,8,9,4,16,276682,44016,128,8362,464
4,2,2,2,7,63441,63441,22,12498,641
30,6,24,4,11,41395,31448,242,22463,521
5,3,2,2,13,14101,14101,96,11847,646
24,4,20,4,17,63179,106165,143,12535,486
20,11,9,7,16,310140,28523,40,14008,513
9,5,4,0,19,574517,0,1,0,728
28,6,22,4,18,370000,120764,95,16118,561
9,4,5,3,8,11788,9636,27,4964,573
16,10,6,4,14,15575,16393,119,6656,505
15,3,12,0,10,19669,0,0,0,613
20,12,8,6,14,199574,16371,71,12900,504
21,3,18,2,8,14776,14776,32,13010,545
14,2,12,0,8,0,0,39,1192,651
20,6,14,2,14,808164,37807,25,10412,544
11,8,3,4,13,273327,6389,50,2512,459
21,7,14,2,3,10362,6917,91,5445,515
20,4,16,1,14,294627,42326,25,9965,491
9,4,5,2,16,101940,60932,39,0,485
18,2,16,3,18,5157,12347,92,2993,477
10,6,4,6,8,49921,72675,143,14583,512
6,3,3,2,6,65446,20750,25,0,444
10,8,2,4,11,281989,5090,62,6567,400
10,3,7,8,13,40792,77786,198,15884,488
19,6,13,4,10,56498,14414,5,11996,475
10,3,7,2,9,7746,7746,44,0,500
18,12,6,3,9,141541,3571,53,11787,454
10,6,4,4,12,232104,24324,81,1475,488
25,6,19,6,11,98527,102074,124,11860,498
9,6,3,5,10,319860,272540,49,0,442
4,1,3,0,13,2806,0,3,0,610
132,7,125,7,18,101282,105254,80,27858,442
27,14,13,1,14,201802,11061,27,11061,450
29,15,14,2,69,1636664,4645,29,1960,466
6,1,5,2,8,15115,15115,48,2017,512
11,6,5,3,5,29289,5216,101,626,482
41,7,34,3,19,20540,15853,205,10653,455
6,2,4,0,8,4951,0,0,0,608
8,5,3,4,13,143503,36047,24,6090,471
14,10,4,9,5,82790,44990,400,21646,484
4,1,3,0,4,0,0,0,739,654
408,8,400,3,11,32378,550,141,9597,522
5,3,2,0,6,33450,0,24,0,618
14,12,2,0,9,668517,0,0,0,683
28,15,13,0,21,630302,0,7,5924,636
56,13,43,10,19,166115,117095,212,17456,500
11,3,8,1,5,20608,9155,96,9155,638
17,13,4,10,23,190230,181907,225,10049,462
7,5,2,4,6,43814,8210,12,1675,464
14,9,5,6,12,1106893,52610,74,5610,476
14,5,9,1,17,842641,52785,30,294,501
33,8,25,2,13,383162,4038,21,7380,535
10,5,5,3,8,19609,30751,24,5075,555
10,6,4,4,14,100969,97657,39,94388,487
14,11,3,9,5,474963,20624,105,2659,462
12,9,3,3,13,130014,130014,114,0,451
21,5,16,1,9,67440,1068,48,1635,512
36,19,17,0,15,558599,0,0,0,597
5,2,3,0,7,663,0,55,2096,571
12,6,6,0,3,89633,0,0,0,574
22,9,13,0,11,544251,0,21,716,445
28,6,22,4,13,338639,39916,276,23947,446
4,2,2,1,9,344,172,72,4440,577
11,3,8,2,8,15508,1178,124,1091,520
12,3,9,3,9,23731,13826,20,16548,617
7,4,3,1,12,16332,880,30,1302,532
10,4,6,1,13,548031,47809,25,261,647
4,1,3,2,17,22081,62924,30,4083,559
4,2,2,1,13,121389,80276,23,80276,580
14,7,7,11,8,3148442,391167,167,142805,434
19,16,3,1,14,402622,419,48,4585,628
23,12,11,7,12,194413,105088,129,6720,443
37,5,32,3,7,35441,7058,63,20715,486
10,4,6,4,16,15138,73113,74,0,481
28,18,10,0,34,1456853,0,4,496,687
13,10,3,8,15,264681,22235,47,6612,501
27,13,14,5,11,210907,120916,125,0,475
8,6,2,0,4,528256,0,0,0,639
19,8,11,3,10,910236,51485,64,0,494
32,13,19,12,13,310007,106825,279,31800,377
6,2,4,0,6,13668,0,12,0,541
18,11,7,6,14,385573,37422,100,25803,459
30,12,18,11,11,177801,203374,24,11927,486
37,7,30,1,12,240062,1246,15,1246,664
21,9,12,0,18,779107,0,0,0,600
12,3,9,3,3,12475,3465,34,0,555
6,2,4,0,5,18273,0,19,0,632
16,7,9,1,23,13915,6399,27,5951,640
26,12,14,1,18,139637,692,14,1264,488
11,7,4,3,19,283069,21320,0,0,494
16,11,5,6,12,347312,161066,87,24583,521
39,15,24,5,9,59817,16254,28,4885,440
49,11,38,2,10,166310,17485,8,3645,412
20,9,11,8,12,29270,38626,205,4798,419
15,11,4,4,3,110029,6458,42,2746,422
8,5,3,2,6,10656,2457,54,1033,517
7,5,2,2,9,576673,160815,19,87713,433
19,11,8,14,12,1023960,1264051,270,342517,368
12,8,4,1,7,47831,996,11,996,478
10,6,4,4,6,5011,2023,37,421,603
51,7,44,3,9,48324,8620,75,10160,486
12,7,5,0,16,200116,0,0,0,550
26,10,16,2,14,93400,12203,19,1046,451
23,10,13,8,11,44489,16505,71,5642,613
8,5,3,1,12,91866,18426,2,18426,554
13,6,7,1,26,965054,1994,8,1994,421
19,12,7,0,69,593090,0,1,3868,586
12,7,5,0,8,145792,0,18,0,480
16,9,7,0,10,169867,0,8,259,568
6,4,2,4,13,25816,34468,48,16723,474
47,22,25,2,13,2190595,2410,26,4571,454
15,6,9,7,18,199228,363845,168,152069,460
39,12,27,3,8,106847,47879,71,7941,403
11,4,7,4,5,12697,11722,200,10247,481
11,4,7,1,7,4641,1000,15,3993,579
44,9,35,2,39,92329,13359,33,7634,503
43,12,31,1,69,349566,1812,79,13530,472
21,12,9,7,10,300810,42770,117,4676,417
42,24,18,2,10,719921,9813,124,637,527
10,8,2,3,10,238596,16220,31,6897,451
13,6,7,5,8,204865,13854,37,1317,484
4,2,2,1,7,19846,10897,3,0,594
37,15,22,3,12,109453,8731,120,24864,482
31,4,27,2,5,18542,598,19,7057,601
58,7,51,2,15,234754,5010,36,3354,624
12,6,6,0,9,702418,0,2,0,532
19,5,14,2,6,79860,27568,70,16562,467
29,16,13,1,49,1045949,5309,4,34361,535
59,5,54,6,18,40873,44696,90,3463,459
25,4,21,3,14,43006,14036,57,8495,446
11,0,11,0,6,0,0,0,0,613
30,5,25,1,7,32926,2753,3,2753,469
36,12,24,4,16,163866,6805,286,5236,446
14,7,7,6,18,117184,116153,197,18470,458
8,6,2,4,10,338337,5440,0,0,454
38,13,25,9,9,239563,60772,198,15842,407
18,15,3,14,8,54919,54919,397,17688,544
11,8,3,6,13,39801,35962,239,19027,461
11,3,8,2,15,77253,77253,50,54762,564
13,9,4,4,17,209731,8667,0,822,470
18,10,8,4,11,112426,51189,35,13002,470
9,7,2,1,9,877525,3533,10,3533,538
13,3,10,1,12,44442,44140,12,44140,607
12,8,4,1,10,236984,6887,2,11959,504
17,8,9,9,7,73329,55263,258,6375,462
27,8,19,5,18,74973,74088,66,62453,423
20,6,14,0,7,71586,0,2,385,606
5,2,3,0,3,10274,0,0,0,586
10,1,9,0,11,0,0,6,6423,620
4,2,2,2,14,46389,46389,23,26252,491
12,7,5,5,5,62527,28717,80,0,510
7,2,5,2,10,11230,11230,42,9430,418
36,10,26,8,11,36354,35162,285,13371,434
5,3,2,3,8,34431,48719,50,31810,440
9,7,2,0,4,562664,0,3,35,528
20,11,9,7,13,635920,92242,65,700,444
20,12,8,0,15,5471271,0,3,0,655
15,6,9,2,22,238460,6800,67,4900,515
17,11,6,8,19,639681,199339,44,14114,534
35,15,20,8,18,139019,48740,202,8770,453
16,9,7,1,15,810022,469,2,374,519
14,7,7,3,17,222278,2545,95,12596,446
40,5,35,4,19,111177,89370,186,60922,489
14,5,9,2,14,208217,5321,96,4593,540
19,10,9,2,12,325473,20287,1,597,508
55,5,50,3,12,33563,12488,73,10599,504
4,1,3,0,3,20032,0,0,0,632
27,7,20,4,11,20935,20205,37,6675,597
48,19,29,10,10,158262,52675,24,8991,396
12,9,3,6,5,635356,87723,103,29801,480
6,3,3,1,6,246692,240000,33,0,571
39,7,32,6,12,37077,36161,86,7590,427
11,6,5,4,12,527370,80543,73,41406,442
15,11,4,4,10,101596,30155,136,0,439
11,3,8,1,9,1098028,98161,20,0,508
12,7,5,2,7,223692,1520,8,4711,541
6,2,4,2,7,877,877,49,544,438
8,6,2,3,9,47320,7533,30,3748,609
13,9,4,8,19,245522,47690,262,22469,402
23,5,18,2,17,49599,11177,25,16725,517
26,13,13,2,14,598705,1697,15,1046,489
28,8,20,1,12,398768,9650,57,7400,612
6,3,3,0,30,930103,0,0,0,735
26,9,17,0,18,424260,0,5,0,603
14,4,10,3,12,503102,26147,45,13358,493
5,2,3,0,14,14527,0,1,0,642
12,5,7,1,16,230821,1261,40,3161,522
23,5,18,7,8,53092,87726,263,18894,438
15,8,7,4,11,60153,22798,46,16278,513
20,9,11,10,13,517987,651740,165,327744,391
4,1,3,0,8,18978,0,0,0,627
18,4,14,6,16,36068,31943,64,5380,457
43,15,28,9,13,588806,89883,127,6758,408
10,3,7,1,12,84796,7693,35,742,507
82,9,73,2,9,203055,16905,134,13156,588
6,3,3,4,14,37774,47838,50,26364,556
52,20,32,6,11,1238943,68273,104,4651,450
28,10,18,9,14,596545,356604,179,30902,456
9,3,6,1,10,14692,10551,23,10551,570
7,3,4,1,15,470833,7406,25,0,609
72,8,64,3,9,501735,6105,23,4375,489
6,2,4,1,13,0,37639,11,2682,662
63,15,48,14,21,134835,127553,756,32109,465
18,7,11,0,14,36845,0,7,470,607
19,4,15,2,9,13504,6401,87,2415,560
11,2,9,2,7,2806,9300,32,1104,487
9,2,7,0,7,42175,0,4,0,575
15,8,7,1,9,238353,354,83,505,457
18,11,7,7,7,27906,24841,86,2406,418
6,3,3,5,5,20213,20169,28,10638,487
54,22,32,17,10,240729,239181,35,17415,387
21,6,15,9,13,44544,58895,189,11104,470
6,4,2,0,3,73861,0,0,0,671
14,2,12,0,14,14230,0,0,0,618
13,6,7,3,17,209577,163015,76,0,559
8,1,7,1,11,1626,1626,7,3157,631
8,1,7,1,7,7503,7503,9,7503,569
18,8,10,0,9,27589,0,25,10807,569
6,4,2,2,4,8429,4862,13,3000,494
7,4,3,1,9,790861,5102,4,0,554
31,7,24,8,7,111434,61266,0,0,457
8,5,3,1,9,40264,1231,5,0,661
12,3,9,3,13,18865,108183,29,9980,497
34,5,29,2,6,232226,1989,28,1591,486
9,4,5,3,21,14174,6722,33,4170,555
25,7,18,1,9,47028,64,211,645,425
23,4,19,3,16,37500,53721,156,20925,501
31,4,27,1,13,39147,703,8,1813,546
3,1,2,1,7,6090,6090,94,6090,644
17,10,7,6,7,348691,114754,146,8405,525
5,3,2,5,4,35462,27649,18,17182,486
20,10,10,5,9,73090,20340,84,9451,464
18,13,5,7,7,74946,38023,124,5258,433
25,5,20,5,11,7486,54160,32,701,494
40,12,28,7,11,328568,22154,161,17377,486
27,5,22,5,14,176411,82569,58,23265,501
28,4,24,2,8,25074,10500,48,9444,444
12,10,2,2,7,49352,679,0,0,505
14,7,7,3,8,34096,23397,287,20812,506
82,19,63,0,17,284558,0,24,6829,532
21,5,16,5,14,35264,35264,470,18099,526
12,10,2,6,4,274758,64562,6,1532,448
34,13,21,4,14,344165,2368,105,10620,383
12,3,9,2,6,16672,5412,0,0,452
17,8,9,2,13,339721,30228,19,0,448
19,5,14,2,6,8143,4205,42,7127,551
4,2,2,2,7,5815,5815,18,4252,606
3,1,2,2,7,57460,61793,16,0,544
8,3,5,4,4,40488,40488,14,8049,454
72,17,55,5,20,326136,28640,38,39143,503
14,3,11,2,13,64048,59332,44,0,633
45,8,37,5,16,539686,110458,88,69709,433
56,15,41,1,7,76818,5086,8,851,480
23,9,14,8,15,274921,274921,200,21097,450
26,9,17,5,18,134220,72978,173,107193,453
5,1,4,2,8,35579,35579,96,15296,619
15,6,9,6,13,148088,262501,0,0,491
13,4,9,0,8,17077,0,30,0,609
21,10,11,8,12,281319,274417,84,1647,508
10,3,7,1,18,18320,11165,46,1665,495
7,2,5,2,7,21876,19405,16,18523,634
4,1,3,1,6,18399,3470,6,0,491
20,3,17,2,9,5384,652,330,616,571
21,7,14,5,9,26281,13249,0,0,442
5,3,2,3,7,63613,23346,56,3136,506
7,5,2,0,16,2925477,0,0,4367,597
10,5,5,5,12,58822,50393,126,3849,505
18,8,10,3,12,361347,13775,2,900,504
12,8,4,6,26,651712,3157157,80,51555,378
18,8,10,2,7,899324,4167,33,988,450
17,4,13,1,13,261007,9950,150,2614,543
20,8,12,0,11,75228,0,9,0,501
37,15,22,0,6,163889,0,1,0,392
99,16,83,4,18,674718,99317,105,21993,465
10,7,3,0,6,39404,0,0,0,705
10,5,5,2,11,857450,21799,23,0,511
10,6,4,0,7,340386,0,0,0,612
5,1,4,1,9,8469,8469,17,8469,567
8,2,6,1,14,97019,37235,25,0,605
16,6,10,0,4,161265,0,2,1691,597
13,6,7,2,29,6669,6665,24,6396,608
9,4,5,4,8,6896,11642,9,4747,455
3,1,2,2,8,0,24768,17,17678,628
4,0,4,0,5,0,0,8,0,561
28,10,18,7,8,88481,44800,115,12755,506
8,6,2,0,16,86032,0,0,0,645
4,2,2,1,3,50001,1020,19,0,500
7,5,2,1,5,106844,800,6,1693,534
28,12,16,2,21,519717,8699,60,2470,503
7,2,5,1,5,159209,124511,14,0,563
7,4,3,0,7,63956,0,3,0,674
19,4,15,1,11,22066,1895,28,591,556
30,2,28,1,18,48495,769,202,6230,540
12,10,2,5,22,339472,53188,62,1124,370
6,4,2,4,6,9788,6828,89,3278,422
28,7,21,5,20,104898,83473,154,55600,468
5,2,3,1,8,31131,8872,0,0,505
7,0,7,0,12,0,0,20,1070,643
48,14,34,5,9,495817,85753,113,11842,479
207,8,199,2,17,333707,73702,18,628,557
7,0,7,0,6,0,0,2,0,632
11,8,3,0,3,111855,0,22,1283,575
8,3,5,6,10,63084,85142,119,25529,506
13,6,7,0,15,46013,0,10,1160,543
5,3,2,4,7,20354,20133,34,9157,478
6,2,4,3,10,32366,22429,40,6759,501
8,5,3,3,20,326075,24179,98,6233,529
7,5,2,3,9,48498,18521,28,8646,484
9,5,4,6,7,16644,18301,193,7764,499
19,6,13,2,7,55261,13327,37,199,459
19,10,9,7,13,374806,81036,136,44530,432
15,6,9,3,15,205830,49724,74,6301,552
8,4,4,0,11,107107,0,0,0,687
37,10,27,4,10,54740,30728,91,17010,413
10,1,9,1,14,10805,10805,24,10805,620
10,6,4,2,6,100316,5678,0,0,429
24,11,13,7,6,184644,21756,6,1020,439
36,13,23,9,23,54784,46188,58,18223,463
7,4,3,1,4,5252,1075,15,4011,530
13,7,6,4,21,122603,17811,94,5629,484
21,12,9,9,16,128096,127815,357,60770,400
10,6,4,4,6,40148,23413,53,0,471
15,4,11,0,7,31331,0,0,0,517
22,8,14,0,9,36666,0,45,3281,551
44,18,26,13,12,1243815,73550,118,16616,424
24,11,13,4,15,1504233,97015,68,484,538
37,6,31,7,7,35444,25485,110,9201,411
4,2,2,3,4,70030,68224,37,0,523
13,3,10,3,14,10628,9119,33,18959,462
4,2,2,2,13,24372,27106,43,24372,475
10,5,5,0,7,9307,0,5,173,580
20,14,6,8,5,693265,87235,36,4820,464
12,6,6,7,5,14844,14844,82,6600,459
6,1,5,1,5,103,103,11,0,600
19,4,15,3,11,751620,40320,21,19319,503
8,5,3,0,7,68315,0,2,0,545
3,1,2,0,7,187,0,0,0,634
4,1,3,2,21,58905,117810,33,0,526
14,12,2,0,18,521321,0,13,16666,553
11,7,4,5,9,193684,25381,94,11127,405
34,7,27,4,15,209579,61865,15,9301,450
31,11,20,9,17,49017,44390,64,13556,426
5,2,3,2,17,717220,35746,32,1291,457
3,1,2,0,13,500521,0,0,0,658
13,1,12,2,7,8467,8467,0,0,629
14,6,8,2,9,123187,10897,13,8378,470
8,5,3,6,7,22290,38878,116,5425,457
7,3,4,1,7,139574,3277,65,0,532
29,6,23,1,15,35260,1864,39,4411,600
48,14,34,1,19,487306,714,50,804,558
23,7,16,5,12,247714,25576,61,0,470
8,5,3,0,9,631893,0,0,0,584
20,15,5,2,17,643173,23030,18,1485,492
10,2,8,2,8,13242,6789,330,1204,546
20,10,10,7,13,61090,58335,167,32814,431
32,11,21,2,18,114512,6479,0,0,468
23,15,8,12,8,456116,80599,142,7442,340
3,1,2,1,11,9008,1731,0,0,521
17,11,6,0,18,87901,0,4,1280,689
55,8,47,5,11,623129,203505,97,11163,447
17,12,5,0,5,519062,0,1,0,564
22,8,14,2,11,300271,7157,51,919,497
30,17,13,10,14,804451,130119,93,69104,476
15,2,13,0,8,41113,0,4,1665,525
7,5,2,3,15,323630,74359,18,35124,498
8,4,4,0,11,251063,0,99,26223,503
7,4,3,2,14,84884,82182,7,52279,471
12,8,4,2,12,216103,54844,34,12154,642
8,4,4,0,12,286277,0,1,3899,534
20,7,13,6,7,196502,82355,0,0,440
21,11,10,10,18,789377,72687,108,25829,428
85,8,77,0,12,34011,0,2,5171,555
6,3,3,1,9,125104,26218,12,0,489
8,2,6,1,17,2354,2354,12,4713,425
26,17,9,3,6,224033,17497,12,8748,481
4,2,2,0,7,0,0,2,1186,640
26,11,15,11,12,257309,32319,210,11587,457
14,4,10,2,22,532,532,38,30380,585
5,0,5,1,6,0,6733,0,0,564
11,6,5,0,18,404591,0,1,5155,528
96,3,93,0,4,9077,0,5,2174,630
15,6,9,7,25,192706,174366,148,44893,490
6,3,3,3,15,21717,27899,70,0,557
17,6,11,4,17,355685,106825,41,2910,437
13,6,7,3,7,128113,34337,49,10420,454
8,4,4,1,5,144653,5631,18,5631,572
12,5,7,4,9,19833,18743,38,6230,440
5,2,3,1,10,63458,63458,102,40536,467
31,11,20,1,13,215544,2399,47,2399,578
7,4,3,3,13,305792,17819,31,10103,522
28,9,19,12,26,149845,184337,467,27808,423
6,4,2,2,12,4141,2063,18,1493,455
24,6,18,1,6,159476,3283,1,3283,502
5,3,2,3,69,1201,1553,4,962,532
56,7,49,6,13,136984,78952,0,0,628
9,7,2,3,9,21782,24050,96,12536,566
17,10,7,9,7,101031,91646,135,52577,378
10,8,2,2,7,519312,87385,38,60797,548
10,4,6,4,16,34410,26067,74,11266,417
70,14,56,3,7,33776,11837,32,8856,497
14,2,12,1,10,2550,2210,36,1078,564
46,7,39,1,12,66593,6886,58,546,497
8,6,2,3,4,139365,14758,14,0,464
7,1,6,1,8,4441,4441,0,0,462
16,4,12,2,5,70044,18331,137,12623,536
5,3,2,4,12,19771,19544,0,12401,489
12,6,6,3,9,28849,17290,31,821,487
6,4,2,4,7,22108,22108,305,12689,482
22,17,5,5,7,314792,18508,59,966,466
12,9,3,3,7,470005,85781,54,5292,470
16,7,9,5,9,75636,36652,40,12786,532
21,14,7,9,21,212448,199177,194,0,453
7,3,4,2,11,174897,13114,49,0,566
7,4,3,0,19,44231,0,7,1201,652
3,1,2,1,7,2010,2010,4,2010,533
14,9,5,0,5,5707,0,33,292,591
18,9,9,3,12,77914,48876,40,20127,424
7,1,6,0,3,7759,0,0,0,614
30,16,14,0,45,1565102,0,21,822,545
4,2,2,2,5,12448,11748,20,0,491
38,2,36,3,8,26619,30669,48,23590,476
20,7,13,1,6,80857,3818,6,3818,480
5,2,3,2,16,208056,18367,4,1997,478
11,4,7,1,18,36935,25778,22,209,459
16,6,10,6,17,426523,249608,21,62746,421
7,4,3,0,5,61546,0,1,0,576
7,4,3,0,5,245423,0,3,5412,580
33,7,26,3,8,93220,5315,84,3080,412
71,5,66,2,8,18490,12100,148,11670,449
17,8,9,4,12,54772,25301,43,1311,474
17,8,9,5,9,321785,17840,84,7186,541
27,8,19,4,15,871295,50720,33,11122,474
39,9,30,6,13,615928,30411,67,63569,444
16,12,4,1,8,537310,16298,10,94,542
9,4,5,1,5,2085,2085,34,446,462
13,9,4,1,8,31630,2300,1,2300,531
22,16,6,9,7,120333,69717,102,20710,459
23,9,14,9,19,376900,251899,137,31776,498
25,13,12,5,28,630898,106326,68,13911,437
205,3,202,2,7,171709,12838,41,5700,581
5,3,2,3,5,14160,14160,38,9130,461
70,9,61,4,22,213212,6626,93,1288,461
16,6,10,5,12,224424,125582,146,7583,515
8,3,5,4,5,5631,11323,19,2938,513
29,8,21,1,23,116868,1284,29,2364,565
35,22,13,1,11,1850970,4984,48,0,514
22,6,16,5,10,17830,14241,183,5412,576
19,10,9,5,9,275989,3839,224,3249,451
23,5,18,5,10,12590,13645,325,7082,428
11,3,8,1,10,19610,19610,32,1658,567
18,8,10,2,7,34356,159,111,3841,550
4,1,3,0,14,0,0,23,0,664
15,12,3,6,10,69539,11764,120,2839,398
7,3,4,2,8,39095,38929,33,0,455
6,0,6,1,11,47094,47094,36,851,636
3,1,2,1,2,25500,255,44,356,530
9,5,4,0,18,39656,0,0,0,687
24,8,16,2,21,593137,7117,100,3386,454
11,2,9,0,16,0,0,2,164,699
6,1,5,0,12,0,0,5,259,704
21,11,10,3,8,933998,154420,32,3355,460
25,6,19,3,18,20228,4633,103,3535,473
25,9,16,5,11,38081,14667,35,8969,406
15,7,8,5,15,26189,27029,87,6894,444
7,3,4,2,8,14977,12828,81,0,534
29,13,16,4,17,441620,16543,56,5955,512
7,3,4,5,9,80429,101838,0,0,418
13,6,7,5,9,126597,118937,85,1250,498
14,7,7,6,12,124503,138692,132,77114,507
5,3,2,3,5,25912,37827,0,0,574
6,4,2,4,8,12459,12459,56,11575,460
15,8,7,3,17,476882,54865,73,4890,448
4,1,3,0,6,3949,0,41,0,688
18,4,14,2,8,14942,6456,26,7100,474
12,6,6,0,19,275538,0,28,1906,587
15,5,10,2,6,37653,4381,19,2502,511
112,16,96,3,8,846618,126599,192,18546,449
4,2,2,2,6,15645,15645,229,8322,495
28,4,24,2,13,336496,10233,62,27562,528
37,10,27,1,13,664858,4560,85,6046,441
6,4,2,4,12,34835,34835,50,14325,481
49,10,39,8,8,51846,31702,289,9021,412
20,9,11,0,15,157768,0,2,2289,632
10,6,4,3,5,13986,6750,23,3631,487
27,12,15,7,15,256420,74618,149,13807,439
19,8,11,5,9,809466,31943,127,10319,504
14,7,7,4,5,134225,51714,65,36675,485
35,15,20,6,13,524175,138107,187,1771,524
7,5,2,0,12,21985,0,0,0,623
4,1,3,0,13,3800,0,0,0,675
3,1,2,2,2,5906,23680,21,0,612
23,8,15,4,13,319507,304617,0,0,499
17,9,8,8,11,136583,49338,139,3868,471
10,5,5,4,18,65972,51240,43,35254,420
34,12,22,1,8,390225,13540,20,219,480
15,5,10,3,13,221569,31597,44,6039,466
25,4,21,1,13,21821,1133,15,3011,497
7,5,2,4,9,31153,12290,25,4167,488
30,8,22,1,13,4024,4024,30,4777,406
4,1,3,2,9,5849,38113,32,0,507
10,4,6,8,7,27797,42577,0,0,456
15,8,7,7,22,214298,249611,133,11339,466
9,3,6,3,4,6222,2575,38,2601,425
13,7,6,3,9,9218,7636,109,5019,486
8,2,6,4,8,45215,45106,240,3731,607
11,8,3,0,8,455433,0,18,0,577
9,6,3,6,9,34357,45453,119,19654,455
12,4,8,2,7,15663,7126,34,1273,535
12,5,7,2,8,46070,10324,11,0,520
38,23,15,10,22,726158,356010,238,63532,488
8,4,4,3,3,13153,11810,34,5460,417
25,4,21,4,12,11838,11838,45,9018,512
10,2,8,0,7,4441,0,90,4332,449
366,12,354,3,11,340417,21090,104,11631,482
22,13,9,1,13,622126,10878,0,360,486
8,2,6,0,8,45943,0,1,0,686
6,4,2,3,8,340923,6045,46,3928,496
18,7,11,5,7,212636,66240,46,24365,396
21,10,11,2,9,30558,41130,44,0,437
18,7,11,3,18,653202,2432,60,32000,619
12,8,4,0,19,503528,0,20,26776,567
23,2,21,3,6,8242,11386,58,3144,437
18,6,12,5,13,563771,65129,58,23725,424
35,18,17,0,17,573048,0,23,285,546
17,7,10,1,12,276639,2877,16,1050,489
26,9,17,1,16,983010,585390,34,488,690
38,7,31,5,18,48194,19620,285,12517,456
20,8,12,7,12,84510,49861,168,16858,465
5,2,3,0,7,327355,0,4,0,596
9,7,2,6,5,209358,60175,9,8393,440
20,9,11,3,13,166884,15684,41,10164,529
14,4,10,1,21,44500,44500,12,4400,662
15,10,5,1,11,572061,2638,12,0,591
39,9,30,1,14,344768,474,21,2694,523
10,6,4,8,8,81735,116575,124,5991,580
6,1,5,0,20,40692,0,0,0,717
12,6,6,2,5,358736,34591,46,1374,621
7,3,4,1,12,662,662,33,1580,581
15,7,8,1,6,177664,427,99,4562,484
18,7,11,2,14,251304,195585,69,9143,495
16,9,7,7,15,301520,342127,114,133937,463
19,7,12,3,13,167087,15515,15,0,512
13,9,4,2,14,100209,34936,27,0,513
21,7,14,4,12,34246,5365,45,2400,438
33,17,16,0,21,3593344,0,29,109164,667
17,7,10,1,35,205141,10643,25,0,555
14,6,8,5,14,79829,76975,244,20104,509
11,6,5,3,8,44503,6055,33,3688,472
9,5,4,4,8,3224,137245,0,0,478
5,1,4,1,6,500,500,1,0,696
17,8,9,3,8,82423,41790,33,18131,424
33,6,27,4,12,12156,8541,24,5737,468
7,5,2,1,12,22386,809,16,0,544
8,2,6,1,11,16475,4473,36,11320,470
12,5,7,0,10,3282807,0,49,0,651
9,7,2,3,16,213534,10588,59,1361,574
5,2,3,0,7,3509,0,0,0,614
15,12,3,0,8,308234,0,0,0,587
42,11,31,0,20,100557,0,98,0,623
8,4,4,3,9,9691,9691,42,3750,405
9,5,4,1,6,110996,9885,15,375,492
28,11,17,1,25,398463,4246,18,0,428
86,7,79,1,10,30551,2050,230,2223,475
22,14,8,4,7,65154,3388,106,2336,498
32,1,31,1,7,349,349,11,349,536
7,4,3,0,7,158204,0,18,0,620
13,9,4,7,10,183034,66531,44,0,439
27,11,16,3,26,578827,27884,7,2031,530
12,8,4,1,8,1587694,2,28,0,597
6,2,4,1,11,7681,7681,60,0,601
55,6,49,3,19,33130,30976,47,22829,446
10,7,3,6,7,75795,62410,56,10152,453
9,3,6,2,16,289947,15852,110,10859,565
30,14,16,0,8,495403,0,0,0,678
9,4,5,3,4,188878,12921,199,4580,506
13,4,9,2,6,52493,4020,20,2520,500
18,5,13,4,10,21581,133749,131,891,468
13,4,9,4,17,281773,404381,19,459,483
33,18,15,0,13,1554220,0,8,0,562
12,5,7,1,6,469592,2887,13,2887,500
5,2,3,2,14,32385,16411,18,10061,517
7,3,4,4,9,12084,12084,52,4306,449
26,3,23,2,13,6682,3829,61,3769,484
18,5,13,1,16,62349,3693,43,3693,480
91,15,76,10,20,608582,59460,167,15168,403
26,7,19,4,38,626311,52367,32,0,518
8,4,4,0,7,5264,0,0,8172,701
33,14,19,0,18,279209,0,2,794,688
16,3,13,1,10,723782,78580,0,0,646
12,7,5,4,17,45641,44478,45,29573,532
20,12,8,5,8,507062,26819,45,3834,520
7,4,3,2,11,9426,3487,97,4380,496
8,3,5,1,10,18572,13550,30,13550,566
5,2,3,0,8,218629,0,24,3761,618
17,8,9,6,24,5166,78521,75,500,594
9,6,3,0,13,568042,0,5,0,640
16,9,7,6,69,380539,65780,100,21578,452
27,6,21,0,13,362069,0,11,0,513
24,10,14,8,7,225232,251267,200,94433,417
144,5,139,3,14,70175,60752,159,8666,449
33,10,23,7,19,309922,24812,87,7138,465
16,7,9,6,14,475275,373734,110,0,486
31,9,22,6,26,267887,64748,86,8016,433
159,5,154,0,19,103776,0,52,710,691
5,2,3,3,17,25051,22289,25,3761,433
90,13,77,5,14,363582,129968,90,9966,427
11,3,8,1,12,41129,6605,13,434,616
12,6,6,2,9,264730,4899,59,0,490
15,4,11,3,12,54915,11074,44,9511,625
5,2,3,2,8,2245,2245,12,2503,473
6,3,3,3,14,28034,28034,59,75927,493
8,5,3,2,6,137013,6062,19,5567,471
10,3,7,3,8,38851,38851,51,23591,504
28,7,21,1,16,38034,6652,26,6652,581
18,9,9,6,4,121230,26081,9,3743,399
6,2,4,0,7,8674,0,0,0,669
16,5,11,3,8,17206,12754,200,9001,529
53,17,36,8,15,361572,27141,62,5938,447
17,3,14,3,14,993692,89493,65,59177,455
8,3,5,4,15,176175,83930,15,17036,504
26,13,13,1,16,804484,87,5,104,577
37,13,24,14,12,118049,102792,493,14722,416
7,5,2,1,11,27001,6022,13,1580,514
13,7,6,3,7,40059,1324,79,893,539
30,8,22,5,14,117707,53313,98,5600,471
20,1,19,1,11,3530,3530,12,3530,623
5,3,2,0,13,104315,0,1,206,615
260,10,250,6,26,394749,333287,70,69570,481
21,16,5,0,16,1681561,0,0,0,655
22,4,18,1,5,60960,1025,28,3613,487
6,4,2,1,14,30622,7193,103,8606,451
20,13,7,4,15,4385979,51152,33,1657,359
17,8,9,6,9,49622,41381,24,19574,419
5,3,2,2,10,83741,83741,36,12586,532
17,8,9,0,13,89223,0,0,83,635
9,5,4,2,8,29382,3346,16,1991,481
25,9,16,3,14,63922,8428,19,6300,572
9,3,6,2,7,4046,9539,10,1057,496
11,4,7,0,16,285949,0,25,13950,576
18,9,9,4,12,497807,68432,76,0,459
9,3,6,2,9,8926,8926,43,6182,640
9,4,5,4,10,3891,3891,4,2145,426
17,5,12,4,10,74639,37892,235,9533,427
8,3,5,1,9,4155,9004,13,9004,604
6,4,2,3,6,53818,47274,0,0,491
19,8,11,4,14,263833,37733,69,3607,460
26,0,26,1,11,7714,4408,4,5159,623
5,2,3,2,8,18368,29273,37,18826,629
56,4,52,3,23,21717,34242,91,96981,486
42,4,38,3,38,249552,23517,40,14811,561
10,5,5,0,10,144638,0,16,0,578
24,0,24,0,7,0,0,47,3504,609
6,3,3,2,6,28366,24933,49,1597,518
7,5,2,2,2,47862,2493,6,973,461
24,10,14,5,11,310764,104890,91,72977,439
11,5,6,4,11,31284,30364,322,12430,424
8,3,5,2,13,21277,22617,1,8870,421
11,1,10,0,18,1138,0,0,645,594
8,6,2,3,8,21399,20294,166,12883,504
29,15,14,10,9,140295,101424,28,16834,465
19,5,14,2,23,612123,612123,259,8140,462
16,6,10,1,5,34354,7,29,1481,490
18,8,10,0,14,456988,0,25,656,517
15,2,13,5,12,0,60660,44,670,632
5,3,2,0,5,9938,0,12,3399,508
12,5,7,4,9,17619,59807,73,10230,511
37,13,24,1,16,86361,15236,81,15236,455
29,4,25,3,28,57686,72692,26,2893,527
39,11,28,2,13,299108,2485,30,4749,416
38,13,25,11,16,2042863,161840,79,8725,381
14,6,8,3,7,35204,14355,98,8172,430
35,12,23,0,11,88989,0,1,259,639
13,4,9,3,16,53112,7209,24,3991,470
5,3,2,1,5,56385,55688,24,0,519
14,8,6,0,20,3447784,0,31,0,424
11,3,8,2,11,36159,7862,33,1174,534
14,4,10,3,6,17296,17296,139,13193,474
18,10,8,1,8,79272,2500,49,14072,527
40,22,18,1,11,59178,2515,5,10041,633
11,8,3,5,12,88589,120947,105,61347,438
39,16,23,5,10,60579,43127,208,14789,441
7,5,2,3,10,499702,22157,84,0,439
10,5,5,6,8,213599,32804,81,11227,455
7,4,3,0,6,52546,0,32,0,575
34,2,32,3,7,8765,19584,129,8612,631
12,3,9,4,9,24351,27706,55,9601,467
14,8,6,3,6,139369,19698,87,2266,579
12,6,6,1,4,23489,205,6,0,534
3,1,2,0,11,0,0,11,0,634
18,7,11,6,13,398453,25528,86,3607,478
26,9,17,1,16,67828,1646,188,4099,472
8,3,5,2,17,713089,7500,37,7039,554
6,4,2,3,9,304057,11010,0,0,514
10,3,7,2,11,16337,16337,40,12667,510
6,2,4,4,11,4898,11792,58,662,535
9,5,4,1,20,338012,970,24,970,523
29,6,23,4,11,418292,48518,166,43802,477
29,10,19,8,69,243669,72315,154,16081,456
25,15,10,1,17,1630131,1014,3,1014,427
9,4,5,1,8,698,698,28,858,647
24,14,10,3,14,357446,19797,116,13219,455
16,10,6,6,9,441550,92085,0,0,453
30,11,19,6,17,423259,35453,69,15679,516
10,3,7,3,11,3683,3683,213,4502,501
13,6,7,5,10,182288,19236,59,8569,461
20,9,11,0,6,169743,0,3,0,621
3,0,3,0,2,0,0,0,0,611
11,4,7,5,10,25842,37903,85,7338,447
11,5,6,3,12,42416,40997,0,0,494
10,3,7,2,14,82495,220786,31,0,565
42,10,32,6,8,138682,70427,37,34897,489
18,6,12,2,8,55101,8240,116,769,542
6,1,5,0,12,0,0,4,0,664
17,7,10,3,14,17619,3196,87,13320,398
5,3,2,1,9,15389,3849,95,3849,622
18,11,7,9,16,609533,46511,114,6610,418
9,6,3,1,9,203928,469,15,0,464
38,9,29,2,15,278505,1239,40,14384,456
24,11,13,4,8,358690,15651,72,952,466
18,9,9,0,14,184512,0,61,3052,463
12,3,9,0,11,0,0,67,1714,592
27,6,21,4,14,85198,74203,27,71212,542
6,1,5,1,7,1051,1051,37,4704,644
10,4,6,0,12,94617,0,22,0,674
9,7,2,1,9,1756,447,0,147,607
8,6,2,3,14,679552,7758,11,0,485
34,11,23,7,12,337236,35518,67,9833,384
9,3,6,1,16,2975,2100,20,2670,436
20,5,15,5,16,51645,51645,78,32131,614
23,9,14,5,12,371228,45270,77,17373,462
9,6,3,0,9,37783,0,3,0,674
13,10,3,4,11,247523,824,75,555,496
9,7,2,3,8,231363,146331,91,10581,487
6,2,4,3,12,40576,53155,18,0,585
27,9,18,2,11,79695,17062,7,232,537
5,1,4,1,11,7240,3040,3,3040,572
7,5,2,4,11,107435,14261,46,28609,486
5,3,2,2,7,2150,9959,30,0,636
8,6,2,0,8,122249,0,0,3094,598
17,2,15,6,11,38183,124774,0,0,473
8,6,2,6,7,55083,68621,111,27793,484
34,6,28,4,13,110834,71166,57,4575,500
15,2,13,2,14,406065,55275,29,550,474
15,10,5,9,18,411088,89290,102,23308,401
23,10,13,3,12,433556,150295,45,148277,519
13,7,6,5,19,83355,49677,59,1197,489
22,3,19,0,9,171536,0,9,0,640
14,5,9,3,7,206304,14386,0,0,452
17,11,6,1,13,358217,271,74,0,493
7,1,6,1,7,4398,4398,279,4398,621
9,3,6,3,4,49317,3522,14,2184,499
36,11,25,8,14,486285,468825,79,14340,430
8,6,2,2,7,385669,13121,136,10559,447
9,1,8,0,7,0,0,12,2205,668
21,12,9,2,12,369536,2597,4,2274,513
18,4,14,2,8,382466,87704,32,2721,439
15,11,4,1,11,324702,1418,33,0,460
6,3,3,0,13,13054,0,0,0,642
3,1,2,1,23,2472,2472,0,0,655
21,9,12,1,27,51188,49677,22,935,550
2,0,2,0,7,0,0,5,867,675
17,9,8,14,23,865020,1246682,253,291506,359
38,18,20,12,13,909552,116065,255,55133,414
26,8,18,1,44,95253,876,5,2268,574
14,6,8,2,8,157199,48584,97,81177,353
39,8,31,3,16,49292,9220,102,9693,414
4,2,2,1,2,10866,525,4,0,545
14,6,8,2,9,57610,6311,13,0,478
14,4,10,1,6,316825,14775,16,1989,617
9,7,2,5,12,366062,17131,75,42786,419
16,11,5,10,7,416507,294851,125,4361,406
10,3,7,2,13,43962,51291,40,0,549
4,2,2,2,12,16581,16581,146,15621,512
9,5,4,0,10,38500,0,0,0,637
10,5,5,3,8,17449,5710,121,3408,477
9,2,7,1,14,323483,2966,96,9129,440
16,10,6,3,7,389265,13244,71,5986,468
25,5,20,3,11,568076,172682,83,0,521
17,8,9,3,18,128767,116187,62,10171,469
29,6,23,4,7,47021,28005,135,5260,449
8,3,5,0,14,0,0,14,0,713
23,8,15,5,22,174661,193059,83,2220,456
11,6,5,4,12,49535,26796,53,1389,509
45,10,35,11,14,496955,168608,224,9137,447
26,7,19,4,16,279458,27008,136,26020,540
7,2,5,3,15,48254,51092,52,3268,542
10,3,7,1,8,11719,3529,30,6200,410
13,9,4,0,11,878006,0,3,0,605
8,4,4,3,10,466345,62209,39,0,451
25,16,9,0,12,2023014,0,0,0,632
14,7,7,6,10,249457,43777,52,14721,499
20,7,13,6,11,78047,17152,348,5904,443
31,11,20,0,18,29661,0,61,293,609
19,1,18,2,10,36444,36444,33,2409,579
34,7,27,5,13,71465,44463,60,19049,499
3,1,2,0,3,41530,0,2,0,639
10,2,8,2,6,11684,9715,50,0,498
40,4,36,4,15,67188,67188,252,43840,513
3,1,2,2,7,12503,22706,30,12503,630
31,8,23,0,8,39986,0,61,3672,477
7,4,3,2,14,29946,29946,0,0,532
19,10,9,1,12,192337,26928,30,16404,598
4,2,2,2,10,3619,21523,29,3619,648
18,8,10,0,22,171376,0,7,0,674
11,6,5,3,7,22796,1847,91,1441,532
30,13,17,6,11,305883,27102,409,14750,471
11,6,5,1,14,315546,17200,15,17200,640
10,7,3,1,13,2786,2338,72,2994,542
15,11,4,0,9,50635,0,14,0,497
12,9,3,0,17,492027,0,4,3475,589
31,5,26,3,11,61172,30340,29,14537,534
22,4,18,5,10,262987,31923,24,0,513
14,11,3,2,32,232185,38388,37,30784,576
46,14,32,12,13,42212,42037,265,7339,406
12,5,7,0,11,57123,0,42,1589,542
38,15,23,0,12,819107,0,14,0,580
11,6,5,5,15,526085,39560,75,4206,486
41,4,37,3,7,16666,1542,308,17331,486
3,1,2,1,6,8022,537,25,0,545
20,6,14,0,19,803107,0,4,0,690
46,18,28,5,69,374034,64494,121,25550,460
5,3,2,0,6,13639,0,0,0,648
4,1,3,3,5,563,19437,40,0,497
13,8,5,0,10,8324,0,19,2746,612
38,11,27,8,21,346594,85171,97,17155,407
9,4,5,0,11,93608,0,6,5850,677
44,8,36,4,13,221428,108269,80,3617,443
6,2,4,0,14,25351,0,6,31450,633
8,5,3,4,8,193334,58770,108,35368,478
27,4,23,2,16,49703,15051,45,3663,467
11,2,9,2,9,0,20414,40,7356,651
31,12,19,4,18,357646,31572,34,14006,510
25,6,19,3,3,30641,2038,71,1194,549
15,11,4,0,8,384846,0,7,0,563
15,3,12,1,16,136417,11308,96,19700,518
9,4,5,5,5,58606,45017,103,15485,423
11,6,5,3,31,36865,15078,68,11857,450
39,6,33,0,10,40979,0,35,2348,525
3,1,2,0,7,16082,0,8,0,539
5,3,2,4,11,29008,31471,87,11111,559
37,9,28,1,16,270333,298,75,1710,510
7,3,4,3,14,14403,14403,69,13000,516
11,7,4,4,13,54215,54215,60,19667,426
5,2,3,0,11,3656,0,0,3555,611
5,1,4,1,7,2146,2146,16,2146,595
7,3,4,2,9,22252,8108,0,0,477
30,8,22,6,9,301932,34613,401,17385,451
7,3,4,0,15,62256,0,0,2346,625
48,12,36,4,20,117027,29725,102,2806,454
5,3,2,0,3,413043,0,0,0,516
12,7,5,0,10,310145,0,6,0,521
11,8,3,4,3,211254,121556,10,0,415
13,5,8,7,11,11098,91309,133,5950,615
20,5,15,1,14,14958,3836,12,19049,431
7,4,3,2,10,36852,25019,49,18060,637
27,5,22,4,9,27366,28637,52,9692,497
33,10,23,19,16,241418,554332,249,43735,555
48,13,35,10,21,203087,86853,24,19805,453
12,7,5,1,7,712983,202,20,964,536
73,6,67,3,13,5357,3895,32,6508,460
79,30,49,1,13,750694,661,12,18622,494
17,11,6,5,8,283384,15138,8,834,466
67,15,52,1,18,1412737,330,28,47611,607
12,8,4,2,9,193227,14745,102,10086,488
28,9,19,0,9,79541,0,36,206,575
27,3,24,3,14,439101,15045,23,7919,454
60,4,56,1,12,386766,58729,52,0,507
39,7,32,1,12,506029,15736,160,5034,541
10,4,6,2,15,16661,27723,30,16661,618
48,14,34,0,10,1148989,0,51,4268,612
8,3,5,1,11,673228,27279,10,0,606
21,3,18,3,14,11170,11170,87,2981,428
33,5,28,4,13,158646,155174,109,10107,465
6,3,3,1,8,4568,442,20,442,442
15,3,12,1,7,49835,760,35,750,534
6,3,3,4,5,32492,32490,140,13076,395
17,7,10,4,13,90938,37013,55,8770,427
5,1,4,2,7,28205,18399,19,22278,585
16,7,9,12,8,360652,394837,180,13022,509
33,13,20,8,8,446711,64486,281,8106,418
8,2,6,0,6,7507,0,25,13209,486
3,1,2,2,7,95380,95380,41,0,503
4,2,2,0,3,12168,0,37,3791,629
12,7,5,1,23,6422,4852,48,406,504
11,3,8,1,9,19148,8731,95,8731,423
20,8,12,2,14,296004,11720,19,330,579
20,6,14,4,11,63233,51903,54,27597,462
24,4,20,4,11,48858,4923,95,4246,502
30,10,20,2,7,47193,9036,57,7924,444
14,6,8,3,16,159934,8805,20,1985,522
15,8,7,3,11,550746,22855,70,12230,432
17,6,11,1,8,71899,6139,15,1629,465
7,4,3,6,5,48980,47023,127,261,456
30,12,18,0,25,62401,0,0,15717,619
7,4,3,0,5,38346,0,2,0,578
10,7,3,7,11,149865,149865,285,46655,434
32,5,27,2,8,51346,6071,172,3700,454
17,9,8,5,26,169681,20084,141,23000,599
8,5,3,1,4,76839,123,3,0,592
18,13,5,10,13,353812,72268,152,16372,438
6,4,2,3,9,31684,8008,63,1596,493
9,5,4,1,11,22187,498,17,18543,524
18,9,9,8,7,179279,155804,182,20219,457
23,11,12,5,11,53546,16368,44,7530,425
7,4,3,2,8,36045,8930,2,4465,482
27,8,19,5,14,426096,194907,154,30570,486
15,10,5,2,11,35007,9316,17,8821,436
4,2,2,1,7,0,8820,24,0,605
5,2,3,0,14,0,0,27,0,519
37,9,28,2,9,322102,7270,13,3096,447
10,4,6,5,5,30916,30916,403,12124,490
9,7,2,6,11,147827,133052,121,9422,396
23,4,19,2,9,39287,18493,54,15418,522
12,1,11,0,12,342067,0,0,0,630
37,16,21,0,14,1166027,0,23,3625,671
24,14,10,4,12,177430,6808,1,8937,396
7,3,4,1,17,35163,6461,9,6461,656
27,5,22,6,12,148957,179324,199,90092,474
14,6,8,2,22,777522,25817,68,1332,552
4,2,2,3,12,28946,22507,0,0,496
16,5,11,4,19,34701,22359,36,12764,391
6,2,4,0,7,115053,0,17,1683,613
56,12,44,5,13,82043,5791,81,7342,459
18,2,16,0,27,0,0,28,1320,526
8,6,2,5,25,8730,5892,101,971,426
9,3,6,0,8,183882,0,11,0,617
9,7,2,0,4,214337,0,2,0,567
21,6,15,4,5,189814,69764,61,0,451
33,21,12,0,11,221619,0,0,0,642
6,3,3,0,18,273744,0,27,0,574
15,3,12,3,11,41492,40076,59,18370,544
37,7,30,2,12,144650,73014,163,16792,468
87,15,72,12,30,809955,290497,67,53055,445
20,4,16,4,14,62594,32625,54,6310,459
7,4,3,5,4,35354,32669,67,6975,461
15,10,5,11,4,587382,964158,114,273898,455
6,4,2,3,6,19924,22949,68,467,531
22,15,7,1,7,1046734,50,10,2360,646
30,5,25,3,8,347319,24585,61,0,508
22,2,20,1,11,728,728,27,2253,549
32,13,19,1,19,191750,225353,2,272,453
5,3,2,1,4,17347,655,62,2058,481
39,10,29,4,22,711351,192239,24,26120,453
29,5,24,5,12,72287,36880,168,1161,550
11,6,5,4,18,61187,39440,0,0,550
3,1,2,0,6,19331,0,2,0,627
12,2,10,3,9,22939,32391,14,22229,570
11,9,2,2,17,91541,948,15,5122,501
15,6,9,10,14,50354,179988,0,0,474
11,8,3,0,6,1271353,0,17,1406,474
6,4,2,2,13,262074,74688,35,47914,470
8,5,3,4,12,17820,17820,133,11155,474
28,3,25,2,7,21716,21716,68,2073,499
11,5,6,4,8,50302,29396,111,40,480
22,9,13,4,5,191429,174982,125,8510,433
6,0,6,0,6,0,0,0,0,665
14,5,9,5,8,56487,60652,102,26412,518
16,8,8,1,9,530498,554,19,554,527
50,6,44,0,18,44040,0,9,1823,632
17,8,9,2,6,22720,3362,31,3537,471
156,11,145,2,8,48288,4988,87,4896,490
6,3,3,2,8,15852,15852,19,7926,533
30,8,22,7,13,65945,37255,6,13341,447
15,5,10,4,17,13169,7489,131,3222,516
8,2,6,7,7,34576,49757,0,0,445
12,4,8,1,9,32612,4745,18,230,486
13,7,6,4,7,43192,21247,47,11504,527
5,3,2,0,17,19813,0,5,3226,570
15,5,10,2,12,124347,3237,7,2252,518
15,8,7,0,8,97824,0,3,0,564
7,2,5,0,8,0,0,0,0,766
16,1,15,2,8,145,1145,26,4252,616
10,5,5,2,11,7826,8023,67,0,507
37,5,32,3,10,27672,26063,72,92820,455
6,3,3,4,15,9954,9698,46,3264,539
27,6,21,1,12,76328,2077,7,0,619
25,6,19,2,12,296532,26844,191,22288,501
9,6,3,4,7,22435,26162,230,8750,485
15,6,9,3,7,159897,51578,119,7131,385
64,9,55,1,17,92436,1830,8,5054,494
14,6,8,2,13,209567,124750,10,123416,522
37,10,27,6,5,104136,54331,56,21604,486
17,6,11,6,10,69990,30157,157,7341,476
9,6,3,3,12,41853,24898,50,3465,481
22,7,15,2,10,324145,17720,49,4080,424
3,1,2,1,7,812,812,13,812,627
9,7,2,8,12,63568,74267,301,17901,429
17,7,10,5,39,497529,398972,90,10014,437
12,2,10,0,9,232435,0,23,0,632
16,6,10,4,11,246985,219571,0,0,442
4,2,2,2,11,363555,55232,40,0,564
15,2,13,3,12,63298,29487,0,1193,474
19,7,12,5,13,58109,54023,95,28106,436
30,10,20,11,16,344991,372048,158,24654,412
25,7,18,3,14,140340,23060,78,13772,497
18,4,14,2,9,27135,644,16,5487,572
6,3,3,1,10,369802,1539,5,0,469
12,8,4,3,11,51407,46871,62,32090,485
8,3,5,2,12,27133,27133,48,11897,477
29,9,20,3,13,404087,218730,104,76982,475
35,8,27,5,6,262743,17107,115,7456,362
28,3,25,2,6,10258,7324,37,0,476
8,5,3,0,6,15971,0,3,0,498
74,4,70,4,13,115640,11389,200,7441,512
5,3,2,2,7,19221,19221,56,10206,625
12,5,7,5,8,41243,22506,62,5400,517
8,2,6,2,10,4330,4285,37,1306,503
16,6,10,2,7,53232,28742,35,2830,474
12,5,7,0,12,139915,0,4,477,489
5,3,2,0,11,171478,0,26,0,554
12,9,3,5,9,96460,38489,52,7768,511
27,14,13,1,16,102822,4600,39,795,603
13,8,5,0,6,195511,0,0,0,470
9,4,5,4,9,40449,39090,1,746,443
4,2,2,1,7,9905,9905,20,9905,555
26,4,22,3,9,50954,23991,126,12706,584
13,7,6,5,18,240409,42973,33,0,499
11,3,8,2,9,6841,3201,30,1403,475
11,7,4,5,7,33190,12601,79,841,498
12,4,8,2,11,17405,3827,100,2264,476
9,5,4,5,9,22691,22399,61,2333,420
8,1,7,0,19,0,0,6,0,547
23,7,16,8,12,669659,163294,145,24444,509
28,15,13,4,16,367487,21888,72,10640,486
13,5,8,3,24,26976,15076,5,8322,503
7,4,3,1,10,13374,8589,0,0,553
21,3,18,3,15,212144,37980,53,24612,642
27,4,23,2,8,11945,2029,227,3838,485
11,4,7,2,16,923257,208083,0,0,603
14,4,10,0,18,438605,0,6,186,673
27,7,20,0,6,22913,0,6,0,508
49,15,34,12,17,352037,347442,179,220000,501
13,6,7,1,34,24080,3120,2,3120,555
19,8,11,2,11,599457,36368,41,5658,475
10,4,6,6,8,244080,311684,75,106228,382
11,7,4,5,8,20509,9933,40,5821,501
15,8,7,5,14,45000,13572,4,4689,510
14,8,6,4,5,178382,8820,105,2358,459
24,7,17,2,6,37822,15655,196,13410,417
5,2,3,1,9,37082,36082,25,0,599
50,6,44,2,9,10370,5200,14,5872,485
57,3,54,1,11,10246,1371,27,22805,608
5,1,4,3,4,1982,16257,45,0,497
9,2,7,1,15,594,594,21,594,622
8,6,2,2,11,638689,9295,10,3596,496
14,6,8,1,7,330319,3312,18,3312,428
23,13,10,7,7,346025,32240,199,6134,475
7,1,6,2,6,27805,27805,33,18582,617
16,7,9,2,12,16284,607,4,8619,399
17,4,13,5,7,59444,73759,144,23914,610
17,8,9,4,7,390810,98715,94,3500,439
29,12,17,6,15,307773,22764,87,16336,476
5,3,2,3,8,34103,36269,23,14006,551
8,6,2,2,8,30784,12359,68,11775,468
8,3,5,2,14,25091,25091,37,17498,483
15,7,8,0,8,106540,0,9,92,488
20,11,9,11,11,129552,99530,429,12017,409
35,8,27,8,24,338452,317003,124,21577,511
30,8,22,5,20,335600,43657,0,0,523
14,4,10,5,6,18757,18757,70,6674,453
12,5,7,5,19,401692,221315,145,124828,527
7,3,4,3,9,22173,14816,1,1501,529
16,7,9,2,10,830400,1714,36,0,486
12,7,5,2,5,26771,791,65,2472,497
9,6,3,6,7,23355,20045,345,9548,381
3,1,2,0,3,0,0,0,0,617
17,5,12,3,8,253972,31957,224,9207,498
30,7,23,2,17,525196,490811,36,418651,620
16,5,11,2,42,13459,3018,25,2899,538
30,11,19,12,22,98360,211483,126,31635,476
12,4,8,4,7,35104,39160,125,19088,461
10,6,4,0,7,6011,0,37,1030,606
22,13,9,0,18,1626050,0,21,1200,503
11,3,8,2,16,114306,4984,13,54292,475
20,7,13,3,12,327026,8080,11,6627,532
32,5,27,0,15,51055,0,0,306,654
8,4,4,3,6,17738,4900,54,2335,522
14,9,5,4,9,797542,257012,113,79201,423
14,9,5,6,9,423742,276444,0,0,447
23,6,17,1,15,479805,1355,131,2120,504
10,7,3,5,8,36073,40785,74,1129,463
8,5,3,1,4,37681,629,10,0,560
3,0,3,0,2,0,0,0,0,651
11,3,8,2,3,310666,6434,31,0,465
10,7,3,0,18,65317,0,7,2795,538
28,15,13,0,6,463301,0,1,1062,541
17,10,7,1,25,124528,1964,20,0,600
5,1,4,0,7,6262,0,27,2775,529
11,5,6,5,9,14432,27105,26,7804,391
6,3,3,3,7,30940,30510,51,20516,437
22,4,18,0,12,48491,0,61,873,500
28,5,23,2,5,17904,9673,68,8840,570
6,4,2,1,8,15805,1720,0,0,526
4,1,3,1,20,13123,13123,24,13123,560
16,12,4,0,12,49366,0,10,4517,540
4,2,2,1,7,349,349,24,695,668
24,10,14,3,15,236530,6799,89,7690,439
6,4,2,2,11,43419,1831,0,2314,489
11,8,3,0,9,380309,0,1,0,469
12,7,5,5,8,57065,41306,30,9755,426
75,28,47,1,22,2766239,1644,0,0,492
6,4,2,1,3,118209,1280,3,1323,544
10,5,5,2,15,87224,45120,129,34732,482
29,8,21,8,10,59584,65516,270,16105,433
12,3,9,3,5,12537,10649,47,6802,454
18,9,9,7,19,137561,95436,144,5028,424
25,10,15,0,12,524408,0,7,0,692
15,2,13,3,14,86544,130589,58,1790,646
26,10,16,1,14,704213,100,104,3969,587
14,6,8,0,13,193815,0,31,0,520
9,4,5,5,14,529455,306074,56,202625,390
41,10,31,3,7,101840,8474,189,9150,452
42,5,37,0,19,392437,0,0,0,683
7,2,5,0,13,1914,0,0,3829,545
9,6,3,5,7,72928,12656,59,3470,343
11,6,5,5,13,37302,31102,70,11253,401
20,8,12,2,12,15354,5568,50,2851,462
12,7,5,4,14,255442,33866,23,10857,457
46,7,39,2,20,432410,13853,332,8230,390
11,2,9,1,7,8300,8300,50,3293,539
7,2,5,0,8,11566,0,6,0,671
19,10,9,1,11,106478,1154,1,1154,664
13,9,4,2,11,217528,10357,5,0,513
11,2,9,0,12,11049,0,1,0,676
13,7,6,6,6,58863,63066,76,15365,416
9,3,6,2,9,26526,17251,34,9765,625
37,18,19,5,15,511457,23339,96,30988,387
6,4,2,1,6,7654,2000,23,2000,422
48,9,39,8,12,75845,38452,120,3067,427
19,8,11,8,8,88540,101993,169,23166,431
19,10,9,8,8,679430,62726,70,0,444
20,7,13,4,6,316745,27028,37,14331,514
15,7,8,4,8,74833,20768,55,9797,438
10,2,8,1,8,7810,7810,23,10730,532
17,8,9,2,19,152733,45034,14,324,557
25,7,18,2,15,172955,2158,8,3282,474
23,16,7,10,18,871948,84395,73,13347,405
8,2,6,1,16,16736,16736,17,879,516
15,9,6,7,4,146646,56231,44,2000,437
4,1,3,0,8,8881,0,0,0,608
12,6,6,3,17,78105,43595,69,25771,460
16,12,4,4,8,657575,10844,109,4829,420
5,3,2,1,17,6204,6092,0,0,650
18,7,11,6,15,15167,18565,92,3080,519
5,2,3,2,14,242241,55837,35,0,626
12,5,7,5,7,29670,16958,168,4822,530
10,4,6,4,8,29730,29730,70,9504,480
11,0,11,0,7,0,0,0,174,659
15,8,7,5,18,63283,63283,153,66781,423
19,10,9,6,4,107236,9344,0,0,457
8,5,3,4,7,8719,8345,18,2988,391
5,3,2,0,6,49716,0,4,0,662
25,8,17,2,11,476360,6340,0,0,498
11,6,5,7,10,510675,119859,14,5392,449
14,6,8,4,14,23200,23200,269,14025,500
17,4,13,0,19,230754,0,62,39060,536
10,7,3,7,8,19472,21427,144,7109,512
12,1,11,2,8,5000,14266,26,4311,536
28,11,17,5,12,118593,31412,125,0,488
10,3,7,3,17,16054,23458,29,14335,452
7,3,4,1,14,9939,368,6,368,526
13,8,5,0,11,175375,0,8,711,600
3,1,2,2,14,12546,19854,17,12546,510
8,6,2,3,69,33830,7901,75,5405,440
12,6,6,2,7,223210,9664,11,0,539
5,1,4,2,11,2148,9141,0,0,550
13,6,7,1,12,193052,4819,32,4819,527
20,7,13,5,8,259738,13484,128,9177,517
8,0,8,1,4,0,6059,14,0,574
29,11,18,4,6,55940,1186,120,1543,414
13,8,5,0,9,349214,0,0,0,665
6,3,3,3,8,9755,9755,287,7866,492
10,6,4,4,9,132507,87510,52,0,442
7,3,4,2,12,8943,8943,15,2484,571
36,13,23,11,17,168004,181631,297,43291,496
8,4,4,3,14,343206,67490,36,49093,459
17,5,12,6,7,44758,64321,80,21017,496
12,6,6,4,13,632223,24282,179,15112,423
11,5,6,2,2,56040,13825,10,11437,454
11,9,2,6,14,35099,70773,122,9506,555
4,2,2,0,2,361376,0,1,1500,624
12,8,4,1,11,66322,1320,3,1320,496
39,10,29,5,12,597562,41621,124,6538,451
3,1,2,2,6,2886,12332,34,0,493
17,13,4,0,9,1855553,0,24,8379,620
7,4,3,1,11,13305,238,11,0,518
4,2,2,1,10,6294,6294,0,0,636
19,7,12,8,12,42620,41002,66,13301,455
5,1,4,0,5,0,0,0,0,720
17,5,12,1,18,250645,1818,9,2758,683
7,5,2,1,7,228097,3052,16,0,669
33,14,19,16,26,229326,205464,328,71957,435
27,8,19,7,12,15832,14390,136,4591,431
14,3,11,2,13,10114,12378,20,7850,471
5,3,2,3,18,11313,11313,34,148,457
7,1,6,1,10,1855,18417,17,18417,640
19,5,14,3,12,51862,5438,80,3941,521
12,5,7,3,15,208,63113,88,208,578
20,13,7,6,16,214365,18453,33,7092,501
10,8,2,7,6,31613,31613,297,12291,452
5,1,4,0,7,0,0,110,713,665
44,7,37,5,24,385094,39998,92,3720,551
11,6,5,3,13,13010,31207,208,10637,490
9,7,2,3,8,11837,10575,286,6906,445
12,5,7,1,8,6225,3670,68,8376,542
22,3,19,3,12,6454,6309,10,5280,514
9,4,5,5,11,607759,168566,107,95332,468
11,7,4,0,25,616876,0,0,0,672
13,5,8,3,7,239555,26063,53,806,462
5,2,3,0,8,0,0,23,2500,496
15,9,6,7,19,89774,89774,129,2757020,602
30,12,18,0,12,510667,0,0,3021,666
14,7,7,3,12,221360,14616,34,3426,482
26,4,22,2,7,15489,749,355,930,549
21,7,14,7,18,519776,49495,132,6800,465
19,7,12,7,8,45249,33774,381,8500,488
7,1,6,1,13,0,707,46,7557,548
60,18,42,9,10,137503,59281,320,12052,420
8,6,2,0,4,92343,0,0,0,554
29,4,25,1,13,939816,3142,64,19122,458
30,12,18,1,10,542826,7215,50,5036,480
8,5,3,3,10,557517,14185,60,0,502
21,4,17,4,18,761567,24901,19,8958,521
28,4,24,3,13,44420,37058,181,749,451
15,6,9,3,8,210100,11051,0,0,527
53,13,40,5,14,92904,27258,124,52528,418
23,1,22,1,8,2187,2186,35,2186,457
9,6,3,0,9,530022,0,5,0,538
22,4,18,3,13,50062,61650,21,27587,637
12,6,6,7,8,36664,102093,50,14238,447
51,9,42,0,13,74887,0,0,1253,531
2,0,2,2,2,23306,23306,12,0,603
14,7,7,0,8,41643,0,20,1077,441
8,4,4,4,5,19189,1205,68,1090,566
17,5,12,3,9,52350,54232,68,3575,481
2,0,2,0,6,0,0,0,0,547
20,9,11,5,11,3116482,40098,19,22618,442
41,8,33,3,12,459082,28175,0,6774,419
3,1,2,1,8,8488,8488,13,8488,509
9,5,4,1,13,316895,3398,15,0,552
15,8,7,3,6,95279,3481,13,18345,605
11,7,4,0,9,15484,0,2,0,661
18,4,14,2,8,11119,7419,191,5970,447
13,7,6,9,6,115983,91349,6,2296,409
5,3,2,2,6,9376,9376,9,2174,497
24,7,17,1,16,634739,1692,11,1692,543
5,3,2,3,8,30522,30522,42,13847,517
8,4,4,0,17,20097,0,7,5115,693
7,4,3,3,3,57341,12699,17,2754,445
3,0,3,1,8,0,9246,0,0,533
6,1,5,0,14,0,0,0,188,650
20,5,15,4,15,81390,21848,32,11176,477
6,2,4,2,7,2969,2969,20,2919,506
12,3,9,0,18,162061,0,0,0,691
9,3,6,0,5,120967,0,0,0,683
87,14,73,0,9,303319,0,36,0,507
19,10,9,8,21,694915,92010,98,0,463
6,2,4,2,11,535938,86336,72,83108,502
24,11,13,11,8,147268,98836,510,1670521,437
9,6,3,5,13,583885,99505,64,40203,427
9,4,5,3,14,64056,56347,45,44935,486
8,1,7,1,8,3430,25556,16,0,647
57,3,54,3,7,49779,16276,43,10443,504
16,6,10,2,21,415142,399950,27,359447,672
17,6,11,1,9,18239,389,27,3421,470
6,3,3,1,6,17252,8640,35,8640,634
20,8,12,2,13,6173,3343,222,4211,447
21,6,15,3,8,201361,45188,10,1500,442
12,4,8,0,6,17253,0,1,301,654
78,8,70,4,12,153487,131340,242,22031,460
17,8,9,4,9,49441,30397,61,11482,493
13,10,3,4,11,87621,64469,63,70,500
11,5,6,5,7,13466,12948,65,3946,411
5,2,3,2,11,8966,8966,57,5541,549
17,12,5,6,3,149623,50618,42,12919,417
58,12,46,11,6,372465,450631,85,140699,416
22,4,18,3,12,64795,32442,64,22967,539
16,9,7,5,12,144795,144795,147,36324,450
35,11,24,3,11,146116,29616,76,17813,519
13,9,4,4,8,118804,3502,39,2816,456
13,3,10,2,9,16674,26781,19,2273,466
13,7,6,0,14,392284,0,5,0,616
41,8,33,7,9,38824,45927,50,9568,357
6,3,3,5,13,44719,53227,74,13655,578
35,8,27,8,13,487146,75949,210,30537,423
15,7,8,5,10,64001,13818,72,4386,478
30,13,17,16,9,583342,202622,325,0,439
18,10,8,10,7,41064,39948,183,8286,419
15,6,9,5,16,99154,96194,418,59851,485
19,6,13,3,17,2926,17352,44,3542,465
7,2,5,1,5,5547,1711,1,371,485
18,12,6,4,9,140496,6294,30,1692,545
15,2,13,2,8,15729,14927,56,5560,483
19,6,13,3,12,140814,13792,4,1570,544
34,2,32,2,9,11363,11363,98,8068,571
22,14,8,5,8,715028,55974,18,11903,453
9,3,6,2,2,49373,44143,6,22374,487
6,3,3,2,7,6508,6286,0,0,517
10,8,2,8,7,351839,44516,118,11637,458
11,6,5,5,38,961779,409940,29,0,466
11,7,4,2,7,189213,633,17,0,517
33,10,23,0,18,56669,0,12,5400,473
5,3,2,2,6,4974,4974,15,0,460
49,6,43,0,10,330254,0,3,3240,522
7,3,4,4,5,12030,24218,0,0,515
8,6,2,0,8,325247,0,0,7963,676
13,8,5,4,9,191960,10118,38,7201,453
12,8,4,4,13,11072,11072,61,6840,391
20,13,7,1,12,219155,1,23,0,479
6,2,4,0,11,1401,0,2,18429,644
18,11,7,9,14,102235,88054,127,32227,464
16,8,8,6,22,376231,356833,104,37932,465
8,2,6,1,9,11498,2017,40,359,488
6,4,2,2,6,4649,691,8,716,550
11,7,4,7,5,206463,32376,344,7505,480
6,3,3,0,7,25658,0,25,3936,484
23,11,12,7,13,134268,79579,125,12360,419
6,4,2,1,8,17780,1065,8,7195,505
37,3,34,1,14,25142,25077,144,9997,613
24,11,13,7,17,448940,245275,106,161641,442
16,10,6,3,14,894178,6557,83,3000,515
13,4,9,1,4,245243,1568,2,0,508
4,1,3,0,10,0,0,0,0,660
8,6,2,2,17,37459,1355,6,2012,487
8,6,2,2,19,51409,15605,48,10477,465
48,7,41,5,9,54849,15910,92,10160,460
34,3,31,2,12,13421,5790,37,3630,553
18,4,14,8,9,271316,125034,171,47879,456
23,10,13,1,14,905811,3287,18,3287,666
3,1,2,2,8,13331,41891,95,13331,633
36,9,27,0,4,270755,0,1,5973,504
7,2,5,2,12,25146,25146,56,13536,627
18,12,6,1,14,1734717,3163,9,3163,537
11,8,3,6,6,107077,57611,105,0,466
29,5,24,3,12,89524,13004,53,7833,593
7,4,3,2,9,9684,4510,40,37339,466
4,2,2,0,6,6323,0,4,0,602
44,13,31,9,12,460282,158801,348,9727,481
31,20,11,15,13,1024076,248966,114,68117,423
17,5,12,1,11,176683,28761,4,28761,530
12,2,10,1,9,183963,3393,9,0,614
13,3,10,1,5,4464,2550,4,2550,600
4,2,2,2,4,3015,4119,113,3015,534
49,8,41,4,6,158937,45196,141,21516,472
9,4,5,1,6,33952,6188,61,0,457
27,9,18,2,10,55926,2477,73,3449,440
5,1,4,2,8,5149,12099,0,0,485
11,4,7,4,19,22512,14136,70,1705,462
17,5,12,5,7,37354,35215,180,10777,442
40,18,22,0,22,3394279,0,3,0,555
3,1,2,2,14,6299,9863,21,6299,485
3,1,2,0,11,812,0,0,912,584
12,5,7,6,7,29048,43631,336,7082,510
5,3,2,4,8,77132,36277,17,9961,510
21,6,15,0,8,27537,0,4,140,653
35,12,23,2,13,191821,4614,8,1684,472
3,1,2,1,8,13318,13318,0,0,474
3,1,2,1,3,778,778,9,778,592
36,5,31,2,18,7811,6464,32,5775,507
13,7,6,0,11,185457,0,5,7210,676
29,6,23,1,13,405957,3374,41,799,460
18,5,13,4,14,60316,54599,54,29604,500
10,3,7,2,13,36435,30155,55,3132,549
14,4,10,5,9,21944,50486,61,1865,443
49,7,42,6,17,62970,62340,294,35648,464
24,2,22,1,18,11664,11664,23,1485,639
14,8,6,9,9,765898,251861,0,0,466
40,13,27,8,6,429395,37663,128,6501,417
3,1,2,1,8,0,5378,9,0,654
3,1,2,2,2,1915,3830,0,0,360
14,3,11,6,9,51535,80263,143,24526,500
109,15,94,4,11,154907,41479,292,35658,483
10,4,6,0,11,48909,0,14,0,683
24,6,18,3,18,463021,8930,52,6149,433
10,4,6,4,11,141237,37757,84,12943,481
6,1,5,3,6,7039,9778,60,4890,564
8,6,2,5,13,25383,30896,82,7824,453
9,5,4,4,11,25248,25248,61,17267,470
3,1,2,1,3,385,385,9,385,663
25,5,20,3,13,55663,42029,62,26768,455
34,9,25,1,14,606744,3870,25,0,570
8,4,4,3,7,26497,26497,47,22336,478
11,9,2,0,3,106566,0,0,0,630
21,6,15,1,11,303861,279885,16,279885,580
16,5,11,3,6,32839,946,7,503,534
15,5,10,7,9,36479,49516,64,21597,440
26,12,14,11,8,96506,63586,435,9069,429
14,7,7,2,16,105408,26094,52,17924,468
26,17,9,12,27,2013786,939798,167,34994,510
7,2,5,0,8,9148,0,0,149,758
12,9,3,8,13,74994,53468,232,13654,446
6,4,2,2,13,275228,11643,2,950,521
19,11,8,7,8,129680,34897,31,11632,468
26,17,9,11,19,152080,283954,164,160802,428
7,4,3,4,10,21446,21446,0,0,451
8,4,4,5,26,629788,49451,72,597,505
34,8,26,0,13,197416,0,7,89,606
8,4,4,0,4,35065,0,0,0,613
9,7,2,7,6,22775,27713,406,8214,502
3,1,2,0,2,883,0,0,0,609
6,2,4,0,2,2398,0,0,0,705
13,3,10,2,3,7323,7323,11,4315,511
31,8,23,4,14,46142,19207,50,6535,481
12,6,6,2,6,67910,1680,3,1386,538
11,6,5,1,22,303522,32932,3,32932,550
47,7,40,2,16,198982,16305,123,10745,497
20,13,7,13,5,146005,167871,238,59282,444
16,2,14,3,14,9390,21577,10,8107,512
12,6,6,4,6,13142,9247,44,1402,415
25,16,9,14,7,41328,12793,98,2383,491
20,12,8,0,7,538020,0,0,0,581
9,3,6,2,16,127240,10488,37,7784,554
45,14,31,7,10,70591,52008,255,15349,417
21,7,14,4,12,93685,17522,77,5785,504
21,11,10,5,19,1848061,242095,125,4661,453
18,8,10,9,8,1047979,572811,176,11017,440
43,10,33,6,14,77565,14525,478,10694,447
13,5,8,1,17,39634,3,5,1122,668
6,2,4,2,10,0,10872,21,204,651
11,7,4,6,13,297191,21347,94,8573,401
8,6,2,2,13,34654,944,7,928,485
8,5,3,4,18,43964,43964,97,13424,481
4,2,2,0,9,0,0,0,1527,702
16,6,10,8,13,148113,171655,0,0,466
10,5,5,6,10,636235,206666,125,73212,464
30,7,23,5,7,64301,31276,153,16892,582
16,4,12,4,11,42049,3395,63,1287,474
5,3,2,2,10,61371,60892,50,13614,601
40,10,30,1,15,164907,962,12,1976,522
12,7,5,7,11,51374,27698,273,9980,459
38,12,26,0,11,608131,0,6,1204,639
20,7,13,7,14,47025,46908,110,17188,469
4,1,3,0,9,7313,0,29,426,625
15,5,10,2,12,295362,35759,0,0,671
15,7,8,0,14,126718,0,5,0,514
21,10,11,7,8,312577,237377,197,83630,459
22,7,15,5,8,21598,6712,39,2002,450
20,6,14,1,14,20541,2447,45,34210,567
12,5,7,2,12,377749,305043,66,4400,466
19,10,9,3,10,144324,130239,55,99258,468
19,12,7,10,12,51605,51605,121,15252,567
12,5,7,0,19,202163,0,2,649,659
14,10,4,8,7,168875,148859,160,1020,439
12,8,4,6,7,30035,20923,112,7066,461
48,10,38,6,11,119757,80229,69,21301,419
27,6,21,7,12,164783,169987,70,102795,427
8,5,3,5,5,38843,40983,262,6270,504
20,8,12,6,5,191867,175143,119,8510,433
10,5,5,3,3,11420,11420,46,0,457
5,1,4,2,7,61571,41670,37,0,479
19,1,18,2,14,6788,9444,20,0,516
9,4,5,0,17,1079,0,0,0,686
11,9,2,5,3,614625,40004,11,4980,457
6,4,2,0,5,388401,0,0,0,580
10,8,2,0,7,765871,0,1,0,596
9,4,5,2,10,103176,28623,29,8393,469
28,12,16,1,25,749431,535,21,0,611
12,4,8,5,8,8676,8676,44,1484,398
21,10,11,0,15,484649,0,20,0,555
36,7,29,7,16,78600,24680,60,6238,439
13,8,5,4,14,321275,42109,75,28324,403
17,6,11,2,12,140937,140936,107,140674,446
24,4,20,3,12,50816,2696,129,4737,510
10,3,7,0,3,65897,0,1,2378,591
67,7,60,1,17,203760,13788,11,28512,598
9,6,3,4,14,300191,77353,72,8040,484
14,6,8,5,20,258500,48086,89,8803,521
16,6,10,6,69,714385,279175,122,0,457
15,9,6,0,4,84146,0,0,0,593
8,4,4,2,8,10701,20263,85,1042,524
13,7,6,1,17,279108,23783,88,94056,453
24,12,12,2,16,5594025,83701,78,7403,501
11,5,6,5,26,294812,35866,32,14728,453
4,1,3,3,5,176585,160968,0,0,511
29,3,26,1,7,28369,5258,43,1809,581
16,5,11,6,9,53541,53883,179,47963,457
5,2,3,3,6,6961,6961,37,3399,596
42,8,34,9,18,29292,33435,135,7419,474
22,1,21,1,18,40711,4398,2,4398,557
6,3,3,1,5,72,68,121,8489,491
51,10,41,1,17,535394,125,8,402,460
6,3,3,5,11,19871,19333,46,9448,483
7,2,5,3,7,22533,33138,46,0,507
13,6,7,5,7,29165,17908,117,3478,464
6,4,2,2,19,276027,53318,25,0,531
12,2,10,2,5,7685,11640,18,0,494
6,4,2,2,8,421679,23198,16,14894,576
19,8,11,7,16,158133,64644,28,29974,466
46,8,38,2,4,30189,14264,17,3600,462
14,6,8,1,6,150018,1643,11,1039,582
35,8,27,6,16,48856,38595,135,2350,507
19,11,8,1,14,117863,1061,115,2122,528
12,6,6,0,6,501709,0,0,0,567
9,4,5,2,7,82514,47158,56,21934,427
21,7,14,0,12,299171,0,4,80,668
25,9,16,9,19,107248,146400,0,0,465
8,4,4,4,13,46755,72770,8,233,481
3,1,2,2,9,0,26507,13,0,639
24,2,22,2,5,22005,9022,16,4995,534
13,3,10,2,15,2226,2226,59,7685,494
12,5,7,3,8,41006,20208,56,5617,422
50,11,39,1,12,146527,1618,76,5000,471
5,3,2,3,10,542329,32524,61,3664,528
12,4,8,1,24,178775,495,16,21377,455
97,9,88,2,11,77569,5152,90,4656,449
9,4,5,4,12,43044,41554,59,12608,501
6,2,4,0,6,24100,0,9,0,586
5,2,3,2,11,30249,30249,34,0,492
28,8,20,8,18,168261,234037,380,67492,533
20,9,11,0,13,480776,0,1,1040,655
12,9,3,6,11,425805,48638,62,33872,462
5,2,3,2,3,38705,38705,37,4536,498
5,3,2,0,8,678293,0,0,1223,614
11,6,5,4,11,545546,65439,13,2022,439
5,3,2,1,9,21508,662,7,662,482
12,2,10,0,10,499,0,18,5336,612
13,5,8,3,48,29481,6897,30,3656,511
7,3,4,0,9,23310,0,18,406,603
7,3,4,3,6,377969,33876,23,4404,476
18,6,12,6,9,33539,33935,107,24655,421
11,4,7,1,18,74393,27631,8,27631,548
25,11,14,0,25,2687386,0,3,0,646
10,4,6,1,20,263805,1958,10,2824,583
20,12,8,3,8,68684,7507,14,4314,464
9,5,4,3,18,736735,19726,72,5806,484
16,5,11,2,13,17431,4506,17,4290,567
19,7,12,1,14,50710,5978,6,5978,640
9,6,3,7,11,9823,12636,77,5604,483
12,4,8,2,17,577502,81821,9,80847,477
13,10,3,0,10,162413,0,5,0,667
10,5,5,3,21,187718,13959,218,1670,490
23,8,15,4,13,148396,6862,51,3000,493
24,7,17,0,14,473885,0,0,0,592
44,10,34,7,7,75119,35996,260,13957,413
14,7,7,4,11,267672,264186,0,0,519
34,8,26,0,40,53196,0,1,2775,468
11,5,6,4,13,10034,8202,41,3645,447
8,4,4,7,8,34882,63751,92,2788,521
26,18,8,0,14,835184,0,13,0,516
17,9,8,13,6,3631769,1755164,195,196624,440
3,1,2,2,7,31034,31034,16,0,615
31,9,22,6,13,60050,48161,82,36549,436
20,8,12,3,10,680824,11073,1,318,451
6,1,5,0,8,62271,0,25,0,606
2,0,2,0,3,0,0,2,980,543
9,6,3,1,10,102501,5017,4,30,492
6,3,3,2,8,382025,18679,0,0,534
9,4,5,1,16,174845,159923,26,0,592
10,3,7,4,7,45714,62375,80,1226,498
13,11,2,8,19,966920,289665,137,0,535
35,23,12,1,6,109350,21,17,1915,658
36,8,28,1,10,181431,3263,26,1125,481
5,3,2,2,6,13737,3350,19,1710,511
12,6,6,1,22,250576,3700,4,0,599
9,5,4,2,12,105410,74522,17,453,507
18,5,13,2,9,90468,28723,56,20347,533
41,8,33,6,11,143553,64091,113,22167,446
4,2,2,1,6,58834,58628,7,0,595
12,7,5,6,7,435302,52092,89,23972,389
33,5,28,3,15,29935,28759,70,14475,502
49,30,19,5,30,867719,37022,150,17755,405
62,17,45,10,13,918351,313432,237,140343,425
41,18,23,11,25,691319,440121,249,7902,474
12,7,5,8,12,20923,18241,52,4456,472
12,4,8,0,13,16646,0,0,9992,553
11,6,5,7,8,19963,30349,43,8471,445
6,4,2,3,11,21825,17352,47,14783,521
20,4,16,4,11,16637,16637,44,11761,488
44,6,38,5,7,9002,1284,249,662,487
25,12,13,15,15,108823,95368,312,13688,397
9,6,3,2,11,21047,303,3,219,503
41,10,31,3,10,193330,19066,99,14525,514
10,4,6,6,7,22853,46834,14,11595,597
8,3,5,1,7,7731,6018,40,4380,501
9,4,5,2,16,58925,57762,37,56713,523
12,4,8,4,10,311948,28073,56,15585,474
6,2,4,2,5,21658,658,5,5169,424
10,6,4,6,8,82506,82506,256,54770,486
20,9,11,1,8,620687,300,86,3301,485
10,5,5,4,14,32895,22145,100,13224,456
17,8,9,8,15,46536,37172,97,7925,447
13,10,3,3,12,82822,34323,2,4422,466
19,4,15,4,8,23879,21852,34,0,485
6,3,3,3,15,26767,15593,31,2527,486
9,3,6,2,6,6430,827,2,0,623
13,9,4,7,12,74017,66672,151,33039,448
20,7,13,5,12,301733,23908,35,7128,421
21,6,15,3,17,113815,21110,25,14037,491
30,11,19,4,14,244520,39684,77,15904,493
24,6,18,3,8,209855,114533,79,1243,485
14,2,12,0,10,0,0,8,0,708
5,3,2,4,5,52287,43191,96,18575,485
6,3,3,3,4,16861,7992,0,0,388
17,7,10,1,12,105715,2724,9,2724,495
70,15,55,0,17,1685257,0,58,5500,634
8,2,6,1,11,0,6748,26,804,566
23,13,10,10,9,420169,25677,40,2430,418
10,6,4,7,16,218552,45528,331,24882,483
9,3,6,4,5,27324,28329,41,8756,425
18,8,10,8,14,83363,54578,187,8894,414
14,6,8,5,11,107934,40723,47,609,474
8,2,6,3,8,710,61209,15,0,536
3,1,2,2,8,8045,14095,51,8045,534
14,1,13,1,7,500,14355,31,0,633
12,9,3,0,8,21615,0,0,895,681
46,6,40,3,14,63749,35486,223,31309,502
12,9,3,2,4,96473,27370,10,0,531
9,5,4,8,8,7780,34495,277,3587,422
25,15,10,0,17,660002,0,13,852,574
20,4,16,5,9,29505,43984,74,14441,525
14,8,6,7,7,16039,26350,77,4616,467
5,2,3,3,11,9328,9328,41,4441,559
8,6,2,5,10,34613,42309,103,16552,558
27,8,19,5,8,279140,29877,2,2101,519
16,11,5,3,18,2676136,118351,23,9554,540
15,5,10,0,6,22329,0,1,1250,567
20,3,17,2,15,39269,33063,172,39908,467
9,5,4,0,14,108588,0,1,0,657
4,2,2,0,9,6583,0,17,0,617
3,0,3,0,4,0,0,14,93,584
14,6,8,2,14,61121,59073,36,54080,544
25,7,18,2,9,74539,3124,54,937,396
7,3,4,4,4,6751,5653,36,0,449
6,2,4,2,13,867641,13257,33,0,502
89,13,76,11,5,94667,63120,158,11318,429
9,5,4,4,7,264114,5341,0,0,476
10,6,4,2,16,293959,8974,45,5773,515
5,2,3,0,7,15331,0,72,1348,656
7,1,6,2,3,9847,9847,21,8780,503
40,8,32,0,18,251922,0,47,23300,449
19,8,11,0,16,103819,0,18,271,616
19,15,4,7,17,308891,42169,87,3421,453
16,8,8,0,12,735996,0,0,0,539
14,8,6,5,15,956540,77215,67,8097,446
38,10,28,4,9,13165,3592,115,8052,572
6,4,2,4,20,232202,108152,0,0,550
7,3,4,0,10,30891,0,0,0,631
57,5,52,5,9,249274,23444,13,6125,477
5,2,3,1,3,3597,3597,23,3597,398
14,9,5,8,7,118175,103615,91,19953,394
12,9,3,11,11,36728,26927,192,6412,404
9,3,6,2,9,10873,10873,192,10653,562
18,9,9,4,12,93102,35567,126,7495,469
9,3,6,3,8,214608,214608,66,0,506
9,7,2,4,2,52036,2112,36,937,533
41,5,36,2,5,45772,1057,27,8580,406
19,6,13,0,9,69480,0,7,0,536
24,9,15,5,7,180038,62956,47,6318,442
5,2,3,0,5,18513,0,57,420,665
23,11,12,12,14,386929,371151,152,1566,452
12,5,7,5,8,39241,35927,72,3577,432
30,7,23,3,7,141810,62602,51,46208,620
34,6,28,3,8,292704,3531,92,7178,406
13,11,2,0,20,124081,0,2,1666,607
21,9,12,5,9,56946,36366,61,22600,433
25,10,15,0,13,218670,0,10,0,548
7,5,2,0,10,9937,0,0,0,656
30,4,26,1,10,15731,3612,33,0,592
26,13,13,1,12,240495,370,22,1545,581
37,5,32,4,8,8883,9253,52,2799,515
12,8,4,0,6,86417,0,23,4691,509
11,6,5,5,15,174410,120820,32,11294,512
35,7,28,5,7,46445,27081,191,10982,449
9,4,5,5,10,9368,16463,80,21720,457
7,4,3,1,14,196491,1833,21,0,664
16,10,6,7,8,622766,74770,54,0,464
11,1,10,0,2,600,0,0,0,624
11,6,5,4,15,92669,92669,72,856,547
14,3,11,2,26,27991,23624,26,459,643
26,5,21,0,9,6160,0,1,4500,541
9,2,7,2,7,5198,5198,30,3686,527
10,6,4,6,8,179576,181457,91,10004,426
5,2,3,1,4,3808,885,11,1111,600
13,7,6,5,10,25316,10203,43,2949,455
12,6,6,0,12,43301,0,0,2744,598
9,3,6,3,8,20907,20907,310,17679,507
39,9,30,1,16,172148,1514,41,3993,488
7,2,5,0,5,0,0,2,295,726
28,19,9,3,18,947178,410360,73,205377,444
4,1,3,0,11,0,0,28,1861,545
17,8,9,0,24,67868,0,0,0,616
12,8,4,2,12,120815,16655,21,0,583
19,12,7,2,16,3103393,30843,42,2027,449
27,10,17,0,3,112103,0,13,3264,433
10,6,4,1,15,40295,40705,37,0,503
8,6,2,3,6,311557,7357,21,1854,438
16,9,7,8,13,487080,48136,72,17342,459
5,3,2,0,7,7189,0,1,2,667
43,13,30,12,20,483106,733204,214,48338,433
16,1,15,0,7,0,0,0,0,678
18,10,8,0,16,837982,0,32,0,467
27,16,11,6,7,600338,36189,124,13000,374
10,6,4,2,20,185101,12268,0,0,638
3,1,2,1,16,17676,68234,14,0,575
7,4,3,0,8,29972,0,0,0,692
11,9,2,3,12,6601,1216,28,11072,598
96,14,82,0,27,256363,0,1,316,596
6,4,2,2,15,37391,25325,36,1647,526
29,13,16,0,6,99980,0,0,3509,589
20,5,15,4,6,49661,34030,28,7697,466
15,9,6,8,9,59320,52026,65,4811,336
12,1,11,3,12,54634,54634,100,11483,500
17,6,11,2,6,26752,23200,261,14900,472
13,5,8,2,12,774014,59462,13,3023,494
9,6,3,5,7,18886,18417,414,7976,484
11,6,5,2,7,394093,3179,83,0,524
72,4,68,2,19,17173,11023,50,2032,544
11,7,4,0,23,864164,0,16,0,568
33,31,2,1,12,72306,35619,6,35619,589
12,3,9,1,7,137492,3329,0,0,535
6,2,4,1,9,583786,451,21,451,510
12,8,4,5,19,145995,152293,242,98907,465
13,7,6,4,8,25343,4761,2,1235,439
7,5,2,2,8,90074,72027,65,503,496
14,10,4,3,11,15919,16021,67,5347,470
11,6,5,5,9,220734,220676,75,1518,508
31,13,18,5,9,568630,23550,67,2156,469
40,4,36,3,13,23523,8638,33,6177,477
18,3,15,3,17,86001,86001,46,4386,457
5,1,4,2,9,43155,43015,51,0,636
6,2,4,2,9,127072,131607,0,0,466
49,5,44,5,69,59455,59455,142,11554,515
8,3,5,4,9,81026,132469,0,0,515
10,7,3,0,5,612416,0,1,0,581
16,4,12,4,19,44293,82347,22,47094,542
26,11,15,7,29,108267,200691,70,7853,469
21,7,14,3,12,263436,33616,145,19517,472
20,12,8,8,10,379396,60574,86,9320,411
18,6,12,5,17,173921,27500,81,5424,494
16,9,7,4,15,432885,67945,70,1958,431
9,7,2,6,8,67760,55495,89,10360,417
20,10,10,5,17,21823,7589,42,596,471
16,4,12,2,15,226914,4778,33,4342,484
13,6,7,0,14,234317,0,17,0,536
38,13,25,3,10,396160,20462,60,14678,482
212,6,206,2,8,15405,3034,82,11137,578
20,18,2,10,11,495111,81015,45,7659,449
26,7,19,2,6,23326,7648,192,6744,509
14,8,6,1,17,89964,762,38,437,466
14,12,2,13,14,113616,118446,157,9510,380
6,3,3,3,15,26573,40670,134,12097,525
30,13,17,1,10,905436,837,27,419,489
26,7,19,3,11,774420,172682,77,0,620
19,2,17,2,12,415606,370,49,1734,616
9,6,3,6,6,27161,19507,107,7505,455
10,6,4,4,69,196465,73132,75,33400,508
13,4,9,3,11,217735,13386,61,10778,448
12,10,2,2,25,2834,2833,19,2333,452
38,12,26,9,11,97712,91251,114,30107,437
14,11,3,9,5,470827,20624,98,2659,416
9,3,6,2,18,49350,57734,39,0,547
6,3,3,0,14,4300,0,20,2743,610
8,4,4,4,19,449103,534399,75,0,519
25,10,15,7,11,246399,229382,197,44466,459
17,4,13,4,18,377816,200121,0,0,492
7,4,3,6,10,533488,43529,67,0,479
21,7,14,0,17,595370,0,4,0,611
27,16,11,0,11,631764,0,21,660,480
19,9,10,4,15,263445,21145,57,9199,424
12,7,5,0,4,152411,0,2,0,517
10,4,6,3,16,17396,16736,54,2333,525
9,3,6,0,14,110856,0,8,0,721
21,11,10,0,17,1634801,0,3,1565,669
18,7,11,0,12,1827989,0,4,0,658
4,1,3,0,14,0,0,1,199,682
14,4,10,0,14,225963,0,36,1942,630
26,7,19,0,12,54384,0,13,4166,586
24,7,17,1,16,265582,12149,27,12,601
11,6,5,3,13,365042,31048,34,42629,587
8,6,2,4,12,38373,16114,48,3723,461
7,5,2,4,3,382354,32801,20,0,488
15,9,6,7,7,342710,15978,350,2899,513
13,6,7,8,8,20691,20488,126,13351,511
29,11,18,7,9,93349,22905,110,5663,408
15,8,7,7,15,55795,47971,93,21235,462
21,10,11,12,16,3007917,1959674,265,319681,452
34,3,31,1,7,7647,3410,165,11515,621
5,2,3,2,6,71643,20859,48,18499,625
16,7,9,1,8,99348,289,26,7510,572
11,5,6,3,20,567095,567095,91,775,509
22,11,11,5,5,84807,26206,66,8130,413
6,3,3,3,5,19406,1317,11,490,497
19,9,10,7,16,317681,289736,0,0,447
12,2,10,3,11,16718,56439,16,10241,552
9,4,5,3,12,206744,75365,35,64608,425
18,8,10,8,9,236365,262139,212,0,480
28,8,20,1,9,294848,5726,20,13788,539
7,4,3,0,12,468601,0,6,0,470
16,3,13,3,11,12814,12814,13,3013,455
6,4,2,0,7,51590,0,0,0,602
29,11,18,2,6,50113,27408,51,1414,517
14,4,10,1,20,742945,337,1,6009,479
12,6,6,4,8,453299,157949,23,1548,510
12,7,5,7,13,315412,303139,137,0,442
36,4,32,3,8,7824,7105,88,4002,502
26,11,15,2,12,388143,354,88,600,504
11,7,4,2,12,62309,8952,18,72,470
16,5,11,6,14,21406,13590,60,3200,440
9,2,7,0,9,205969,0,13,0,629
13,11,2,1,16,172891,562,6,299,534
6,4,2,3,5,106396,179496,47,0,574
10,6,4,0,12,149046,0,0,0,675
10,8,2,4,6,26935,13173,50,6427,424
22,7,15,4,7,45957,28069,37,16520,497
10,6,4,0,13,97835,0,9,0,533
18,9,9,0,13,193598,0,2,246,596
46,12,34,9,15,268285,92171,79,30020,427
4,1,3,0,6,132901,0,0,0,666
18,11,7,5,20,343406,319742,106,1828,453
37,11,26,8,13,121346,67050,113,13430,388
37,8,29,9,9,49133,40884,176,14803,428
12,1,11,0,13,8004,0,156,1608,628
22,6,16,3,13,23539,5734,23,2415,472
18,5,13,2,5,14329,892,388,2546,540
237,4,233,2,8,39701,2395,18,3429,476
92,6,86,6,16,300419,299350,65,210571,504
19,4,15,4,9,22370,23792,114,3869,500
17,8,9,5,13,340669,26700,75,26599,405
13,5,8,3,6,20533,15934,96,1111,445
30,9,21,2,12,426119,5833,262,16005,418
7,4,3,0,4,3920,0,4,449,667
7,4,3,1,5,33815,170,8,0,512
10,8,2,7,8,55006,46294,15,2211,430
12,6,6,6,9,205506,236303,147,73936,459
35,11,24,7,13,90923,22338,104,21773,417
19,9,10,0,27,948454,0,0,0,527
48,14,34,14,18,803819,221509,220,55792,403
12,8,4,3,8,95456,16342,0,0,489
169,13,156,13,8,69735,65976,256,16178,406
6,4,2,2,18,326366,26053,23,3462,507
53,13,40,3,14,602705,792,71,1286,542
13,4,9,3,12,316654,9647,38,5640,459
4,2,2,2,8,19921,19921,36,0,447
37,12,25,7,15,275867,232428,350,12734,497
6,4,2,0,18,60078,0,0,0,686
33,10,23,5,15,144373,64781,69,2251374,460
23,6,17,5,7,30756,25855,209,11489,451
13,4,9,3,8,7439,6570,29,3309,478
15,6,9,2,23,17114,17114,331,16850,438
10,6,4,4,7,316935,29497,69,13984,574
18,8,10,7,14,42673,42673,137,8664,459
14,2,12,2,14,1368,3586,10,4065,504
7,5,2,5,8,256499,23419,95,2875,500
4,2,2,0,8,3436,0,0,175,589
9,5,4,1,7,193117,433,42,433,491
20,7,13,9,25,403161,96453,108,5000,434
15,5,10,1,20,212264,51460,0,0,528
10,8,2,5,5,105853,55761,21,14531,489
59,15,44,0,21,530794,0,11,0,611
75,15,60,9,18,222612,66033,75,350600,463
22,10,12,8,14,379787,216186,147,312184,445
16,8,8,1,9,71280,4169,0,364,451
16,3,13,2,6,70856,62324,9,0,546
10,6,4,0,12,229854,0,6,311,627
24,12,12,6,16,146593,27423,87,10650,476
4,2,2,2,3,7304,6780,12,4232,534
9,5,4,2,16,582606,13957,120,7516,471
23,6,17,1,15,264143,1103,56,7866,444
19,4,15,2,11,33059,4729,25,9850,442
23,9,14,0,15,592777,0,7,0,683
24,6,18,1,3,127650,105,134,1437,629
6,1,5,2,13,5721,11443,20,7032,520
22,11,11,0,11,181452,0,0,0,576
19,9,10,6,13,124925,41765,28,3510,459
20,1,19,3,15,16138,20101,50,8796,455
4,1,3,0,18,0,0,0,1054,676
51,5,46,2,21,112684,109074,46,98148,624
12,3,9,4,19,227444,154571,0,0,490
10,6,4,3,14,147128,21283,28,13575,389
36,13,23,2,21,1759906,97866,20,1656,442
22,12,10,9,16,656467,38855,104,10596,370
11,3,8,4,10,425117,161215,45,1363,421
11,3,8,1,1,13353,3789,1,3789,520
18,9,9,3,23,69323,37475,257,1246,507
32,20,12,0,27,734027,0,5,12443,481
112,24,88,2,33,203942,55218,24,32838,647
5,3,2,1,3,38582,2657,19,0,557
15,8,7,0,15,112520,0,39,390,587
16,4,12,4,13,5370,5370,39,2745,483
11,3,8,5,10,19559,26827,70,8700,457
12,5,7,5,7,37574,37469,271,3326,450
8,2,6,1,8,24244,24244,4,1012,600
14,8,6,9,4,143433,136504,122,54664,422
16,11,5,0,34,220805,0,21,1622,615
36,6,30,5,10,60810,21539,74,5026,449
7,3,4,4,14,618910,717650,42,547236,491
32,9,23,5,18,381344,59324,296,29536,501
11,5,6,2,14,546172,37385,27,0,494
8,5,3,6,7,29149,31633,103,0,644
44,7,37,7,10,257567,77434,14,7795,439
34,20,14,15,12,310039,79394,274,31159,423
4,1,3,3,15,19334,23958,96,22491,489
21,4,17,3,15,109352,9594,38,1971,423
34,4,30,4,12,38499,27514,95,10570,453
26,4,22,4,11,21439,19620,33,9455,462
25,14,11,10,10,759260,700854,178,56168,382
32,6,26,2,20,438163,7987,51,1351,498
7,3,4,4,7,23033,22143,66,6335,551
18,9,9,0,20,2212100,0,3,0,545
9,5,4,3,15,202369,41642,47,81,586
65,13,52,9,8,123219,91508,172,42726,414
9,7,2,6,5,23597,12597,53,2223,422
21,8,13,1,13,347556,1555,49,4600,425
15,6,9,9,21,755586,236212,211,43444,440
8,4,4,3,16,371092,9827,23,1680,429
10,8,2,5,8,92803,39284,45,18035,465
10,2,8,1,9,9378,9378,34,9378,528
12,5,7,4,30,136889,35957,60,27128,428
11,5,6,2,9,63214,35625,14,0,625
22,7,15,5,8,529789,979463,59,3000,498
8,5,3,8,11,108560,149593,158,18010,518
7,4,3,1,3,20220,879,6,464,538
15,5,10,8,8,43630,58650,196,16538,441
12,3,9,2,19,2828,74685,1,1987,541
15,4,11,0,7,7348,0,86,1283,585
12,3,9,3,17,43953,36205,184,20444,496
13,9,4,5,7,85509,73290,313,2919,466
14,8,6,5,19,62166,62166,38,43635,518
4,1,3,1,9,3059,2696,2,2696,588
6,3,3,3,8,19716,14156,14,3368,473
44,11,33,9,12,81247,45809,182,12147,433
22,12,10,8,11,412879,38861,415,27014,443
18,5,13,3,17,20710,45676,61,19710,527
32,15,17,0,15,1481130,0,2,1214,568
8,5,3,1,18,811679,182761,0,1166,457
9,3,6,3,8,8316,8316,90,6823,444
15,10,5,2,14,1062710,9474,4,0,603
28,7,21,5,6,55450,41572,75,15565,396
20,9,11,7,23,465743,66504,67,18245,443
20,12,8,12,18,817026,104303,205,14524,415
57,7,50,3,8,32577,14009,65,4952,454
9,0,9,3,8,4532,12187,66,0,616
22,6,16,1,6,43164,2652,376,7390,497
53,13,40,4,8,239112,2046,181,1008,401
38,8,30,2,15,34356,1315,36,5156,563
9,3,6,0,7,276121,0,8,518,621
26,11,15,1,69,107798,276,11,194,480
22,10,12,6,9,81884,72964,99,19539,453
14,6,8,3,69,426422,46453,45,22710,492
10,5,5,5,14,39317,47500,59,17012,570
8,4,4,0,9,94234,0,0,0,573
99,31,68,4,9,336963,13130,192,9580,476
7,5,2,5,10,86072,58248,107,3311,495
34,19,15,1,15,192346,278,4,923,507
13,10,3,10,13,768632,278444,209,12715,446
37,9,28,6,25,234052,174854,217,28200,440
19,6,13,5,13,265629,17566,58,7583,431
10,4,6,2,12,7866,7866,38,0,554
4,2,2,3,6,19886,44341,46,0,486
7,0,7,0,10,0,0,1,715,541
13,1,12,1,7,3247,3247,48,3317,478
9,6,3,6,9,34917,26936,169,12042,458
7,2,5,1,8,5459,3459,24,3459,528
6,3,3,2,9,13294,13294,95,5588,553
11,6,5,2,14,7354,3772,33,3250,443
7,5,2,2,7,861264,183213,133,4623,586
13,8,5,8,10,2043849,304643,184,49389,454
12,4,8,0,11,4389,0,0,0,693
7,5,2,1,6,68157,53501,4,53501,523
32,11,21,3,13,57705,5069,16,768,474
15,11,4,4,6,418485,11716,177,8840,449
5,0,5,1,6,0,16930,0,0,598
6,2,4,1,11,871,871,5,871,545
11,7,4,6,11,539313,61089,104,44597,456
18,12,6,16,10,225271,380986,168,125484,413
10,2,8,0,10,4633,0,0,2518,678
23,7,16,2,16,92045,7800,104,5306,511
17,10,7,0,11,453526,0,6,0,491
29,7,22,0,10,41318,0,26,9413,512
11,9,2,8,14,43128,43128,122,10556,371
18,9,9,8,14,650615,172842,174,21672,447
12,8,4,8,7,379712,50433,21,10894,421
36,10,26,0,15,559330,0,17,4776,571
13,2,11,0,8,13610,0,0,0,629
8,4,4,0,4,105928,0,0,0,511
30,6,24,3,10,66313,3038,147,3633,536
13,5,8,4,25,590809,126578,147,36210,694
30,9,21,8,8,166738,149142,597,13719,443
6,2,4,3,8,38322,55362,0,0,489
6,4,2,1,17,395126,870,10,0,587
6,4,2,2,8,508567,12638,50,0,537
7,4,3,4,13,322005,42473,47,7732,432
34,14,20,5,13,484108,91145,11,6793,480
3,1,2,0,7,0,0,90,1815,628
55,13,42,2,12,248992,494,39,634,595
20,9,11,0,20,298817,0,0,0,682
8,6,2,3,15,89901,20112,26,0,474
19,9,10,8,12,131657,79780,112,29143,438
4,2,2,0,3,1305,0,0,596,661
6,4,2,2,5,14702,3212,29,3289,518
4,2,2,1,2,8241,2016,21,0,539
48,16,32,8,13,81395,31812,391,11179,421
7,4,3,3,27,41711,15999,75,916,618
25,9,16,6,18,45175,17466,40,4311,511
7,3,4,0,11,99879,0,0,2275,578
21,3,18,1,8,918,917,0,0,585
6,4,2,3,10,19238,18534,54,3695,547
24,2,22,2,13,23737,23737,77,2755,606
6,1,5,1,8,415,415,38,1468,510
7,2,5,4,5,5992,10126,52,2680,516
34,8,26,3,13,73908,16428,17,3892,409
7,4,3,2,7,78787,40938,48,0,505
18,4,14,1,17,36365,11208,37,2970,576
26,18,8,1,7,279112,870,43,870,626
10,4,6,0,6,110096,0,1,0,629
43,14,29,10,9,173572,52606,290,24942,404
30,0,30,1,12,9110,9110,42,9110,594
4,0,4,0,2,0,0,0,0,606
50,20,30,0,19,152910,0,0,9730,632
8,4,4,4,7,20153,20290,115,10787,414
23,5,18,0,5,394778,0,4,0,546
9,6,3,4,16,65512,64403,63,48923,515
8,4,4,2,15,243612,1139,5,1083,431
10,5,5,1,6,7405,539,3,539,533
11,9,2,2,12,131578,6249,50,4632,474
5,3,2,3,13,29746,16875,33,1758,568
56,11,45,11,8,543421,524828,162,61222,488
38,8,30,6,10,231269,242751,78,93881,444
85,4,81,2,13,213710,10523,19,3367,545
5,2,3,0,5,539,0,0,0,672
23,4,19,2,9,36557,18493,51,15418,593
18,7,11,1,15,272034,26150,13,320,528
14,7,7,3,69,275185,15225,78,13225,411
21,11,10,5,22,194773,30343,55,67483,398
17,5,12,4,8,63812,28428,10,3981,481
23,1,22,1,9,7261,7261,1,4076,459
25,11,14,0,14,46146,0,10,3669,486
18,8,10,7,7,53881,48238,25,6707,452
23,8,15,4,11,289158,9756,68,7736,484
24,7,17,3,9,66391,23334,0,0,451
9,3,6,3,16,19043,19043,46,10911,568
12,5,7,5,16,595793,595793,57,304292,478
10,8,2,2,7,104716,9854,0,0,428
21,9,12,1,8,406754,14558,6,14558,527
10,5,5,5,13,75258,106824,123,42982,477
8,4,4,3,5,37609,6924,337,1924,483
5,2,3,1,9,5544,5544,23,5544,574
7,2,5,2,14,17487,22924,32,0,526
24,10,14,5,11,310764,104890,91,72977,439
35,10,25,3,8,70970,9017,22,6178,451
52,9,43,9,7,59395,86356,179,5344,535
8,2,6,1,6,4079,1670,25,3620,561
24,13,11,0,6,1110989,0,0,0,655
11,5,6,0,7,1871867,0,8,0,597
18,9,9,5,14,87236,41710,49,4809,474
11,3,8,2,19,512696,2384,32,5989,477
9,3,6,4,15,201550,193805,102,0,523
14,7,7,6,11,72300,31025,112,1930,423
18,14,4,14,25,519254,119935,288,13746,439
9,5,4,2,5,203510,3974,5,0,503
10,3,7,3,8,8578,8578,61,6419,417
10,8,2,0,8,311721,0,2,837,581
12,7,5,4,17,401886,23306,43,20681,471
3,1,2,0,11,4870,0,1,104,566
38,21,17,10,16,5548783,148594,78,2975,481
6,4,2,0,11,26598,0,5,0,672
4,1,3,1,4,17271,16596,9,0,505
16,9,7,0,8,1120054,0,0,0,583
40,7,33,2,9,614387,1696,124,3148,455
18,9,9,3,8,57626,7574,3,1098,465
13,9,4,6,20,62348,12797,54,4613,498
9,6,3,4,7,14518,9963,223,4304,459
40,7,33,5,9,36580,32430,134,16000,436
13,6,7,0,9,1489717,0,10,0,666
181,8,173,4,18,318743,49068,61,15836,582
35,10,25,11,11,80777,80776,224,17201,440
13,8,5,0,6,234775,0,0,0,580
37,8,29,5,7,26277,8975,162,8994,474
12,5,7,8,12,63620,103741,13,3761,517
30,8,22,4,9,199730,55874,156,25627,475
5,3,2,0,6,74715,0,3,390,647
21,12,9,3,27,179114,126437,46,123640,439
10,4,6,2,15,337294,3544,6,2715,451
14,3,11,0,4,168912,0,0,0,629
21,8,13,5,14,1250073,187640,155,7848,459
9,3,6,0,13,88879,0,0,0,612
15,3,12,3,19,42644,42644,0,0,469
5,3,2,3,8,12434,12434,190,13052,477
21,12,9,5,11,111983,38650,141,14009,492
17,4,13,0,4,83249,0,5,270,621
16,6,10,0,6,251628,0,2,805,581
10,2,8,2,6,5937,5937,29,3397,432
10,8,2,0,14,130672,0,8,28968,678
31,12,19,0,34,707457,0,104,6721,550
13,6,7,3,11,17194,14998,7,13397,546
11,5,6,5,10,35970,36621,97,14009,500
8,4,4,0,8,65523,0,0,0,488
5,3,2,4,6,37962,34964,60,15136,443
14,10,4,6,19,435465,32376,33,10279,405
6,2,4,3,8,40316,60480,71,6593,451
14,8,6,1,69,143896,59226,47,0,587
28,6,22,5,11,31352,31352,128,4440,613
8,1,7,0,7,0,0,4,0,718
5,3,2,2,4,133953,35220,11,0,569
23,11,12,9,12,689316,242799,71,12099,464
8,4,4,5,5,26512,40274,103,5194,540
18,8,10,5,13,360501,43600,51,17983,568
21,4,17,2,6,55734,15239,0,0,579
14,6,8,6,12,46259,77424,154,2650,573
30,5,25,3,10,30935,12073,54,9094,548
13,8,5,7,11,105974,105974,139,19910,496
5,3,2,3,8,20796,28250,0,0,455
57,11,46,2,8,95509,1777,43,7842,592
12,5,7,0,9,379760,0,0,0,641
18,3,15,3,7,21096,23413,89,451,544
26,8,18,3,13,463506,68622,208,56404,431
12,4,8,1,8,56603,346,8,346,636
25,11,14,1,10,679692,3425,18,46,547
16,8,8,6,12,51975,32424,56,10538,465
10,3,7,3,18,8710,8710,29,1475,513
31,4,27,4,12,15288,14611,370,7379,474
45,7,38,3,21,344567,29670,50,17012,575
9,4,5,6,9,162448,269191,112,11184,484
17,9,8,1,17,181975,20494,26,239,510
32,24,8,0,10,767614,0,23,5498,546
6,3,3,3,5,23774,21188,49,2807,442
10,4,6,0,15,39070,0,15,882,681
26,11,15,12,6,172154,65714,223,6911,437
10,2,8,2,11,5925,5924,21,4350,456
10,5,5,7,18,446445,100454,117,36915,439
18,6,12,5,7,30278,20999,66,7651,504
15,6,9,5,7,433435,54157,59,5650,503
13,8,5,4,13,434147,429259,143,3730,469
34,10,24,0,14,14013,0,1,1357,656
3,1,2,2,8,4411,10586,0,0,510
27,11,16,11,9,109713,121708,82,28159,483
50,23,27,0,20,5554810,0,24,50,550
9,7,2,4,12,64366,48720,89,1982,418
14,8,6,10,14,328583,380479,160,0,488
23,7,16,5,8,40530,8052,47,4644,533
6,2,4,1,7,1454,775,1,0,645
13,5,8,4,12,52461,23243,101,0,448
15,9,6,2,10,445011,31118,27,21582,571
11,3,8,3,10,36359,36359,57,30002,453
19,12,7,0,12,102176,0,50,1947,471
6,3,3,5,7,104319,73047,37,17492,457
22,11,11,5,16,598199,78873,61,1500,534
8,6,2,3,4,232816,13899,5,0,506
3,1,2,1,3,13019,2383,27,2410,399
11,1,10,2,13,12440,14927,46,12440,629
8,4,4,1,13,19222,47,16,2721,531
10,6,4,4,13,25910,25909,61,1305,481
13,7,6,10,17,278626,350216,108,95435,457
2,0,2,1,12,44871,44871,6,0,606
16,4,12,2,11,697816,49012,9,0,669
28,16,12,0,10,685141,0,9,700,608
38,8,30,7,12,75269,64437,75,16084,418
26,12,14,8,10,25583,21729,136,43330,438
33,5,28,3,9,21060,3961,2,1038,465
8,3,5,3,8,44024,25470,26,18554,466
23,10,13,3,14,210857,647,74,301,560
17,8,9,0,10,254879,0,60,5132,465
7,4,3,1,11,29459,257,12,0,488
161,7,154,2,14,114144,9014,70,2876,452
7,2,5,1,7,4200,4200,23,4200,542
78,11,67,3,10,434046,51907,104,8410,449
10,2,8,1,14,51594,764,0,4330,687
6,4,2,0,4,129568,0,5,0,599
13,5,8,3,12,321477,2224,110,17480,421
3,1,2,2,17,35475,49608,31,35475,579
5,1,4,2,14,18496,18496,24,16856,500
17,9,8,2,8,135728,7732,19,6793,601
41,20,21,7,8,497282,40098,237,19497,440
18,8,10,0,14,176544,0,0,0,543
55,17,38,9,10,105991,17392,80,7850,487
11,7,4,6,18,1945664,78994,44,3508,450
6,4,2,0,8,625359,0,25,0,495
10,5,5,3,24,196379,72209,51,51295,469
20,5,15,3,13,15191,15191,39,9716,481
30,9,21,9,7,915928,323029,336,4057564,414
9,4,5,4,16,18665,24185,24,3596,488
6,3,3,4,5,15354,15354,227,7070,494
17,6,11,5,15,75650,75650,111,8719,467
28,18,10,18,12,245075,229512,234,16502,423
25,11,14,7,9,322663,26380,363,2580,508
54,8,46,6,11,235658,137280,93,15898,442
6,3,3,0,13,30208,0,15,0,575
17,5,12,0,10,96564,0,16,440,573
5,1,4,1,7,17261,753,11,0,655
20,6,14,1,7,101833,984,21,244,567
69,6,63,0,5,22679,0,0,0,625
15,8,7,1,6,251698,560,6,0,542
25,13,12,6,11,116959,37351,67,11391,393
12,7,5,7,8,23344,33237,175,6265,432
35,14,21,13,7,306366,104600,191,25952,417
10,6,4,1,20,91853,85,25,85,581
10,8,2,6,12,546018,49634,50,20561,397
9,6,3,0,10,5983,0,9,0,672
9,5,4,1,11,119719,118215,29,10809,520
4,2,2,1,11,143585,12647,0,0,617
6,2,4,0,6,30824,0,22,0,470
33,17,16,13,10,413887,106022,301,6724,465
15,11,4,14,8,501232,182217,234,9941,393
6,4,2,2,12,46275,37543,41,0,646
11,6,5,5,7,63132,64289,69,22774,494
23,10,13,8,11,44489,16505,71,5642,514
11,6,5,4,15,34979,33882,110,35573,465
20,4,16,4,9,17123,38579,245,4698,491
25,9,16,4,16,324785,63725,110,13781,481
7,4,3,4,10,100120,100677,90,0,540
12,2,10,1,8,6585,6585,100,6585,663
24,3,21,0,8,26254,0,2,0,616
5,3,2,0,6,115458,0,0,0,697
5,3,2,2,27,21356,23731,43,0,560
39,12,27,11,19,117866,59689,101,15372,412
8,3,5,2,6,14853,12037,21,6242,453
25,9,16,6,9,24860,2670,216,3062,501
12,7,5,1,5,32374,300,58,0,484
29,12,17,6,18,471150,93474,22,2932,486
12,8,4,5,22,253580,30441,108,2315,454
24,5,19,4,9,54176,48138,168,13175,490
36,8,28,2,16,295038,5229,6,600,495
18,8,10,6,9,123549,16663,0,0,494
5,3,2,0,6,211563,0,0,0,684
15,6,9,1,17,14191,14191,32,14191,504
20,9,11,1,12,244917,46650,79,46650,681
15,6,9,3,15,80930,43935,53,0,556
21,15,6,0,24,1488426,0,7,0,639
21,14,7,0,10,1302922,0,36,2200,669
10,7,3,8,14,108599,79733,131,23278,451
12,5,7,1,4,49839,594,21,5326,545
27,11,16,4,24,161407,20124,67,5525,508
37,8,29,5,12,23907,12163,54,5148,503
43,10,33,3,13,78656,11937,50,10920,455
16,6,10,1,1,40313,1403,1,1403,529
8,4,4,4,8,16957,17120,74,7390,439
14,5,9,0,12,286684,0,7,394,582
11,5,6,3,9,26441,29731,60,0,543
40,7,33,5,18,142191,137831,65,123759,483
8,1,7,1,7,6204,6204,36,10204,540
10,4,6,0,8,220803,0,37,0,521
10,5,5,0,9,460391,0,0,0,615
4,2,2,2,9,7813,7740,17,5582,647
13,2,11,1,7,17431,9579,13,3114,661
14,7,7,6,7,376885,18681,26,8172,469
12,5,7,3,13,570348,308487,34,132384,440
15,10,5,9,8,211674,201582,158,4560206,425
19,5,14,5,10,220137,181464,115,22729,445
5,3,2,2,10,639423,53235,2,9746,548
4,2,2,2,7,25391,527,8,486,551
16,2,14,1,18,47492,13364,9,1486,519
17,7,10,4,15,402050,134739,43,2296,427
37,17,20,9,12,1915269,167969,106,130155,414
4,2,2,2,6,12081,12399,197,8769,592
24,7,17,4,13,251911,10689,46,4105,474
10,6,4,3,10,272850,19558,62,0,525
10,7,3,1,6,53202,2122,10,17775,464
17,11,6,7,5,220479,62911,58,3984,440
7,4,3,1,11,99570,1163,44,1163,585
4,2,2,1,12,84163,1784,16,0,604
22,9,13,2,15,203850,9240,45,107,635
32,10,22,0,7,132666,0,2,1406,591
10,5,5,1,12,189941,67623,10,0,547
21,15,6,5,38,506278,207180,7,44324,489
3,1,2,1,8,1588,1588,15,3440,565
8,6,2,6,8,5082,5082,51,2793,438
16,10,6,5,7,62553,50951,116,21896,473
17,8,9,1,14,277698,3150,79,8988,522
3,1,2,0,10,0,0,1,0,687
10,4,6,1,14,279794,451,7,1750,494
14,10,4,6,15,642547,79458,59,4320,528
21,5,16,0,6,53286,0,0,0,652
12,8,4,2,12,388939,193143,53,0,446
5,2,3,0,8,753,0,4,753,647
11,8,3,2,10,1024106,6212,10,9522,408
9,4,5,1,16,195164,195164,16,195164,532
14,8,6,2,8,305802,29980,61,5984,498
134,12,122,5,14,255007,29783,92,6698,444
15,10,5,7,18,199452,198152,102,109779,428
25,9,16,1,5,140293,3171,5,1619,495
31,5,26,1,14,445758,6644,60,1481,501
8,3,5,0,14,21849,0,0,2286,644
7,2,5,1,16,8548,8548,33,3576,557
22,10,12,5,12,63032,19159,53,6595,450
18,6,12,7,8,30568,33145,305,13860,455
20,7,13,1,17,288528,4664,1,5230,488
4,0,4,0,7,0,0,64,0,632
15,7,8,7,6,19818,16467,65,5202,495
40,9,31,1,18,352036,4410,19,4860,546
17,9,8,7,17,328287,52539,141,443,433
14,3,11,0,12,310500,0,4,659,554
21,7,14,6,19,183720,97901,178,7105,452
12,5,7,0,12,398117,0,22,0,634
7,3,4,0,15,149,0,31,0,514
22,14,8,4,11,90535,6741,8,3225,529
13,10,3,0,7,230581,0,12,2058,543
39,9,30,1,19,716782,30865,31,30865,562
8,6,2,5,8,33102,28738,124,866,438
19,9,10,0,13,826084,0,0,0,641
16,11,5,0,12,1848810,0,1,174,724
19,3,16,4,7,6927,7304,57,2398,523
12,8,4,4,14,294421,294226,85,9988,471
21,8,13,7,11,20954,16199,106,11700,419
10,5,5,0,15,6926,0,0,486,683
13,7,6,3,8,409067,9569,166,5180,392
8,5,3,3,12,9860,11616,18,5863,549
22,11,11,11,49,989126,577549,86,0,501
13,5,8,5,10,43052,56827,64,19275,479
15,8,7,0,15,105048,0,3,0,443
16,3,13,5,4,142644,93103,33,0,472
13,7,6,7,8,39062,36679,58,9887,424
6,4,2,1,12,41032,41032,7,41032,566
13,10,3,7,11,112317,44065,65,8632,487
17,7,10,5,8,102802,34072,17,11266,412
8,2,6,3,8,11655,14215,71,5981,527
18,13,5,5,16,380151,110122,107,9333,504
9,4,5,1,6,9831,493,27,0,537
33,10,23,8,9,488336,22639,189,4829,403
8,5,3,4,9,246209,5829,19,3962,373
5,3,2,0,8,89340,0,6,0,506
3,1,2,2,6,77043,77043,41,0,602
15,7,8,8,6,165558,170976,93,14414,513
21,8,13,0,15,753700,0,1,0,678
11,2,9,3,6,4412,10448,103,721,569
8,4,4,1,20,32407,4125,21,4125,546
6,4,2,3,9,391360,30339,27,20885,497
12,6,6,7,10,511951,639262,121,182091,493
16,6,10,3,14,410870,247440,31,0,677
16,4,12,3,8,77587,94596,0,0,444
11,5,6,3,12,189464,15164,8,0,476
8,6,2,4,8,24236,20385,204,8908,518
20,7,13,5,9,135924,14051,324,1600,541
13,5,8,3,10,129305,123268,24,0,513
28,11,17,0,7,739438,0,2,803,613
27,6,21,0,9,124742,0,4,0,598
20,7,13,5,8,513231,566286,10,5839,462
25,8,17,2,8,489352,1938,6,0,511
22,10,12,4,14,74316,68612,0,0,447
19,3,16,3,18,37091,51334,79,21091,566
13,11,2,9,10,52499,59762,119,5026,398
9,1,8,0,7,747,0,0,0,607
25,7,18,7,4,79264,53784,121,8011,418
14,4,10,1,8,34163,2987,8,2987,500
19,6,13,2,18,524083,168779,50,104935,491
13,4,9,3,6,18205,5742,209,1243,581
7,4,3,6,9,79767,92702,12,18504,386
11,8,3,0,6,329417,0,9,1446,576
11,7,4,0,7,303246,0,0,0,622
28,7,21,2,13,63268,60086,67,0,453
12,7,5,7,14,20189,20189,127,6595,434
9,4,5,1,16,621075,1331,17,3031,496
23,8,15,7,8,55244,56599,93,12808,489
3,1,2,3,6,11478,11550,39,630,474
20,11,9,7,16,58453,27192,118,13043,453
19,7,12,0,8,179173,0,9,1,528
36,4,32,1,14,67686,1732,19,1734,613
16,4,12,2,7,74415,7964,22,1782,464
10,5,5,3,8,353526,6397,42,0,488
5,0,5,0,14,0,0,2,22339,537
5,3,2,3,4,23526,21726,0,0,578
32,3,29,2,7,5813,3711,48,2511,544
26,13,13,1,11,1046173,117,1,117,444
3,1,2,1,7,23335,23335,23,23335,573
8,3,5,3,5,2948,2650,205,4773,556
14,2,12,0,11,28054,0,15,421,613
18,4,14,0,9,32130,0,0,0,571
11,4,7,2,6,27626,7141,0,0,528
15,8,7,2,12,396931,256860,68,227178,587
5,2,3,0,12,0,0,0,0,714
11,5,6,3,9,23100,21901,46,12854,499
16,9,7,7,8,361629,42951,106,16157,470
15,8,7,0,11,138374,0,14,0,418
37,7,30,4,10,281680,17960,34,16176,416
22,10,12,1,8,458196,1506,51,9010,482
5,2,3,2,9,15579,7006,1,1004,455
7,1,6,1,10,562,562,20,1516,583
5,3,2,1,5,7695,6496,90,6496,494
8,5,3,2,23,599027,196959,25,0,503
25,9,16,6,7,39690,13610,150,4979,457
170,14,156,1,12,105847,1270,48,4570,562
58,17,41,2,12,254183,37694,103,23928,467
8,4,4,1,6,25040,4557,35,255,526
3,1,2,0,3,1138,0,0,0,583
9,3,6,4,10,25984,34729,103,17901,619
33,4,29,1,10,26960,8350,23,1189,454
24,7,17,2,11,52932,32926,79,26876,543
13,3,10,1,12,4827,3164,90,3164,482
10,6,4,0,6,19015,0,58,559,652
5,3,2,2,7,15653,2653,13,1825,449
4,2,2,2,6,4345,7412,31,4345,626
10,6,4,4,14,419564,68586,47,37123,480
49,13,36,5,25,728853,8698,28,22155,547
29,5,24,2,14,71283,13787,71,9263,496
19,10,9,0,22,43746,0,9,0,698
10,6,4,5,12,86725,44328,66,17156,465
17,5,12,8,14,74079,83581,69,23244,442
11,6,5,5,15,265923,141992,131,0,474
41,16,25,13,17,1460498,663526,198,2475,453
3,1,2,1,7,390,390,1,0,666
19,9,10,0,15,1756689,0,2,0,661
3,1,2,3,3,31267,39406,23,28956,446
8,6,2,1,15,11847,11463,22,48852,409
14,7,7,5,14,34779,32566,0,0,492
11,6,5,1,7,23399,12202,0,159,525
4,1,3,1,7,19778,19778,14,1150,632
20,13,7,0,16,619576,0,19,5273,477
4,1,3,1,9,18174,18174,23,18174,591
10,6,4,0,3,355061,0,1,0,587
10,4,6,0,14,0,0,0,0,764
7,5,2,3,6,18241,12830,192,5381,509
30,12,18,0,12,1119799,0,1,3605,537
12,9,3,10,26,112530,150017,28,26712,465
3,1,2,2,8,12103,49287,52,12103,464
11,4,7,0,16,140681,0,2,6775,638
14,10,4,4,13,398119,43899,8,3712,455
3,1,2,0,14,196,0,0,0,681
29,4,25,1,6,14810,942,14,40908,542
3,0,3,0,4,0,0,5,0,583
9,5,4,0,7,26148,0,15,0,604
9,6,3,3,19,108566,19785,37,24724,469
7,5,2,5,8,30642,30313,60,11135,438
25,16,9,2,12,389425,1106,32,432,631
11,7,4,7,5,50128,33198,155,14238,417
49,22,27,2,25,876637,9362,46,20547,571
14,6,8,7,28,677162,348867,2,2535,526
17,9,8,1,19,431664,9162,13,9162,557
16,5,11,4,11,104299,11337,79,8650,514
38,8,30,3,17,210171,32156,47,15694,404
22,4,18,3,11,35795,35795,56,28396,537
42,12,30,5,19,319205,37695,41,1419,469
9,6,3,0,17,426191,0,7,9204,570
19,6,13,5,9,25990,17122,134,743,504
40,6,34,3,12,178758,10655,42,7708,421
12,6,6,6,19,86923,137191,128,3112,414
4,2,2,0,11,1893,0,3,0,625
4,2,2,4,6,21292,25832,40,0,572
26,7,19,6,11,31321,21892,63,6756,502
25,7,18,0,12,416333,0,37,459,613
9,7,2,1,19,375534,17307,20,17307,562
40,5,35,2,7,19633,11331,40,5356,621
16,4,12,1,10,63320,1956,69,9737,539
35,9,26,3,8,138133,2461,450,1946,494
41,8,33,10,14,107565,83187,163,20101,437
11,4,7,0,12,9059,0,1,0,650
16,12,4,6,69,367830,12396,66,126,492
42,22,20,0,45,797297,0,10,1782,530
10,5,5,1,18,62128,13373,14,559,520
36,6,30,0,12,8598,0,8,0,660
8,5,3,2,8,72674,11506,23,14451,501
27,20,7,2,18,1610229,2201,3,21,475
13,9,4,8,13,94718,83146,119,14640,497
21,8,13,4,25,649025,184653,137,34503,510
13,9,4,0,14,645108,0,0,0,664
15,8,7,9,20,766396,181302,110,20565,509
13,3,10,2,18,12731,12731,110,15818,473
14,5,9,2,7,53323,24821,28,17180,483
31,13,18,11,7,430530,62384,180,14607,407
15,7,8,9,8,77279,97582,64,22472,404
16,9,7,6,10,577857,164924,93,80002,445
5,1,4,2,16,854,8204,169,7350,529
4,0,4,2,8,0,13067,0,0,507
3,1,2,0,9,0,0,0,1182,683
8,4,4,2,9,119269,24350,14,0,610
35,12,23,11,16,120476,137414,389,44150,427
2,0,2,0,5,0,0,0,0,587
4,2,2,2,5,1391,1391,137,1295,549
21,10,11,6,7,76034,37217,163,13993,457
8,3,5,3,14,407665,7417,26,602,491
39,12,27,2,15,344047,64514,344,34240,515
15,4,11,0,21,703540,0,3,10851,695
6,4,2,0,7,152327,0,0,0,576
33,12,21,6,10,765061,27618,58,3381,431
10,3,7,1,13,213213,2021,13,2021,495
18,6,12,6,20,113236,134195,106,94073,412
9,3,6,2,14,23043,7921,23,7781,483
19,10,9,1,13,332933,30,2,292,580
51,25,26,1,23,4298493,1047,23,2168,551
37,13,24,7,23,211924,43758,143,2763,466
16,10,6,3,21,194080,10145,26,9130,574
10,7,3,0,11,63374,0,0,0,583
18,9,9,0,21,490065,0,1,0,676
26,14,12,4,13,271390,3344,30,1345,482
10,5,5,1,13,93220,20008,52,5150,475
22,9,13,4,13,61318,23105,56,8675,466
24,8,16,5,19,4443356,3105448,102,35963,472
22,13,9,0,7,447712,0,27,0,506
5,1,4,0,5,18756,0,0,0,602
15,4,11,5,8,143076,59208,58,1040,509
8,5,3,0,8,264984,0,0,0,701
17,8,9,7,14,272755,41733,84,4995,431
9,7,2,9,6,871728,329192,145,87067,409
9,4,5,1,6,74803,5041,30,5041,463
14,10,4,10,4,130474,52478,180,12811,479
16,8,8,3,19,119120,10138,12,0,548
3,1,2,2,8,0,11204,11,0,648
20,15,5,9,11,189832,162932,159,63096,430
15,8,7,1,9,142589,1460,11,1500,473
14,11,3,11,8,40337,48837,34,13472,397
31,9,22,6,9,603789,47792,8,7055,450
39,8,31,8,13,25951,16873,222,4712,481
45,13,32,7,23,461674,47806,347,1162,464
12,2,10,0,1,23074,0,0,0,555
9,4,5,0,12,583,0,20,2001,537
14,7,7,6,13,401320,71849,26,11487,488
8,5,3,2,11,468227,4324,25,0,572
26,5,21,7,10,60047,46227,0,0,455
5,3,2,3,8,44899,37132,76,0,514
5,2,3,3,11,12236,12517,32,6118,519
16,7,9,4,8,20875,18773,92,1875,453
11,9,2,0,18,397948,0,0,0,622
6,3,3,3,14,119689,242698,61,119689,438
26,2,24,0,8,32389,0,8,0,672
7,3,4,1,7,53590,53590,31,0,551
8,6,2,0,13,1747,0,32,0,690
18,7,11,6,12,70653,70312,83,18059,450
10,7,3,9,7,43924,63370,0,0,463
7,5,2,1,12,896116,29988,20,29988,563
28,7,21,5,5,48224,39041,9,25405,478
14,8,6,6,10,42414,23246,124,7875,523
14,6,8,2,9,37552,36814,3,18407,560
24,7,17,5,5,21970,15057,149,5980,487
21,11,10,10,11,53119,47411,118,10682,417
7,2,5,0,8,11660,0,45,3344,566
14,4,10,4,15,20241,25590,21,5420,451
9,4,5,3,10,21229,21229,42,5503,445
8,3,5,1,3,46797,727,9,1853,476
9,6,3,0,6,23617,0,0,0,625
5,3,2,0,3,18175,0,5,0,555
29,5,24,5,10,57478,62196,0,0,478
9,7,2,4,7,373669,39735,36,40291,458
8,5,3,5,10,43426,16072,37,6499,434
7,2,5,2,13,10483,4495,0,0,515
11,4,7,2,10,399579,4096,13,0,550
6,3,3,1,10,14564,837,38,0,536
46,8,38,3,10,67963,13212,14,5123,451
22,6,16,7,9,25583,38515,480,18165,427
14,4,10,0,10,17751,0,23,0,684
26,13,13,0,11,506027,0,2,117,648
11,5,6,3,4,23998,29933,0,0,478
15,10,5,6,15,394138,107681,35,39201,419
6,3,3,1,14,36814,36814,23,36814,552
20,9,11,0,12,54486,0,31,0,597
36,7,29,3,10,38382,21347,24,1692,469
20,5,15,5,15,236377,236377,347,29526,451
3,0,3,1,14,0,3694,25,0,618
12,3,9,1,11,343621,9558,2,9558,569
44,3,41,1,10,352894,700,1,700,613
15,8,7,10,6,45502,80523,149,11176,446
5,1,4,2,3,7394,4500,13,1334,392
18,8,10,0,3,111199,0,1,0,538
14,7,7,4,7,59957,34194,104,16776,525
69,13,56,3,13,1132823,14926,72,13643,571
9,4,5,3,3,437834,10403,125,6753,451
13,8,5,1,7,413165,2031,3,1173,632
11,7,4,6,9,59741,18216,211,10496,463
7,4,3,0,13,93963,0,0,0,685
27,16,11,1,18,811974,3651,4,3651,460
9,5,4,4,14,80893,151250,85,76894,452
102,5,97,3,10,17752,14457,40,10761,526
13,10,3,8,8,48002,47711,0,0,473
18,11,7,1,7,8725,91,7,1019,653
26,17,9,17,7,29287,29287,1308,6585,507
11,6,5,6,6,292335,85291,87,16043,409
24,13,11,8,21,800137,773445,43,0,501
30,12,18,5,14,179579,72366,327,27770,461
9,7,2,3,16,15638,275,31,442,515
28,14,14,21,9,484287,1041557,193,114669,417
14,12,2,0,12,193929,0,2,0,599
8,3,5,2,5,13459,3933,22,4700,557
15,8,7,2,14,96215,66220,42,400,503
6,4,2,0,5,28413,0,45,9095,602
21,5,16,3,14,400655,53811,98,32028,384
13,7,6,0,69,318465,0,2,2500,555
17,6,11,5,14,32205,32205,98,75391,523
9,3,6,2,8,84444,17140,23,12488,421
7,4,3,2,4,14043,5510,42,3770,434
16,7,9,7,8,48514,79558,105,25923,464
7,2,5,0,11,0,0,0,5670,588
9,4,5,5,9,33970,27017,88,4394,462
69,13,56,1,15,68924,5766,68,417,520
9,5,4,2,10,31618,25798,6,12900,447
19,4,15,0,3,22964,0,0,0,691
24,6,18,6,7,28830,35146,173,6468,465
21,10,11,0,8,640293,0,98,2220,585
18,7,11,4,8,42738,38779,0,0,489
19,6,13,2,11,392414,23866,32,20107,477
12,7,5,3,36,758232,56832,75,0,476
4,2,2,1,6,284,284,36,2614,592
16,5,11,2,13,26905,8982,24,7394,535
6,3,3,0,17,28216,0,3,0,663
15,8,7,5,8,373220,20429,28,2412,411
11,7,4,6,6,98664,49080,0,0,519
23,8,15,8,16,66154,48729,46,15669,467
8,3,5,2,17,25416,17750,62,0,541
4,2,2,1,7,22689,463,12,463,648
63,8,55,2,8,450057,7998,69,6642,451
21,3,18,4,16,18828,32948,28,5669,429
11,4,7,7,13,75794,98620,15,4120,492
30,13,17,16,9,583342,202622,325,0,439
17,7,10,2,8,8703,3958,29,2345,550
14,3,11,3,6,11911,10615,5,2013,574
17,8,9,5,9,115346,69438,203,7772,454
8,1,7,0,17,0,0,3,3380,620
11,4,7,5,9,28826,39703,1,773,443
5,2,3,3,7,37095,51904,49,0,637
29,11,18,2,14,125253,78291,47,0,645
19,6,13,3,14,20010,152571,69,4880,529
3,1,2,1,8,673,673,12,0,560
20,12,8,12,7,55974,60150,117,12793,385
15,7,8,4,12,1147540,40757,86,4975,450
17,9,8,2,8,119629,5148,4,1990,450
13,6,7,1,13,29246,9742,11,41,496
8,6,2,5,10,280812,25551,41,8439,402
6,4,2,3,14,63032,62409,51,0,647
39,17,22,10,12,1832231,46607,456,4017,482
7,4,3,1,6,21176,5466,30,5466,463
23,4,19,3,8,44202,39444,33,13699,516
11,8,3,9,6,41520,39618,151,9936,444
7,3,4,4,15,852491,907237,45,102509,489
44,12,32,5,10,323233,44976,131,1502,458
4,1,3,1,11,20096,20096,89,20096,623
5,2,3,2,5,16417,15075,45,0,491
27,7,20,2,6,35726,6363,56,6263,567
4,2,2,2,4,288463,15589,13,0,485
12,1,11,0,5,14408,0,0,0,605
16,8,8,1,13,331357,1720,21,2500,603
46,17,29,10,8,76448,95550,184,20641,477
10,2,8,5,18,88413,185092,89,79887,550
18,14,4,13,13,739571,690798,205,138923,432
16,3,13,0,7,442554,0,111,1744,640
16,7,9,0,8,345880,0,36,11240,604
11,5,6,1,11,20670,5589,49,563,540
7,4,3,1,15,396013,12387,21,1610,510
13,8,5,6,11,35844,30582,86,8490,426
13,9,4,8,6,20606,30355,111,10546,485
17,10,7,9,11,289945,133780,180,17842,484
15,10,5,9,7,197552,65228,368,12402,439
35,6,29,4,6,120950,45196,92,29933,495
3,1,2,1,6,6186,6186,35,8391,604
28,8,20,0,10,133419,0,7,318,506
9,7,2,3,14,552692,129046,42,91200,567
35,5,30,5,13,23040,18613,42,4785,418
28,1,27,1,12,7002,5842,11,5842,575
16,6,10,4,11,133182,17406,5,6469,447
41,10,31,11,12,377504,62561,191,7531,443
13,4,9,3,5,45691,20148,49,17122,599
17,8,9,1,6,313884,3727,4,5800,631
5,2,3,4,11,49068,51476,72,10606,427
17,8,9,6,69,148845,114756,92,48000,473
13,4,9,2,10,11503,10578,33,858,599
2,0,2,1,6,0,8693,35,0,604
29,4,25,3,7,38738,38180,108,7137,494
12,5,7,1,10,301059,3676,8,6551,514
8,3,5,2,14,8240,8240,24,3150,507
10,3,7,3,9,314592,23079,64,13136,478
6,2,4,2,8,28517,23653,6,5475,462
18,7,11,11,8,81996,103006,112,44029,441
12,2,10,2,9,137905,94624,78,5294,449
32,11,21,1,8,322933,1207,27,1207,595
49,13,36,2,6,63399,9335,10,6316,416
17,12,5,8,13,1520921,121792,61,3975,447
14,8,6,1,16,336709,30518,6,34601,599
31,10,21,2,15,118591,2275,40,2290,586
12,6,6,2,15,320945,2843,33,1579,458
13,2,11,2,14,306749,9886,26,16718,422
30,13,17,2,12,1214451,3810,1,839,577
11,7,4,0,2,39251,0,0,0,631
21,14,7,7,25,2342935,543940,130,91082,473
8,5,3,4,7,1074053,163423,25,133726,442
19,5,14,8,15,364694,205905,0,0,493
30,5,25,2,17,74499,56356,25,0,526
6,2,4,0,6,140523,0,1,0,624
5,1,4,1,4,27381,11865,15,0,549
12,6,6,1,10,236562,180803,24,280,601
18,7,11,8,17,29665,33294,97,4697,458
28,14,14,0,19,1344669,0,60,8849,489
6,4,2,2,5,5881,5881,61,3442,507
3,1,2,2,7,3195,4693,42,3195,549
11,4,7,2,8,127804,6540,7,1703,604
11,2,9,1,9,3683,2954,29,2954,586
10,5,5,0,14,76792,0,3,0,627
16,7,9,7,9,70641,70641,141,2497,474
7,3,4,3,10,24585,24585,19,14175,486
11,5,6,5,25,397848,395691,58,377,495
3,1,2,1,2,5508,5508,13,5508,472
14,3,11,2,10,254207,88008,33,49150,490
23,6,17,3,13,110420,10486,52,6132,449
10,7,3,0,25,622419,0,0,0,713
5,2,3,1,8,6382,6382,83,6382,605
11,5,6,1,7,319997,15138,0,0,531
4,1,3,1,9,9336,9336,10,9336,636
41,12,29,4,18,427163,16366,119,8594,591
5,3,2,0,5,8699,0,14,168,603
36,6,30,2,22,32317,28622,114,11096,449
12,10,2,9,8,17418,17418,85,16800,409
8,2,6,0,8,30983,0,0,2498,625
8,1,7,0,14,0,0,0,996,581
14,4,10,4,5,35552,35552,84,7906,452
29,7,22,2,14,828756,4121,18,1406,476
16,9,7,5,9,55148,54132,40,3875,469
18,8,10,1,6,274554,8144,158,8144,569
37,9,28,3,18,870962,266763,68,172196,474
5,2,3,1,8,322318,17909,7,17909,551
60,8,52,1,12,55640,19181,53,2606,520
8,6,2,3,8,76227,25121,21,0,547
11,4,7,4,15,657182,54049,24,2825,448
8,2,6,0,15,23115,0,0,92,685
12,6,6,8,25,304010,1419343,183,0,526
7,4,3,4,8,4150,57723,38,1250,442
21,4,17,2,6,5644,5002,186,4696,556
72,7,65,0,14,887923,0,28,5910,590
12,6,6,5,13,1013036,120002,12,19148,485
10,8,2,9,5,39762,37180,0,0,498
16,5,11,1,19,296283,6718,38,5272,483
9,5,4,4,11,16868,17880,36,8017,498
17,2,15,0,7,10105,0,8,0,599
12,8,4,0,12,37083,0,0,234,579
6,4,2,0,10,68552,0,12,0,552
17,8,9,8,9,31887,26244,355,13124,404
9,6,3,3,11,42415,33369,24,1409,513
15,8,7,4,21,240022,31632,56,3316,533
3,1,2,1,16,34342,34342,14,34342,477
6,2,4,1,13,13984,13984,7,13984,605
9,7,2,1,4,390568,538,5,0,505
17,7,10,6,21,316543,41983,50,24295,409
36,9,27,1,8,268273,3280,16,2162,469
17,6,11,0,8,20341,0,7,344,583
10,6,4,1,7,374612,5192,18,0,500
24,8,16,9,12,40940,29659,57,11104,470
6,4,2,2,19,47172,42377,30,41828,471
40,3,37,0,13,10320,0,34,8725,472
63,10,53,2,6,93604,2647,31,2896,447
18,7,11,5,8,103519,56840,270,15884,453
12,4,8,1,9,7912,1834,95,1834,621
21,3,18,4,16,18031,20226,45,9320,495
11,5,6,2,5,16402,3139,8,381,498
26,16,10,8,13,174066,92635,243,23419,407
42,5,37,2,10,47467,9292,59,8940,618
21,15,6,9,25,2326715,442289,59,249,501
38,13,25,16,9,88266,177742,625,28351,414
68,18,50,9,30,446394,136517,187,62042,404
13,0,13,0,8,0,0,0,0,530
7,1,6,1,8,2031,4479,40,215,608
41,10,31,0,14,38520,0,80,1768,522
31,3,28,3,9,81070,22328,5,1250,522
6,3,3,3,12,281275,77335,41,37909,601
28,5,23,6,14,108267,54432,81,6377,429
12,6,6,2,5,243629,14789,21,2240,585
28,9,19,6,10,245540,70294,82,36397,356
6,2,4,0,8,910,0,1,1332,643
85,12,73,13,14,237427,257491,124,63011,412
11,7,4,5,7,91717,91298,329,14948,510
25,14,11,3,13,170908,2989,13,533,491
11,8,3,1,23,518554,7901,14,7901,529
5,3,2,3,8,14484,12315,16,9383,505
8,3,5,1,12,14720,14720,96,20546,534
10,1,9,0,12,0,0,47,968,649
8,2,6,3,9,0,35701,61,0,705
99,6,93,0,14,19117,0,4,1282,599
5,2,3,1,11,8939,8939,18,8939,586
23,10,13,6,13,69506,21167,63,3652,415
8,2,6,3,7,30350,50305,13,17673,454
36,6,30,3,5,27206,9154,164,6118,534
5,3,2,2,4,20453,17457,29,15926,450
3,1,2,0,12,0,0,0,0,610
6,3,3,4,13,7053,9443,49,5415,472
4,2,2,1,19,3720,3720,25,3720,659
5,3,2,1,10,280456,8395,23,8395,652
9,6,3,0,14,155316,0,1,0,587
14,10,4,7,9,78201,41697,82,11142,429
10,5,5,5,9,50432,64735,0,0,458
20,7,13,0,18,315230,0,0,708,635
17,3,14,3,17,68639,13778,0,0,458
29,5,24,3,14,73848,73848,181,63784,533
10,6,4,7,39,319987,59450,124,5995,411
17,4,13,2,19,63105,15790,7,702,635
26,18,8,0,14,290771,0,35,5528,567
18,11,7,6,16,239630,38619,84,24279,438
3,1,2,1,16,352280,15676,0,310,467
17,12,5,1,14,136047,288,27,1949,542
9,4,5,2,18,353312,56595,45,29624,556
21,7,14,3,8,400587,23999,23,7685,457
12,4,8,4,23,95253,35152,42,21680,471
26,16,10,3,22,830779,6099,23,0,506
10,8,2,6,16,307837,23990,23,837,474
17,10,7,1,28,875378,86364,91,7748,498
47,9,38,9,8,75103,83315,460,35238,438
20,4,16,2,8,19482,1505,209,1289,539
11,3,8,1,4,22865,4062,0,2249,503
138,16,122,1,17,129574,909,48,2313,501
4,2,2,3,11,287548,133770,59,0,641
51,0,51,0,9,0,0,1,818,703
36,12,24,5,11,65652,2828,121,1212,537
34,31,3,30,6,68617,64391,491,7866,436
12,6,6,5,13,35895,18348,142,3103,474
15,6,9,2,19,339653,229258,22,114629,489
12,5,7,0,8,39092,0,17,216,503
25,11,14,9,11,22898,16716,173,6770,436
12,5,7,2,13,76901,3120,8,2646,500
23,8,15,0,16,101275,0,38,4090,470
9,5,4,0,12,219425,0,12,7253,591
34,13,21,0,13,719788,0,1,518,669
21,7,14,0,7,63072,0,13,0,616
32,9,23,3,13,148613,25773,198,19245,508
10,6,4,2,12,16268,7361,45,0,492
31,9,22,3,18,317568,4782,99,6130,502
26,12,14,1,6,148995,2743,14,944,559
5,2,3,1,2,15632,6618,46,6618,454
13,7,6,5,11,21641,10425,63,1285,489
14,5,9,2,6,18656,11341,23,4666,448
5,2,3,5,7,97998,137123,84,28866,535
42,13,29,2,9,559666,32187,59,941,466
31,13,18,8,14,230961,23435,174,3220,508
29,8,21,6,10,296204,84001,121,42177,486
18,6,12,4,13,21986,13597,54,6075,465
8,6,2,0,3,116810,0,0,0,518
59,10,49,2,20,112673,246058,59,12496,570
24,11,13,2,6,129539,2617,19,1317,536
91,16,75,4,11,374398,13888,76,18497,398
20,7,13,6,12,24549,24438,96,11616,459
22,12,10,6,11,57075,6393,177,3348,456
11,7,4,1,14,334533,4794,2,0,629
28,4,24,1,15,56042,55651,106,10909,551
10,5,5,1,7,57731,121,68,3698,449
7,4,3,1,12,29518,656,23,656,500
8,5,3,5,8,4082,4082,25,1329,563
4,2,2,4,9,238913,100631,0,0,466
9,2,7,1,6,18982,2452,14,3681,558
27,9,18,3,12,97323,58116,225,37166,404
6,4,2,2,7,423904,65303,15,9589,405
12,6,6,0,7,19727,0,5,0,513
32,19,13,10,10,370485,8845,22,743,465
29,8,21,5,14,29809,22135,73,9645,427
15,5,10,3,10,165530,132918,44,0,552
9,4,5,7,12,23514,31604,117,8732,505
10,7,3,2,20,190535,16637,27,14329,519
17,5,12,0,12,68745,0,0,0,635
11,9,2,5,11,192649,49758,59,7627,492
64,26,38,25,30,1509361,1584572,774,145828,424
22,10,12,1,19,442157,1672,3,0,510
28,1,27,0,19,0,0,0,4537,673
5,2,3,3,12,13807,17602,24,11476,512
25,14,11,1,14,391922,36421,0,0,502
6,3,3,0,7,19995,0,5,145,603
18,8,10,3,10,84536,18947,63,573,514
7,4,3,2,13,371686,18728,0,108,474
20,6,14,1,20,104132,14039,1,14039,459
17,8,9,10,9,3475723,3364837,108,0,462
4,2,2,0,16,182032,0,0,5453,637
4,1,3,2,7,1404,12850,29,1404,507
31,7,24,3,13,151197,24463,74,7386,447
12,4,8,0,19,75636,0,1,0,662
53,2,51,0,6,2497,0,2,0,508
6,3,3,0,16,1439,0,28,858,468
14,9,5,7,11,731376,71648,1,177,484
24,7,17,0,19,26782,0,5,1951,652
29,5,24,3,8,39377,25624,50,5781,466
8,4,4,1,12,24560,710,25,203,565
9,2,7,1,5,484,484,8,4710,398
17,8,9,7,15,285734,192637,132,34617,441
7,4,3,0,6,158707,0,8,0,545
5,3,2,1,8,287925,23429,15,0,613
9,7,2,3,16,332029,158520,50,4855,447
11,5,6,2,8,40385,32294,37,2718,483
21,13,8,1,30,852442,1112446,14,0,584
4,2,2,0,33,8180,0,0,0,744
25,20,5,0,20,2427180,0,5,0,668
13,3,10,1,12,58038,351,9,3194,628
21,13,8,0,15,1973083,0,0,0,580
17,9,8,0,6,402044,0,0,0,592
10,3,7,3,14,5605,5604,28,1560,475
48,8,40,4,18,33114,10719,242,5782,527
12,5,7,0,7,83304,0,89,580,506
6,3,3,2,7,9207,1294,21,22,650
22,3,19,3,14,14704,14704,185,8606,481
15,5,10,0,5,50151,0,0,0,653
32,17,15,17,8,596978,234575,289,35405,382
9,2,7,2,14,1556,1556,4,1030,470
8,3,5,1,6,20937,8405,32,0,506
6,4,2,3,15,29378,29378,48,12241,412
9,4,5,1,7,76203,872,19,0,555
54,13,41,3,13,403915,165349,142,146067,443
10,5,5,4,7,24776,9573,82,3232,534
6,4,2,3,15,67214,28295,24,5897,481
10,7,3,3,9,155816,75755,0,0,534
7,3,4,3,8,26430,18859,64,0,503
11,4,7,0,18,12022,0,0,0,739
11,7,4,3,7,293683,197714,52,112705,463
7,2,5,2,4,23819,6321,7,2688,592
27,6,21,1,6,101537,305,1,5000,556
12,7,5,0,9,234690,0,29,0,536
40,21,19,19,13,449814,438540,403,42128,492
5,2,3,4,5,31003,24272,4,2566,534
19,10,9,5,8,236109,18454,62,0,478
8,5,3,0,7,129066,0,0,0,673
27,6,21,8,8,176108,176108,85,5228,425
10,8,2,2,15,375464,4373,2,820,607
18,9,9,1,3,77910,5428,14,11471,517
3,1,2,0,4,4142,0,0,0,659
23,7,16,6,7,47492,34440,42,10288,468
22,3,19,4,12,311853,58613,75,0,429
14,6,8,0,12,622967,0,1,0,564
4,1,3,2,7,8593,6848,0,0,543
9,3,6,1,10,7816,4057,10,4057,500
23,2,21,2,19,7487,7487,279,3865,516
26,9,17,11,12,384948,221627,184,33777,435
7,3,4,2,15,27520,11102,43,0,531
33,15,18,8,18,216686,36990,364,15239,458
6,2,4,3,5,412,14687,34,12775,455
12,7,5,5,16,341418,107912,136,0,525
6,1,5,0,3,10534,0,0,0,631
15,9,6,1,8,310756,1921,23,0,571
10,4,6,3,7,9752,4922,37,4116,466
28,9,19,0,12,369750,0,2,121,640
20,5,15,1,3,17960,333,18,0,510
19,3,16,3,12,346487,27389,59,17900,446
20,6,14,2,7,82479,2405,261,2385,492
64,7,57,4,18,92865,33512,99,0,509
33,14,19,11,20,121269,118807,132,37124,511
14,11,3,2,7,227419,1147,0,0,570
16,5,11,1,12,91712,1092,38,4971,520
8,3,5,1,8,0,1604,0,0,702
42,13,29,12,17,423190,401377,10,9967,500
10,6,4,7,15,373846,220629,286,15851,463
6,4,2,2,8,63472,26617,50,0,543
28,9,19,6,19,41015,25468,126,8117,446
11,5,6,3,11,97242,54153,48,11627,427
6,1,5,1,7,3641,3641,253,2865,488
6,1,5,1,14,0,15021,0,9138,578
42,5,37,3,15,92413,9071,68,7641,483
15,3,12,2,18,148855,148855,72,0,525
28,11,17,9,15,183080,56818,56,20311,433
30,7,23,1,7,209635,9790,7,0,517
32,11,21,3,10,317419,8837,111,3577,452
97,11,86,3,13,141546,10842,9,4778,424
90,26,64,17,7,328029,132384,150,70538,429
28,5,23,1,15,31926,2506,28,4307,509
16,5,11,1,15,15104,1150,4,1150,640
10,7,3,5,4,219985,22699,41,5225,454
6,2,4,2,14,229108,67714,61,0,612
14,8,6,1,10,382533,416,52,698,533
62,14,48,13,14,123960,143422,728,32109,447
19,11,8,2,23,199235,83616,28,0,481
27,10,17,8,20,91188,51856,163,9997,460
8,5,3,4,7,16657,16102,39,6394,435
6,3,3,1,12,1149,451,38,1643,532
22,10,12,7,18,460216,95892,122,4830,505
19,5,14,3,13,3892,3821,25,2834,472
15,9,6,8,17,877196,337000,163,10095,511
7,3,4,0,12,282341,0,3,251,689
13,7,6,4,12,142486,119687,56,55814,496
14,8,6,8,7,96709,100616,0,0,440
5,2,3,1,11,352847,10083,0,0,486
38,3,35,1,6,36709,10801,25,0,632
8,6,2,7,13,58556,30396,74,5576,459
3,1,2,0,12,16478,0,0,0,614
16,9,7,7,17,307116,82068,283,14694,422
14,7,7,8,12,355047,65952,125,10308,395
15,6,9,5,12,12789,17438,72,1340,508
3,1,2,2,8,4188,11396,43,7208,533
18,7,11,4,15,285590,59261,79,118941,411
20,13,7,5,7,209313,19806,93,1540,433
9,7,2,6,19,363754,328740,108,8252,439
39,20,19,0,15,2576157,0,18,3300,558
9,2,7,2,9,22765,22765,77,18077,425
11,9,2,0,15,441573,0,10,0,683
5,1,4,1,14,26800,26800,22,26800,587
13,3,10,2,15,11745,7774,26,6642,471
13,8,5,4,13,977928,909659,106,0,505
14,11,3,0,7,129080,0,1,0,540
4,2,2,2,15,36140,36140,31,3012,567
15,10,5,2,7,62402,8080,22,1356,464
8,2,6,2,10,1273,1273,41,999,525
4,2,2,1,7,22601,22601,50,0,513
41,14,27,0,14,757419,0,4,592,602
33,10,23,0,16,567481,0,0,0,485
24,8,16,3,7,41687,25877,53,18015,472
6,2,4,0,6,9501,0,0,0,611
9,6,3,0,4,41077,0,4,1200,583
21,7,14,7,8,48715,50493,102,21568,435
5,3,2,1,6,1670,1377,53,3752,468
6,4,2,2,14,333831,11903,23,6208,496
19,7,12,3,27,407905,190797,40,0,543
17,10,7,8,8,100412,38986,39,1501,442
33,8,25,3,12,531356,4512,55,0,492
19,13,6,1,27,473441,421,17,421,489
17,5,12,6,20,682497,184880,102,3705,484
15,4,11,2,6,26159,2499,88,2290,503
8,3,5,3,3,34312,34312,37,15119,411
8,4,4,4,13,48075,48075,0,0,504
5,2,3,0,14,250922,0,0,182,606
17,3,14,3,20,225237,194476,45,0,495
21,14,7,15,9,219763,215452,292,6206,513
20,8,12,0,12,136503,0,1,184,509
11,6,5,0,3,469049,0,8,1009,511
3,1,2,0,4,0,0,20,2739,574
13,6,7,1,16,27621,29830,7,10020,457
5,2,3,0,6,48115,0,6,94202,609
8,4,4,0,9,0,0,119,2535,509
14,9,5,6,12,331046,48479,54,9104,447
8,4,4,2,8,45307,89926,21,44963,528
3,1,2,1,11,223,223,10,223,517
16,6,10,2,24,323263,78065,42,39619,532
116,6,110,0,14,2574,0,1,1,587
11,2,9,2,11,9334,9334,59,7771,419
29,5,24,2,19,32862,32862,24,2400,426
10,6,4,5,9,576517,85595,80,62097,415
8,4,4,3,13,17425,17425,31,18796,472
25,7,18,5,30,27573,80788,261,20834,515
12,1,11,1,13,8328,8328,95,355,446
17,7,10,4,50,41236,31443,32,15271,439
31,15,16,13,8,62481,48808,146,8233,437
18,7,11,5,15,59422,72359,1,8156,525
8,3,5,0,6,20525,0,0,0,654
44,11,33,4,14,327086,67558,70,33998,438
22,5,17,1,17,18584,12984,47,1134,528
6,4,2,1,16,608260,504864,16,504864,616
36,7,29,2,12,49602,39024,125,1177,521
11,5,6,5,12,102269,102843,9,26130,552
13,4,9,2,18,10012,9946,55,3724,525
8,4,4,5,15,19690,18878,172,7701,481
5,1,4,3,6,7628,15211,42,0,501
16,4,12,6,14,43150,59473,101,2050,494
15,5,10,3,9,290992,16752,46,5782,469
23,9,14,9,22,414572,174973,3,1133,511
6,1,5,0,13,4196,0,5,610,731
18,6,12,4,14,657271,12474,108,0,529
18,8,10,2,8,56477,11281,136,24124,342
50,8,42,6,16,41793,80030,155,29250,519
47,13,34,10,18,106846,48533,133,36270,425
18,8,10,7,11,857640,672036,60,153545,405
13,7,6,5,5,421698,45023,329,16405,437
106,7,99,3,10,22884,14457,40,10761,526
20,11,9,7,11,109899,55348,240,7478,404
13,7,6,7,11,279124,272105,9,4941,415
5,2,3,2,6,638,638,7,1097,517
10,7,3,6,11,124810,122885,14,2590,483
11,8,3,8,7,56909,56909,62,11572,418
14,4,10,1,19,58540,58000,24,58000,642
52,14,38,9,11,263508,79457,162,24951,427
6,4,2,3,14,20717,11511,154,8360,432
16,8,8,3,8,12940,2384,43,7609,515
7,5,2,1,6,88289,21152,11,0,491
37,4,33,7,11,201599,201599,168,3501652,515
21,12,9,0,9,578222,0,15,3165,598
25,4,21,4,8,30147,16684,79,4100,473
74,22,52,11,11,184836,53073,45,5500,517
9,4,5,5,12,13350,15572,0,0,467
11,5,6,4,10,348678,47396,95,484,493
9,2,7,3,8,10637,14782,54,9404,606
8,4,4,3,10,36991,49709,26,0,538
8,6,2,3,10,23727,22811,99,1914,466
33,7,26,6,12,239915,237910,128,0,494
16,4,12,5,8,10484,10185,100,1941,436
24,8,16,0,9,452263,0,4,2412,512
9,2,7,3,7,12494,44472,51,2359,485
5,2,3,1,5,12475,5682,24,5682,457
33,11,22,0,13,212418,0,14,3151,486
7,3,4,0,12,24091,0,26,0,672
21,8,13,7,11,39472,41789,261,14497,437
7,4,3,3,13,890500,35346,35,0,505
7,5,2,2,16,211265,58989,15,1508,463
41,13,28,9,16,224476,211256,491,29836,432
49,8,41,8,13,93511,81648,127,29532,482
21,6,15,7,18,79466,30773,118,9560,517
11,3,8,3,11,103302,49763,59,5604,455
17,13,4,10,17,203936,55941,56,254791,446
13,5,8,5,8,27271,30061,264,12586,427
14,8,6,5,7,23609,34855,39,11612,394
11,6,5,2,13,20451,2998,66,0,548
14,2,12,2,5,2558,2558,76,3149,487
8,2,6,0,10,21925,0,5,244,654
60,18,42,6,15,1478401,156413,73,12048,423
105,12,93,8,17,1109365,189379,261,6921,453
11,8,3,1,9,249295,187,3,0,535
16,7,9,6,9,46244,46244,315,24252,417
27,8,19,4,9,100402,24154,0,99,496
15,4,11,3,11,853787,61017,99,19720,424
20,5,15,2,10,6582,6582,30,1895,480
6,3,3,3,12,17517,15369,45,6980,451
27,14,13,6,5,552917,35449,46,9303,400
4,1,3,1,6,6225,6225,26,0,506
38,34,4,8,14,1556318,2302,13,7447,485
9,2,7,1,14,303,303,14,682,647
9,2,7,4,6,9158,27437,0,0,561
11,7,4,1,10,423336,1176,5,3095,473
31,7,24,0,13,350375,0,3,0,635
11,6,5,2,3,18687,3317,79,2184,432
11,4,7,4,14,417027,35686,23,14400,455
77,16,61,1,10,148678,145,66,1523,553
14,5,9,5,3,21147,15719,14,4748,446
14,6,8,0,10,356739,0,2,0,551
15,9,6,0,21,460830,0,10,10826,575
8,3,5,3,13,16835,21612,44,9300,558
30,5,25,1,11,619971,13409,24,7639,581
8,4,4,4,17,235366,70832,5,12540,547
22,10,12,0,9,404785,0,1,0,653
16,11,5,9,8,1229306,1223498,172,2610,437
12,9,3,1,10,52677,1162,17,1162,501
24,6,18,6,13,63910,35533,157,12759,412
18,3,15,3,13,18975,18975,215,12193,490
5,3,2,1,13,938,65679,0,0,467
56,9,47,8,17,71046,66331,498,22011,463
8,4,4,4,7,14779,14779,60,6671,516
17,8,9,0,6,117275,0,0,0,655
6,3,3,2,14,20106,14617,61,12490,471
23,12,11,9,7,312183,41511,247,19366,478
6,1,5,1,4,8512,526,3,526,600
13,4,9,4,9,10920,7738,56,3504,477
8,6,2,0,7,21556,0,0,0,476
158,10,148,9,10,18801,17808,207,6478,431
12,8,4,0,16,270721,0,77,5123,604
32,9,23,10,15,348335,33690,584,10716,455
23,2,21,1,12,17584,17584,8,2043,545
13,8,5,5,29,201750,205714,56,1008,523
55,16,39,5,16,63613,45561,187,28167,579
17,4,13,1,18,13159,35,25,1290,551
5,3,2,5,7,70378,94504,0,0,481
15,8,7,4,27,79568,75650,102,0,492
7,1,6,1,12,14231,14231,4,14231,637
22,7,15,3,9,44232,5041,67,3220,489
16,7,9,2,9,74472,1122,81,624,569
39,4,35,5,10,34734,16725,104,5976,520
19,8,11,5,9,19835,19835,63,10332,400
13,8,5,7,8,127758,117880,28,18748,424
39,14,25,3,27,676542,84236,61,12946,577
42,10,32,5,11,287241,3863,108,3741,424
9,7,2,1,7,17867,2509,24,2509,597
23,6,17,6,13,38579,39959,106,19288,503
20,7,13,2,15,63849,12329,38,12145,532
10,3,7,0,10,76756,0,0,0,622
7,5,2,1,5,318243,288,0,0,548
14,8,6,1,8,335459,2258,10,0,519
9,2,7,3,8,15091,24426,0,0,537
23,9,14,7,14,74430,84285,112,25813,475
9,6,3,0,13,363941,0,0,0,713
31,26,5,25,15,193530,54145,341,29495,414
16,7,9,2,7,64290,11054,11,4985,477
4,0,4,0,11,0,0,28,5981,626
4,2,2,1,8,11967,2158,10,2158,641
6,4,2,1,7,389552,2521,3,2521,479
8,3,5,2,15,6714,10496,113,0,506
25,5,20,1,18,412481,16559,23,16559,683
9,2,7,2,5,15027,12975,110,1737,542
10,6,4,8,10,100215,163534,24,6247,471
37,9,28,8,13,236835,124901,8,8660,431
15,11,4,4,14,59730,57469,46,53273,433
11,7,4,7,14,894357,1056540,166,345276,509
11,6,5,0,14,535653,0,15,2275,599
19,11,8,13,8,47956,54682,171,9170,455
39,16,23,1,15,311346,1240,179,0,487
10,7,3,4,14,353367,27397,69,10731,445
14,5,9,3,10,65410,24773,37,10718,441
9,5,4,0,7,249899,0,20,0,510
9,3,6,5,13,104814,113584,57,8116,526
12,7,5,0,6,54577,0,0,0,638
6,4,2,1,6,30279,22744,40,0,518
33,10,23,8,12,116878,85152,97,22296,453
16,6,10,7,6,17501,22317,30,7888,462
23,5,18,0,7,64422,0,11,0,675
24,6,18,1,13,55627,1062,138,24042,535
8,3,5,4,6,19363,23605,0,0,536
16,5,11,5,8,52492,47200,79,16160,414
5,2,3,0,3,441916,0,8,0,522
12,6,6,6,11,20191,20191,47,12344,481
19,13,6,0,14,806580,0,7,1725,609
21,8,13,6,18,39218,39216,136,19857,365
7,3,4,0,13,126417,0,4,664,546
34,18,16,1,8,202694,3842,9,40,573
3,1,2,1,12,0,7434,18,4478,640
23,16,7,1,11,1742435,439,7,0,541
4,2,2,0,8,4900,0,0,0,542
8,2,6,1,20,235312,13246,0,1254,495
10,5,5,5,11,32229,55360,42,10202,455
22,12,10,6,9,78637,18145,69,6721,450
28,8,20,2,13,732656,25055,16,3339,418
12,8,4,6,14,37602,32436,108,13903,429
19,4,15,3,12,22550,21260,39,16974,519
21,6,15,4,7,20602,2182,268,7190,451
22,9,13,6,13,17168,11817,144,8502,430
16,9,7,0,13,274431,0,7,274,563
62,9,53,8,15,76564,57218,188,13843,458
23,10,13,0,15,108607,0,0,0,692
76,14,62,2,13,242432,2208,51,2512,520
7,4,3,5,9,140219,146092,105,119861,498
6,3,3,2,11,1748,1748,25,1140,484
17,2,15,3,7,14399,20410,89,4502,477
7,5,2,5,10,89688,44174,96,10976,451
15,4,11,0,10,11305,0,12,2599,651
19,4,15,3,6,9741,9741,25,4702,427
14,5,9,1,10,669936,43274,40,0,485
18,16,2,4,15,376979,7050,4,2992,552
15,12,3,7,9,118356,75959,188,34647,420
5,1,4,0,10,0,0,3,180,728
5,3,2,2,8,495631,30667,19,25792,523
17,6,11,2,8,48436,13773,65,0,451
10,7,3,2,3,586431,19124,21,18474,486
9,7,2,0,10,170985,0,0,0,637
49,8,41,2,18,119371,9964,282,21701,521
14,4,10,2,8,84143,1174,117,1054,475
15,6,9,6,8,50589,56143,78,15417,470
38,8,30,7,18,55172,23741,298,9330,460
8,6,2,6,8,54277,54277,63,8100,458
24,4,20,5,12,456825,80043,5,5346,528
40,13,27,13,26,5100921,748400,144,1274,453
27,16,11,11,13,259619,200351,646,50957,465
18,9,9,9,18,844403,321486,72,34932,423
14,5,9,0,5,11848,0,155,910,526
19,8,11,1,12,66560,2400,54,0,484
29,17,12,16,14,532880,228153,290,11953,422
10,5,5,0,12,5115,0,8,308,621
17,12,5,0,18,315665,0,0,774,674
17,9,8,7,8,17406,17406,128,8262,571
14,4,10,4,9,514,15974,105,0,536
7,5,2,0,6,312089,0,0,0,674
57,12,45,5,10,81846,53958,45,18286,440
15,3,12,0,11,891022,0,20,6083,496
17,12,5,8,12,771484,100979,43,89968,459
11,6,5,4,15,94278,24902,58,19026,489
11,5,6,0,12,327038,0,0,1000,577
2,0,2,1,7,0,43916,10,43916,459
6,3,3,2,11,5664,5664,4,4919,468
7,4,3,1,4,33875,636,1,636,504
9,4,5,3,18,383345,22674,49,638,625
22,7,15,0,13,39274,0,0,14256,628
8,4,4,6,9,53677,78899,127,22952,476
22,5,17,3,7,23002,2703,210,0,644
35,15,20,14,22,603012,472714,388,89985,377
11,4,7,3,12,10698,4314,43,3890,492
6,3,3,0,4,17147,0,4,742,581
14,11,3,11,8,26824,28277,139,7200,429
12,6,6,6,18,441947,90556,59,71114,458
14,6,8,4,9,343849,317322,62,169652,441
12,8,4,4,7,65235,53270,79,24818,460
11,4,7,8,11,339632,159875,106,1900,470
15,9,6,4,6,33632,14176,181,6534,408
9,7,2,5,16,111210,88849,80,9775,481
12,9,3,8,9,45565,38685,128,8289,393
7,4,3,3,7,11538,11538,154,10178,474
4,2,2,2,13,38952,38952,48,0,482
8,6,2,3,13,350665,29641,4,11789,493
14,7,7,5,13,204755,173672,49,29571,459
10,7,3,1,10,370330,6473,0,0,496
22,12,10,13,19,80209,268161,268,25398,496
10,7,3,0,10,79332,0,6,339,628
24,13,11,2,13,294271,6216,6,0,483
21,2,19,0,6,0,0,12,0,571
20,6,14,3,11,222320,18135,34,16100,472
10,8,2,1,69,508650,16210,8,140,522
19,3,16,3,8,6931,3915,0,0,478
11,4,7,1,12,12521,690,2,1395,470
27,11,16,9,15,255876,107476,0,0,450
11,9,2,8,8,232416,127917,166,2284,472
33,6,27,3,9,425152,13050,28,4728,469
5,1,4,1,16,7136,7136,2,7136,587
8,4,4,1,7,39313,652,0,0,657
18,9,9,9,6,142797,29475,22,6920,371
6,1,5,1,5,199,4653,13,4653,568
32,15,17,3,18,144527,6431,58,3304,515
6,4,2,0,7,438189,0,17,0,567
27,10,17,7,15,979790,107147,44,30417,411
6,3,3,2,13,19534,10103,28,1350,592
18,7,11,1,20,861017,338767,36,440,582
62,9,53,6,14,138876,60471,278,19575,448
10,6,4,7,7,32239,28986,63,7722,385
35,4,31,5,9,47353,25602,58,10296,460
14,10,4,3,7,148558,31883,0,0,449
23,15,8,5,10,1186048,138586,106,53309,418
19,5,14,0,14,277320,0,0,0,687
23,7,16,9,12,160964,231175,122,53328,494
7,2,5,2,6,15951,15951,110,14752,519
17,9,8,5,9,571543,10428,62,1386,427
2,0,2,0,2,0,0,0,619,620
35,11,24,3,10,339110,23884,58,13141,516
15,12,3,10,12,438109,83325,116,17993,414
10,4,6,0,4,69315,0,0,0,609
27,12,15,5,12,73430,37495,55,10061,458
6,2,4,1,12,11728,11728,9,11728,594
30,11,19,6,18,108699,5932,241,8056,455
30,7,23,9,10,99695,42784,193,8886,461
22,3,19,4,14,9817,15922,60,5613,523
32,12,20,1,17,687022,243422,37,768,554
8,4,4,3,18,23503,23429,47,15579,478
33,14,19,6,15,189980,127087,124,709,492
9,7,2,2,14,48232,23946,16,15083,555
8,3,5,1,17,315457,9286,36,9286,568
11,3,8,2,8,36939,23765,39,14749,589
14,9,5,8,12,198194,198194,17,41995,442
5,3,2,1,10,1541,1541,20,1541,582
5,2,3,0,2,110716,0,10,0,569
12,5,7,4,25,121627,79154,41,17921,504
21,10,11,0,14,435523,0,52,0,492
8,5,3,5,7,23462,38216,76,9360,381
9,2,7,2,14,11913,11913,40,9028,576
15,4,11,5,10,210161,226678,84,8630,508
16,4,12,0,21,94280,0,1,0,634
8,2,6,1,13,361008,5930,0,0,464
13,5,8,1,11,270070,5980,29,0,573
9,2,7,2,10,666561,64534,43,0,506
9,3,6,3,12,63085,58995,65,4922,521
11,6,5,2,5,28436,3193,103,626,476
19,6,13,5,12,329295,34897,80,23729,452
36,1,35,1,17,2471,2470,10,2470,502
10,5,5,5,13,628355,155818,78,129768,450
27,3,24,1,8,2714,1377,37,14250,440
36,10,26,4,9,398158,51108,77,3539,440
10,3,7,0,15,243761,0,100,1630,605
19,8,11,9,12,694410,296894,217,75153,463
4,2,2,0,6,1435,0,12,832,626
10,8,2,1,18,184913,16666,28,11904,473
8,5,3,5,6,29811,16819,44,0,514
14,7,7,3,18,576617,14684,99,1423,414
39,3,36,4,8,15099,20411,20,9139,466
46,7,39,3,8,58022,6374,31,4000,513
18,8,10,5,8,37657,37657,272,14562,473
53,14,39,7,13,52431,13446,49,3318,517
16,7,9,8,13,599867,69329,131,0,466
8,1,7,1,14,96317,6322,0,0,612
17,12,5,3,5,73405,830,10,509,558
21,11,10,5,17,67452,52313,194,33555,439
55,12,43,4,9,286874,96530,39,0,523
10,4,6,2,10,40287,1161,0,12058,547
17,9,8,4,16,122612,85920,158,24790,511
5,3,2,1,11,41926,2050,10,2050,635
4,2,2,3,2,40907,61532,20,0,483
32,10,22,5,14,50941,13146,34,3975,486
9,2,7,2,7,2543,1326,25,1723,591
8,1,7,1,9,1486,1486,31,2436,583
60,11,49,7,19,108172,87446,479,29296,433
11,5,6,4,7,79168,13093,49,9167,473
7,2,5,1,11,325258,3328,0,0,478
9,4,5,4,10,49684,52531,73,632,525
5,2,3,3,8,15950,27430,62,15399,476
13,10,3,6,13,23113,18122,65,11097,468
17,6,11,4,5,46180,3561,12,17703,508
22,11,11,9,8,56984,39498,153,8079,434
5,3,2,1,11,422081,11905,24,265,672
37,14,23,0,9,107687,0,0,230,660
5,3,2,2,9,43385,7451,42,9909,557
13,3,10,4,13,30188,63789,142,10185,530
28,8,20,1,12,614125,3252,60,5169,555
53,13,40,10,13,249355,94676,153,89725,472
20,7,13,7,18,73064,51869,312,13992,456
28,9,19,4,8,107985,48233,182,5294,473
6,3,3,0,3,0,0,2,0,582
25,15,10,0,9,211730,0,12,0,630
28,8,20,1,18,854849,11459,33,11459,417
18,6,12,1,10,374260,11437,0,0,636
14,8,6,4,4,274741,15634,289,9035,475
7,3,4,0,14,7995,0,11,1365,681
9,6,3,0,7,143913,0,0,0,657
50,6,44,2,7,104649,76440,198,75019,517
4,2,2,2,6,13435,13154,26,6724,605
18,13,5,13,11,73553,72039,181,6856,411
5,3,2,3,6,15060,7198,14,3629,498
3,1,2,1,7,7992,7992,35,0,533
21,9,12,4,13,426039,10599,28,5978,540
6,1,5,1,4,18502,18502,12,0,547
19,7,12,2,13,12662,22776,73,4942,505
12,8,4,1,16,239492,6939,14,1590,587
10,5,5,0,9,48757,0,0,2585,598
2,0,2,1,12,37244,37244,10,1250,674
15,3,12,0,8,17514,0,0,0,675
16,7,9,8,9,59578,52876,141,8859,456
8,5,3,4,5,15814,15814,33,4801,457
20,11,9,7,13,176348,36159,102,5998,427
9,3,6,1,19,649,49777,21,0,516
56,14,42,1,13,4038137,14364,69,22075,551
29,12,17,0,16,883029,0,0,992,707
7,5,2,1,14,557890,31379,24,31379,504
21,9,12,0,3,51122,0,3,2200,522
12,6,6,3,10,24449,22780,0,523,488
7,4,3,4,10,25894,25894,24,13775,440
11,7,4,0,14,118860,0,7,566,634
19,2,17,1,9,6978,1050,34,1232,467
15,7,8,7,11,42541,66865,124,10026,445
5,1,4,0,7,0,0,0,0,641
18,9,9,1,9,245474,1920,7,0,664
22,7,15,7,18,583108,111433,53,37181,379
21,3,18,3,9,19843,3250,38,2624,524
12,2,10,0,7,796,0,2,58,665
8,6,2,5,8,23781,23781,49,8393,450
7,4,3,3,17,66185,38697,42,15119,629
14,7,7,5,6,23671,19981,132,5983,512
29,12,17,1,29,573346,211,2,5870,548
10,2,8,1,11,14211,14211,94,14211,680
13,6,7,0,13,1707,0,0,0,718
10,8,2,7,11,127467,120614,53,6073,428
17,8,9,7,28,580985,527509,61,0,453
5,3,2,5,8,27847,37557,97,20388,503
41,11,30,0,15,203308,0,13,7390,535
16,6,10,6,9,22951,42363,0,0,439
57,7,50,4,11,60455,13848,57,8694,477
4,1,3,0,5,0,0,0,0,599
9,2,7,1,7,13355,8013,18,2556,515
26,9,17,3,20,70485,5184,107,2821,501
16,9,7,4,20,780027,11257,0,0,503
16,4,12,0,16,10979,0,3,2921,674
5,3,2,3,11,4055,4055,26,2747,465
7,4,3,2,10,45233,29355,3,216,478
24,8,16,6,12,40307,28107,128,9326,453
9,3,6,0,5,62813,0,0,0,630
5,3,2,1,5,4193,4086,14,9136,553
15,6,9,2,22,333359,9636,39,30782,403
15,7,8,3,8,236200,21029,312,19012,445
18,10,8,7,12,92778,51254,94,22922,450
14,1,13,2,8,1240,7308,35,6068,573
10,5,5,3,7,51615,28676,51,2050,592
11,6,5,6,31,224216,54112,36,11063,481
12,8,4,0,9,513996,0,11,312,432
16,9,7,0,8,96079,0,0,0,685
9,5,4,3,12,258237,16062,43,1237,464
4,1,3,0,11,292778,0,10,0,630
30,8,22,3,69,21111,8126,30,4741,545
8,5,3,1,6,144589,1183,18,1260,612
66,9,57,4,9,473844,23340,34,7260,476
5,2,3,1,4,5911,5911,0,0,517
18,7,11,0,14,246390,0,0,0,584
8,5,3,0,7,116583,0,2,154,577
12,8,4,3,10,760633,18151,88,9827,454
27,6,21,0,19,554922,0,22,606,541
24,6,18,4,19,18982,62778,140,12064,442
7,2,5,0,9,103996,0,17,0,680
11,9,2,2,8,245741,3375,6,970,669
9,3,6,2,18,31661,5092,1,3225,461
13,3,10,2,13,59859,8966,33,0,497
6,4,2,5,7,53732,70075,78,10940,477
15,8,7,3,8,263342,24181,32,5913,439
28,10,18,6,16,32575,60912,99,7050,560
7,4,3,2,7,255486,16940,14,16938,624
5,2,3,4,5,6152,21183,37,7732,472
26,12,14,5,13,308701,32449,36,2517,418
31,3,28,1,9,3712,594,22,2633,507
20,7,13,4,31,422639,289634,58,0,536
6,3,3,1,8,21900,10290,15,1020,549
7,4,3,0,4,31288,0,0,0,610
13,3,10,0,9,32028,0,0,3350,629
28,20,8,8,19,1247164,1137724,76,30168,464
65,8,57,4,11,1129193,39900,58,2756,508
18,5,13,5,13,370948,15524,36,5497,409
10,6,4,2,14,18246,13237,0,220,462
6,4,2,2,10,52213,10014,47,5049,522
14,11,3,1,6,78272,1476,5,1802,603
7,5,2,1,9,52809,198,5,1350,526
29,13,16,11,16,65510,43167,195,9720,409
8,5,3,1,10,23779,433,23,4381,517
10,5,5,1,11,118972,2030,31,0,603
10,1,9,1,7,6710,5214,26,0,635
13,7,6,0,8,50868,0,24,3101,595
17,7,10,0,13,517343,0,16,434,525
18,6,12,3,8,18187,7209,121,5988,473
15,7,8,2,14,823711,28725,89,27093,428
18,5,13,5,16,59131,59131,72,11490,466
6,2,4,2,8,709,709,26,512,430
50,47,3,0,11,77619,0,0,0,623
11,8,3,4,14,147090,18389,55,3168,512
4,2,2,2,7,20965,36484,0,0,563
12,5,7,3,7,375353,9315,102,407500,512
32,6,26,4,10,303779,27819,60,13150,436
6,3,3,1,16,2274,2274,3,6822,561
5,1,4,0,11,11923,0,0,0,688
4,1,3,0,19,0,0,1,602,480
12,5,7,7,7,57529,71210,340,28600,467
15,7,8,4,16,18068,16587,70,28264,451
34,5,29,5,13,34768,43284,127,3849,518
30,10,20,1,12,385130,73,186,425,581
14,9,5,8,14,68812,39592,170,7825,458
8,5,3,1,2,36224,2705,12,2705,529
22,7,15,8,7,127877,28201,122,5027,493
26,3,23,3,7,34468,4314,1,422,510
35,15,20,15,11,110875,49671,36,14386,392
18,12,6,9,4,411266,67663,145,11431,431
12,4,8,0,5,39012,0,0,0,659
8,3,5,2,17,20419,19419,59,11419,461
18,8,10,5,15,157322,155086,57,3492,442
12,3,9,4,5,22215,22115,35,8885,499
16,7,9,0,18,33852,0,1,580,646
9,2,7,2,5,4843,16708,32,4843,611
8,5,3,5,9,68958,61324,97,9655,491
13,8,5,3,16,327163,10833,70,1349,477
17,4,13,6,9,148798,191319,223,8684,466
16,14,2,11,15,105285,65491,19,1924,447
67,28,39,28,9,787611,701969,732,120039,410
20,8,12,9,8,426351,348945,155,44550,403
12,6,6,0,4,61017,0,11,1021,491
13,5,8,2,16,138693,79386,1,1250,481
54,9,45,1,9,208432,183,75,964,536
33,25,8,4,4,991855,7315,38,1425,494
7,3,4,0,6,28013,0,1,0,603
103,13,90,7,21,297818,78722,258,24256,429
29,8,21,4,13,240174,12701,49,9678,423
19,16,3,0,13,313929,0,0,0,601
11,4,7,0,12,4165,0,0,34495,691
48,15,33,6,48,852551,46003,19,5520,521
17,9,8,1,8,163931,3214,15,0,577
23,5,18,4,13,115609,51647,45,34847,412
19,6,13,4,15,21895,40248,35,29397,455
9,2,7,1,15,86046,6991,17,0,637
38,6,32,3,11,152798,72814,90,0,486
30,18,12,0,10,1441127,0,1,0,615
20,10,10,0,9,1128786,0,0,0,604
7,3,4,3,8,35323,39952,44,33262,441
31,5,26,2,14,866611,70806,45,83255,447
145,8,137,3,14,33580,31444,61,1367,614
27,5,22,2,14,416592,1620,34,1019,459
7,5,2,1,13,354919,10620,24,10620,508
14,9,5,8,7,194751,51051,289,12402,437
26,8,18,11,6,1137611,1728974,203,879741,394
21,1,20,1,10,4429,3267,48,3267,613
11,6,5,0,12,41157,0,24,512,596
17,6,11,1,13,65087,14013,12,14013,640
24,9,15,9,10,35335,36865,139,6234,433
25,14,11,11,11,1095746,942424,0,0,439
4,2,2,4,7,62047,47637,0,0,488
12,4,8,4,17,28452,96187,14,431,531
27,5,22,4,13,19193,19193,64,10476,387
25,16,9,8,8,201031,55293,133,3349,425
12,9,3,1,26,708048,3290,3,709083,497
7,1,6,0,9,0,0,0,0,732
16,9,7,6,19,109071,110814,101,0,508
9,5,4,3,8,27770,27271,57,13810,552
8,3,5,1,12,22912,5623,29,5623,644
18,2,16,0,5,10399,0,9,2407,598
5,3,2,2,12,12256,8242,32,4197,607
12,7,5,10,10,1411785,865620,167,18536,511
5,3,2,2,10,28052,6752,34,5458,458
8,3,5,2,10,40335,8790,8,2480,490
4,2,2,0,7,16355,0,7,3829,625
22,9,13,7,10,55544,64743,35,13186,417
19,5,14,4,16,27190,26525,291,20048,448
5,3,2,0,17,406498,0,0,0,702
39,12,27,5,15,65401,26159,101,9973,458
7,3,4,3,11,37754,37754,32,1850228,521
38,17,21,9,7,489728,84308,325,8956,416
5,1,4,3,7,2302,10097,17,7076,577
13,9,4,9,7,46139,71414,166,14114,454
21,9,12,3,14,279114,23000,106,17312,487
27,10,17,0,12,351990,0,3,0,709
7,4,3,0,7,5807,0,0,0,651
8,3,5,3,12,29036,17527,41,12590,454
13,7,6,5,17,74786,45864,8,7857,511
49,17,32,5,12,262668,22071,83,11798,419
13,6,7,0,18,369,0,45,294042,484
7,4,3,0,14,355351,0,24,7290,498
8,1,7,0,17,0,0,21,4193,670
13,10,3,0,25,152889,0,2,270,688
6,4,2,0,4,11539,0,0,0,500
10,6,4,3,9,533429,127412,46,0,517
6,2,4,2,8,11826,8832,68,0,515
48,8,40,5,16,569622,34228,48,11337,475
7,0,7,2,9,0,25361,31,0,692
14,5,9,1,16,29399,3249,12,3457,563
7,4,3,4,7,5261,5261,0,0,681
8,6,2,6,10,180142,161916,90,59156,445
16,7,9,7,10,384861,54403,133,27682,426
9,6,3,1,9,7413,197,17,12740,505
4,2,2,0,7,18175,0,0,0,641
6,2,4,2,9,10038,15156,58,10490,474
8,1,7,2,7,0,7911,27,0,641
13,10,3,0,9,151828,0,0,0,557
24,11,13,12,12,881564,679158,205,146942,480
10,4,6,2,12,33696,33696,37,3991,521
8,4,4,2,13,18258,17322,47,11109,487
6,3,3,4,8,9697,13594,63,4789,478
12,5,7,2,9,47601,14415,22,0,497
28,13,15,6,12,49458,18243,146,5995,421
6,4,2,3,8,837664,148460,54,7830,470
8,2,6,3,5,12022,14326,21,7344,415
29,8,21,0,12,674183,0,19,1834,462
22,15,7,11,9,177850,49765,277,21071,437
5,1,4,2,9,11017,22034,41,11017,648
4,1,3,0,8,0,0,0,932,759
11,6,5,7,16,1533930,1078345,145,911542,505
21,3,18,0,8,135630,0,3,11501,624
34,8,26,3,13,16340,17948,252,14509,526
16,6,10,6,16,694322,144212,98,21497,429
46,9,37,4,13,229436,21601,108,6174,418
2,0,2,0,2,0,0,0,0,619
4,1,3,1,12,1858,1858,12,6902,602
4,2,2,0,3,4074,0,36,3416,541
13,6,7,7,8,40120,32400,103,6809,455
5,1,4,1,13,248492,71984,8,0,667
13,3,10,1,9,5766,2351,48,2351,526
9,6,3,3,9,28657,5699,296,3615,503
16,10,6,1,10,234060,3093,24,7024,554
52,11,41,4,14,469370,28719,97,16440,430
5,3,2,2,8,19442,9244,40,3104,513
15,7,8,1,10,323760,25806,26,0,608
5,3,2,2,4,30902,27123,28,1726,455
9,5,4,2,9,56258,21264,9,679,450
17,7,10,0,8,133466,0,1,0,662
7,4,3,2,14,41231,34825,35,828,479
12,7,5,1,69,685451,3409,34,16820,389
13,4,9,0,11,6582,0,10,0,598
10,3,7,3,13,313171,50258,23,46237,400
9,1,8,0,11,8739,0,0,1182,696
22,5,17,7,21,525612,505959,112,13813,457
13,9,4,5,7,239373,42252,34,88,474
5,3,2,0,8,36131,0,11,0,581
18,7,11,3,16,820262,22534,11,0,501
47,13,34,5,8,81556,19145,40,6346,407
21,11,10,4,14,248908,14202,141,6987,494
13,8,5,4,7,1607633,52366,88,23476,424
15,8,7,0,9,1106785,0,200,24720,659
20,9,11,1,20,489691,13246,0,690,520
13,1,12,0,11,527,0,6,0,605
24,11,13,5,18,173321,85692,118,24754,574
11,2,9,2,17,31760,31760,35,1873000,553
5,3,2,4,9,131754,178332,60,1484,457
19,4,15,3,7,7520,672,225,3822,579
6,1,5,1,14,13517,13517,95,13517,580
13,6,7,1,16,34326,2714,2,2714,558
6,4,2,3,7,7044,10055,0,0,441
25,11,14,8,10,20321,20321,86,43330,496
17,7,10,6,10,492415,164417,107,70467,497
8,1,7,0,7,0,0,34,2398,669
10,6,4,0,7,726690,0,9,0,596
32,18,14,4,12,453690,3753,8,102785,470
23,5,18,2,10,47555,9453,10,17423,502
8,4,4,3,9,35459,17087,46,5105,621
33,9,24,5,12,83310,35362,92,8075,440
16,7,9,7,15,34408,33514,85,7925,447
5,3,2,3,6,6658,6658,42,2948,469
13,6,7,6,14,588159,155749,15,3593,508
10,3,7,1,12,254468,5690,3,5690,516
18,8,10,0,12,508709,0,14,0,713
12,8,4,7,7,50170,47429,107,28659,481
8,5,3,1,3,75613,9874,1,9874,535
9,4,5,6,9,34138,94989,68,3906,478
20,8,12,0,21,299219,0,9,1699,640
60,19,41,7,16,936381,356342,295,8820,474
78,6,72,0,14,87513,0,1,3731,688
6,1,5,1,10,8006,4263,64,6240,478
14,8,6,2,13,28635,2165,8,0,558
8,4,4,0,8,12526,0,12,0,636
9,1,8,1,12,289759,1920,44,3640,569
7,3,4,2,5,40506,5012,35,0,546
23,5,18,5,13,27566,14756,40,8417,436
50,3,47,1,12,34038,512,41,1579,577
145,10,135,3,11,19783,14545,119,8862,529
24,5,19,1,9,36426,2294,83,41670,564
9,4,5,0,2,5163,0,0,0,630
20,8,12,4,8,213392,21280,44,12230,475
19,6,13,7,16,43930,95126,71,8490,448
15,4,11,1,12,191596,598,31,71093,608
12,7,5,0,8,205919,0,23,0,520
20,13,7,2,11,467499,426,40,7698,644
25,8,17,1,4,46679,2493,38,2493,458
16,1,15,1,10,0,11963,26,11963,480
9,7,2,6,14,29562,23802,103,2709,502
10,6,4,8,6,26797,31340,103,9237,418
9,6,3,4,16,215091,20608,114,26414,423
4,2,2,1,9,0,3787,20,2304,514
8,4,4,4,5,29810,18561,39,13926,487
10,6,4,3,12,20904,14961,103,6961,526
25,9,16,6,15,437683,22501,58,11024,523
17,9,8,0,9,213534,0,0,0,609
9,7,2,3,11,348274,29384,236,27905,374
10,8,2,5,12,1167916,369424,54,8003,520
25,10,15,9,9,103103,81774,312,17207,411
9,2,7,0,6,3000,0,1,1887,582
18,8,10,8,8,33473,23232,102,956,460
12,7,5,0,15,181864,0,1,571,672
22,6,16,7,7,56720,62309,98,7434,437
12,6,6,4,7,32319,17470,0,0,524
5,2,3,1,14,265989,77170,43,1012,578
10,7,3,3,16,903247,28449,19,12048,470
5,3,2,4,7,2843,8760,40,5917,504
13,6,7,0,6,472663,0,2,1473,547
8,4,4,5,10,13235,8840,101,4990,527
10,7,3,6,6,145576,144899,140,12025,458
47,15,32,7,11,415681,147203,137,60792,423
10,4,6,3,11,71973,17430,118,13242,492
5,3,2,1,15,57532,43187,34,43187,477
7,2,5,2,15,486567,16960,28,0,463
9,1,8,0,9,0,0,14,3292,648
11,6,5,5,8,301407,38739,64,12873,455
10,6,4,1,8,16347,2462,61,0,470
22,8,14,5,17,214403,46122,201,37864,530
21,2,19,2,16,15656,15656,36,15077,543
15,5,10,5,12,487705,177503,1,2800,525
39,11,28,3,13,603890,17917,66,63569,431
11,4,7,3,8,67142,12162,25,0,466
14,6,8,1,12,429574,20006,32,431,564
14,8,6,0,1,70598,0,0,0,630
7,1,6,1,9,0,16050,0,0,506
34,4,30,0,12,33255,0,36,800,679
14,11,3,1,13,815211,1147,8,1147,505
38,6,32,4,10,175800,197819,308,117990,492
10,5,5,0,9,645008,0,0,0,642
12,8,4,3,9,125154,1055,22,593,528
31,5,26,3,8,43386,40279,81,9170,527
9,5,4,1,7,109408,10271,11,10271,436
11,4,7,2,9,50648,50648,123,14415,529
10,4,6,5,14,354283,128974,124,75656,584
15,5,10,6,13,218268,265896,115,890,498
11,8,3,2,10,495876,4140,8,0,692
7,4,3,2,8,185558,17446,1,4936,470
16,6,10,0,3,16038,0,0,0,671
16,9,7,2,14,1179815,19649,6,0,470
19,4,15,7,11,61340,96050,141,22535,466
10,7,3,1,15,245723,5294,6,5294,564
7,5,2,2,15,439243,167682,42,149666,532
14,5,9,8,10,56215,102159,178,18915,416
8,6,2,2,8,23468,17632,45,8816,535
15,4,11,1,14,17737,179,5,2500,488
9,6,3,6,13,694159,68679,55,28062,450
11,6,5,0,9,206574,0,25,668,644
8,3,5,0,10,28051,0,5,0,525
24,9,15,4,15,138448,22417,21,7893,532
23,6,17,3,15,196261,172062,0,3159,683
6,3,3,2,11,10862,1808,46,4383,615
32,9,23,7,15,938436,119651,220,74706,430
11,7,4,6,12,56219,35415,210,13043,424
15,6,9,0,12,114968,0,0,0,696
48,19,29,2,29,1146188,1179,177,12827,506
9,3,6,3,7,32293,30759,0,0,515
6,2,4,2,8,12252,11981,53,3823,446
30,4,26,0,8,70124,0,318,1393,474
15,10,5,13,7,574477,540160,111,128253,388
48,5,43,2,12,56647,16494,149,12817,469
24,9,15,8,9,49112,16595,86,1813,494
4,2,2,2,13,928,600,42,398,528
15,6,9,7,9,61889,65343,54,19486,455
41,9,32,0,19,141719,0,14,5656,573
22,4,18,2,13,31280,5400,25,2731,501
8,6,2,3,17,359595,34135,68,12992,395
26,5,21,6,17,69971,69971,137,37297,450
21,8,13,1,15,570268,86,7,93,460
10,8,2,1,6,205455,684,6,1615,548
19,14,5,0,15,432560,0,0,5857,651
14,4,10,1,16,33057,568,2,2810,420
15,6,9,5,12,296163,59933,97,5143,447
30,6,24,5,17,25837,25837,143,11592,463
48,5,43,3,9,482674,155769,118,3800,529
19,13,6,3,16,770585,35360,50,0,450
14,10,4,8,5,31110,23614,303,8981,427
19,2,17,2,11,13398,9548,55,5168,620
17,10,7,2,14,661001,66558,4,65435,475
12,5,7,4,16,700454,31417,11,1631,465
14,4,10,0,10,16319,0,11,140,609
9,3,6,2,19,58867,28605,9,6235,467
33,13,20,5,22,367704,770,30,1980,587
22,10,12,9,9,40770,37884,408,11283,425
66,12,54,5,9,39678,42646,126,12423,521
36,11,25,6,9,81731,24967,448,8096,504
23,10,13,4,16,151796,61733,41,19754,472
10,3,7,6,5,201576,179624,69,0,543
7,4,3,1,8,11519,6465,44,0,562
8,4,4,2,19,29499,18533,36,15307,435
6,1,5,2,10,34980,34980,41,0,517
28,5,23,3,9,16238,9811,122,7286,455
21,5,16,1,10,62309,3680,30,9970,499
31,3,28,0,11,196997,0,0,0,642
6,1,5,3,17,2106,19080,23,876,521
8,5,3,0,15,318970,0,0,7256,678
11,6,5,8,5,61856,18913,15,3881,488
14,3,11,3,11,22285,22285,131,11751,498
24,14,10,4,13,379372,42937,49,8510,520
14,10,4,3,9,72794,5025,46,1624,483
7,3,4,2,14,14323,32551,41,450,546
7,4,3,2,9,20016,889,23,605,606
9,1,8,3,7,1314,18598,38,58443,493
13,2,11,1,12,3263,366,97,2890,620
17,8,9,8,10,38321,38278,143,12605,427
5,3,2,2,13,16208,11936,13,10694,548
24,10,14,6,14,263048,50536,204,29007,447
13,6,7,3,20,711344,44324,87,32744,447
14,1,13,0,6,1000,0,0,0,609
58,15,43,5,18,864088,92210,142,23961,500
35,6,29,4,13,66920,30750,110,5808,514
9,7,2,7,8,33618,40865,87,10191,515
28,1,27,1,6,5297,5297,0,0,465
26,22,4,2,10,1620532,1349,0,0,508
49,20,29,4,19,1037985,15219,85,8534,420
27,6,21,6,18,54511,23406,187,11540,495
7,3,4,0,8,21904,0,0,0,567
10,6,4,7,12,11368,16716,99,2756,503
21,9,12,8,12,405355,36183,262,12434,442
23,11,12,5,17,67713,23351,90,2806,460
97,5,92,2,13,422972,81473,25,16299,433
18,5,13,4,18,58212,13787,50,6566,444
12,9,3,8,21,304867,84010,0,0,488
10,4,6,2,16,114929,29003,190,29013,538
5,3,2,1,7,9426,1141,27,3934,454
12,7,5,8,5,33109,50355,54,3581,515
11,6,5,2,19,763330,296864,33,261,496
35,20,15,5,16,98807,50584,60,10338,439
5,3,2,3,15,53389,13221,38,0,556
25,10,15,6,15,2034957,66051,78,1126,432
18,6,12,4,6,78066,28722,121,4536,477
89,25,64,6,28,854296,3288,233,1599,426
18,7,11,0,3,98201,0,12,314,496
11,3,8,3,9,26156,52249,98,26093,606
7,4,3,3,3,84601,17978,11,0,409
12,8,4,0,9,195717,0,0,0,617
8,5,3,1,10,8307,1560,14,248,442
19,6,13,5,11,194986,478784,69,0,470
24,14,10,9,9,211590,193121,125,111431,404
5,1,4,1,14,0,9402,20,0,608
11,3,8,1,7,30261,5000,40,555,524
5,2,3,2,8,502034,145248,41,4876,522
7,3,4,0,9,26479,0,36,0,489
8,5,3,2,6,17121,911,66,5366,483
29,11,18,0,13,147617,0,0,0,698
12,10,2,8,10,132465,100970,209,9792,499
6,3,3,4,9,13927,22938,76,9053,616
19,9,10,0,9,1217108,0,44,0,573
4,2,2,2,9,15314,21661,4,15314,601
12,4,8,5,20,555722,116462,44,95804,489
19,8,11,5,16,675702,25923,65,11420,409
26,9,17,1,16,165312,42851,54,14095,544
16,6,10,1,11,84407,10319,56,76,443
12,3,9,4,12,6953,23481,0,3160,531
24,11,13,6,15,972672,525371,78,1259,474
47,12,35,12,11,168479,130169,175,24730,420
8,5,3,3,14,32350,31910,142,36100,495
7,4,3,0,9,23783,0,0,1456,644
7,5,2,5,5,228591,36535,61,5043,404
36,18,18,0,14,108288,0,79,2906,511
17,11,6,2,10,260400,2740,33,2480,497
40,6,34,4,8,15646,10548,340,14069,451
6,3,3,1,8,12293,6189,28,6303,395
17,10,7,0,12,462505,0,0,13543,667
8,4,4,3,8,39803,39803,149,17758,529
38,5,33,2,16,11353,7160,32,3902,494
9,7,2,8,4,56000,67014,107,29933,449
59,28,31,18,16,8501040,642370,68,112167,400
3,1,2,0,2,8061,0,0,0,615
9,5,4,4,15,434150,96335,78,3554,544
16,9,7,1,18,807665,1150,11,0,562
5,3,2,2,15,90402,97598,15,90402,629
24,10,14,0,14,599167,0,8,2134,517
9,3,6,1,4,23602,2320,2,661,599
18,12,6,1,9,183067,971,21,971,466
19,6,13,0,11,90028,0,0,738,542
9,3,6,0,10,0,0,30,18484,529
50,16,34,8,14,160346,131182,28,9696,489
8,5,3,6,12,17467,26618,97,6796,530
9,7,2,5,8,114696,17849,51,4212,492
13,4,9,1,6,41547,328,23,12000,588
15,12,3,10,12,50185,50455,155,11888,439
16,6,10,4,5,41702,4999,74,4336,464
27,14,13,1,12,1970796,13016,9,13016,559
8,3,5,2,13,322104,21881,104,18318,433
11,3,8,0,6,1711,0,3,1263,677
16,7,9,0,20,337374,0,0,464,631
3,1,2,0,12,0,0,0,400,663
25,3,22,2,12,7771,7771,20,892,550
14,6,8,4,14,35963,35963,32,16432,487
36,9,27,3,14,179170,66288,75,30750,527
10,3,7,2,8,133593,7594,27,0,545
30,7,23,9,8,73832,96925,148,31574,415
6,3,3,4,6,7896,10852,65,1970,521
5,3,2,3,12,345002,10883,32,8320,429
24,2,22,2,5,19151,16251,34,2135,456
22,5,17,4,6,394217,54309,101,607,508
9,5,4,1,6,167544,6081,25,0,503
23,16,7,9,10,889137,186142,4,1275,439
5,2,3,0,7,20343,0,3,522,580
37,13,24,11,7,40324,17675,122,2014,434
20,12,8,0,30,93817,0,13,427,590
16,8,8,3,12,239713,4122,103,3898,568
30,11,19,2,12,267008,4774,60,18974,564
19,7,12,3,9,363071,28149,230,27379,512
16,3,13,2,7,7659,12149,62,0,516
12,6,6,4,12,303396,24541,29,4902,423
23,12,11,5,17,802794,115579,64,45267,493
16,10,6,1,4,121076,3125,20,224,464
19,9,10,2,11,469562,2259,31,0,493
14,6,8,6,12,65143,31820,0,0,640
7,4,3,6,8,19875,34910,107,2409,438
10,5,5,0,10,13006,0,1,2493,492
20,5,15,5,14,32958,29775,64,9596,496
39,3,36,1,8,36470,1638,127,983,520
28,11,17,7,13,575054,247960,108,1070,522
17,9,8,4,11,52923,50418,89,0,589
7,4,3,2,8,6268,9295,37,0,574
14,8,6,9,5,110024,81493,58,56666,440
18,13,5,10,14,788447,394160,10,64722,498
10,3,7,3,15,1051970,263482,80,0,572
5,3,2,1,12,8674,3395,11,3395,533
16,8,8,4,12,74742,8928,151,11064,459
4,2,2,1,2,26108,2160,50,2241,443
7,4,3,1,7,17082,10912,0,0,545
18,1,17,1,11,698,698,1,2181,481
31,5,26,2,8,28043,2079,26,1188,517
15,8,7,5,4,16742,13372,31,972,449
16,4,12,2,19,34210,34210,134,27790,513
61,13,48,5,14,918287,197961,52,0,486
8,4,4,0,5,63597,0,2,781,619
5,2,3,1,7,14015,14015,35,0,491
18,10,8,5,11,116657,26823,19,5995,466
44,6,38,6,10,162716,173369,95,46303,534
9,6,3,4,13,50270,16252,24,11485,388
15,7,8,8,11,176435,235014,93,962,470
11,8,3,3,35,284159,188076,79,7524,533
33,10,23,0,21,86174,0,0,3520,635
9,5,4,4,13,16431,13672,179,11127,448
5,3,2,0,3,24550,0,2,2211,564
24,7,17,5,14,50553,50553,52,3700,436
7,5,2,4,12,157191,157191,66,71581,444
24,8,16,9,9,99526,103201,499,20377,491
22,13,9,1,14,840668,784,0,1344,556
25,8,17,10,17,372068,239905,427,115534,425
9,6,3,1,6,74102,5864,59,0,464
4,2,2,2,9,5509,5509,43,1890,509
20,5,15,3,12,7747,5147,78,2371,435
9,7,2,6,13,35521,35521,42,27342,451
11,5,6,4,15,48821,78989,60,2722,474
7,3,4,0,9,11232,0,0,2384,660
25,12,13,12,13,3179766,2740464,0,20,447
3,1,2,2,4,10787,10787,0,0,488
6,3,3,3,9,12887,12886,66,7070,431
4,2,2,1,6,2985,423,35,0,562
20,14,6,13,9,198840,224284,97,39704,397
32,6,26,6,10,178841,115087,109,83409,431
30,7,23,11,17,143666,204633,189,14397,436
13,7,6,0,3,43219,0,1,449,606
15,7,8,2,10,911836,29387,52,2985,616
16,4,12,2,10,31850,30250,120,48110,637
7,4,3,1,8,148461,5456,8,0,512
31,7,24,6,10,26616,12621,95,4456,417
3,1,2,0,11,1303,0,0,0,555
18,6,12,3,11,345049,7584,215,6423,512
29,7,22,5,17,7593,10929,67,6509,464
7,3,4,3,14,108734,108734,7,1879,509
48,11,37,8,15,693358,487452,25,0,489
11,2,9,2,16,3565,5489,10,3565,439
110,8,102,2,9,107660,21620,31,15221,533
5,2,3,2,11,14947,14947,32,13147,568
14,9,5,0,7,321879,0,13,0,466
13,3,10,2,10,27911,125268,17,0,615
35,14,21,3,18,237603,12505,33,7153,571
15,10,5,5,13,417921,9510,0,0,474
15,4,11,1,8,153702,16367,36,0,621
9,5,4,3,17,31849,484,42,3339,474
9,3,6,2,3,10260,5806,2,3925,528
7,4,3,2,13,387084,22208,69,24007,512
10,7,3,0,7,46045,0,0,0,580
15,6,9,5,9,61331,17468,169,1380,459
6,4,2,3,8,17557,7032,43,0,418
9,7,2,7,9,12891,16538,19,3463,415
6,1,5,1,7,10773,3793,25,0,509
8,4,4,3,5,392177,30093,13,27335,513
13,7,6,4,11,279862,29631,100,13641,439
6,3,3,1,14,162687,162687,27,80,645
6,4,2,4,7,21964,21964,43,4375,473
22,6,16,7,13,296088,433181,183,126244,423
7,4,3,5,11,540342,103319,77,50969,470
11,5,6,0,11,21092,0,7,0,545
2,0,2,0,11,0,0,0,0,613
18,2,16,2,9,2757,32433,35,30767,662
10,2,8,0,5,9038,0,0,2945,613
4,2,2,0,4,12787,0,0,0,661
5,3,2,4,7,26759,26759,85,9842,536
46,12,34,8,9,69117,54439,291,15485,487
18,4,14,2,13,27185,36722,70,21695,644
4,2,2,1,12,8379,8379,21,3531,522
11,7,4,3,6,112181,24886,71,12223,407
3,1,2,1,11,12436,12436,31,12436,571
13,7,6,1,10,52751,33359,41,33359,478
19,8,11,6,17,379172,90115,11,15688,423
9,2,7,3,15,213817,47257,9,16215,620
17,3,14,4,19,60447,59006,26,5826,421
20,12,8,10,14,192620,177898,202,21014,427
12,8,4,2,18,145916,90523,41,72859,452
7,5,2,4,11,21350,14071,38,10147,406
14,6,8,0,8,1390,0,15,3648,590
13,3,10,0,11,18835,0,1,2065,502
5,3,2,3,14,168626,12561,15,5842,513
11,9,2,0,25,339989,0,2,470,668
38,6,32,0,11,183875,0,3,3173,589
5,2,3,1,12,23101,14620,5,14620,596
34,6,28,1,11,499855,4751,13,25323,478
26,15,11,0,13,225569,0,5,0,522
20,10,10,1,13,343975,30792,25,30792,510
3,1,2,1,11,4583,4583,12,4583,420
15,6,9,1,11,229633,2047,28,2047,630
58,8,50,2,16,103322,12964,33,8840,657
233,7,226,1,10,117466,6391,0,2130,672
8,4,4,0,6,54009,0,0,0,651
12,8,4,7,12,58605,54351,127,29480,455
17,8,9,2,17,64649,24824,49,0,507
112,14,98,4,16,520596,6225,46,3415,626
9,7,2,3,16,332029,158520,50,4855,480
56,13,43,8,14,899052,50209,27,10092,424
76,13,63,4,9,109480,49069,199,31011,506
22,14,8,2,18,454322,3057,35,881,577
6,3,3,4,8,52437,72992,95,0,615
29,9,20,2,8,289789,13039,58,33700,557
36,6,30,7,11,57320,150540,109,7601,485
14,5,9,1,3,16871,1301,22,237,623
16,4,12,5,10,50502,40762,299,36173,507
9,4,5,4,9,30014,38081,76,12843,425
23,14,9,3,13,1084785,29750,40,8725,444
5,1,4,0,7,329832,0,55,0,641
21,8,13,4,38,61249,14992,58,4970,551
10,2,8,2,8,0,1579,56,1165,631
6,1,5,3,4,6683,15499,45,0,474
25,10,15,11,9,263613,322320,30,93349,442
13,6,7,1,18,386763,1313,35,1166,557
7,5,2,1,9,12608,1134,24,2051,527
8,4,4,4,7,499582,14328,52,0,523
40,10,30,0,13,700399,0,9,0,578
14,3,11,4,7,25932,29396,293,12921,442
19,11,8,0,12,532279,0,0,0,651
10,2,8,5,16,652036,220295,85,0,482
6,0,6,3,9,0,36675,78,0,518
11,4,7,3,14,0,219111,80,709,487
15,6,9,4,7,428134,64676,56,7901,418
24,10,14,4,9,64071,6284,133,3265,382
7,5,2,0,7,235501,0,1,0,623
34,3,31,0,10,13498,0,9,1481,637
9,3,6,5,8,96013,123920,87,31693,482
36,7,29,1,8,92086,11848,32,0,599
31,14,17,1,22,530627,253,19,47915,547
8,4,4,3,5,61160,61160,40,9618,494
8,4,4,2,6,17041,13405,42,9724,538
7,4,3,0,5,7652,0,1,2324,624
18,13,5,2,19,153830,1942,7,971,538
12,9,3,6,8,35097,26846,112,9143,466
41,10,31,9,13,87855,196958,40,34170,497
5,1,4,1,7,10432,10432,17,10432,644
32,17,15,0,10,204890,0,28,1766,643
23,8,15,6,11,438191,28647,148,18001,462
17,7,10,0,12,28114,0,1,272,525
43,11,32,6,14,748677,35985,50,19823,418
4,2,2,1,12,3475,3475,24,3475,667
60,12,48,2,16,112667,12701,91,4680,522
10,5,5,4,6,19172,4887,64,29831,519
118,8,110,2,25,27029,9979,38,8085,559
31,18,13,2,14,1103898,4855,37,2213,475
26,9,17,0,17,50709,0,0,209,593
18,12,6,5,14,520786,7000,113,1052,453
13,9,4,0,9,655315,0,0,0,589
15,8,7,10,13,26453,53315,164,13163,474
30,12,18,12,16,289466,52152,153,11730,527
6,4,2,3,8,16411,16411,3,10047,523
20,8,12,0,5,34466,0,4,0,619
34,11,23,8,10,69013,48889,404,17585,559
8,3,5,2,8,6228,5738,113,1515,524
47,10,37,4,13,128377,38603,125,15184,447
11,6,5,1,11,49308,1380,65,10740,480
7,5,2,3,11,52610,61240,63,2384,509
25,10,15,0,9,263961,0,57,7200,583
2,0,2,1,11,34222,34222,9,8941,593
29,20,9,3,16,2524749,79898,64,0,496
15,8,7,2,7,399104,6353,27,2025,576
47,12,35,7,12,81316,38236,73,10440,441
27,10,17,11,13,1017115,386900,200,76753,430
12,5,7,5,7,27894,29936,120,11093,453
6,2,4,1,7,8307,8307,38,1500,541
16,9,7,2,12,89778,994,28,933,522
8,1,7,3,13,23471,42574,2,443,552
14,4,10,4,10,33922,19028,72,8694,481
6,4,2,1,9,36280,4330,23,4330,583
17,11,6,6,19,106946,105800,95,43635,510
11,7,4,2,7,243076,157892,18,351,504
20,7,13,2,7,119244,270,170,818,532
8,6,2,0,9,48220,0,3,0,638
11,4,7,3,14,31214,47136,4,3044,466
9,6,3,0,7,180295,0,0,0,545
22,13,9,1,14,480547,2796,12,0,586
10,3,7,1,14,6525,10812,34,1128,672
9,2,7,2,8,30625,17250,91,37537,453
11,8,3,0,15,245357,0,0,4879,677
21,15,6,9,8,280689,152347,107,397,509
19,9,10,8,8,34051,30217,387,20423,430
39,8,31,0,8,52870,0,0,0,528
41,10,31,7,17,48540,39840,46,14540,518
23,4,19,1,16,219460,3998,46,23535,522
42,12,30,6,39,160840,40703,97,20833,474
18,7,11,0,19,393325,0,5,140,623
6,4,2,4,5,5184,6432,14,3462,519
6,2,4,0,7,17976,0,23,1510,637
16,13,3,3,8,363226,8450,21,0,537
25,6,19,2,8,45452,13960,23,4009,480
11,7,4,9,7,77644,68213,91,23189,556
11,4,7,4,20,91734,105959,108,967,587
12,6,6,2,13,31145,2074,41,1375,556
14,11,3,2,30,47377,9616,23,9374,395
7,2,5,3,8,11823,18739,7,10776,501
23,7,16,8,12,46105,51759,120,17641,433
18,7,11,6,9,431927,76380,4,196,452
38,12,26,7,10,53574,21300,458,11376,413
12,5,7,8,10,83499,141021,163,3800,449
20,17,3,1,8,119626,119,5,1041,624
5,1,4,1,15,37364,1922,9,1922,513
6,1,5,2,4,3699,3432,0,0,516
10,4,6,0,7,160443,0,2,613,700
16,7,9,0,8,190563,0,1,0,618
21,9,12,6,8,411617,32657,313,12704,451
15,10,5,7,5,414732,32507,296,7167,433
9,5,4,0,14,237992,0,13,2034,667
7,3,4,0,10,28861,0,2,3059,472
60,23,37,9,34,280937,67435,154,8608,586
195,12,183,8,8,140585,89542,78,45720,475
20,4,16,4,8,19189,19189,79,10200,454
5,1,4,1,17,0,121413,41,0,668
38,9,29,7,6,200835,122193,64,2552,451
8,2,6,2,7,3613,3275,39,1870,522
27,6,21,0,2,26099,0,0,0,562
25,10,15,2,15,338281,224,4,0,583
17,8,9,4,13,97373,70856,32,36266,447
20,11,9,0,16,781751,0,3,0,693
6,2,4,3,5,10319,30046,38,4056,451
10,5,5,5,13,66615,66615,63,21999,523
53,51,2,5,16,2679256,33133,173,3837,522
4,1,3,0,18,22930,0,0,0,634
15,8,7,0,12,230440,0,26,8044,555
14,10,4,3,10,107032,4804,0,0,466
9,3,6,1,10,319680,26783,6,26783,504
12,9,3,9,20,101454,139017,108,44821,537
15,7,8,3,19,12294,31283,37,12004,446
6,4,2,5,9,40277,51925,16,8874,513
16,7,9,10,14,591833,774917,159,232576,480
14,7,7,6,7,37930,55520,96,0,439
10,8,2,2,5,192507,38608,57,1000,486
81,10,71,10,7,84341,56468,194,16444,414
17,7,10,4,12,19160,27942,32,4640,486
16,7,9,3,8,51645,40956,102,21180,517
10,5,5,4,15,29204,13460,36,4811,433
12,2,10,1,16,4231,16998,76,21244,621
19,15,4,0,9,877268,0,0,160,612
109,10,99,0,8,104636,0,26,0,546
15,10,5,3,14,452305,188118,34,1638,459
12,6,6,4,15,29546,21406,163,12358,446
10,5,5,3,8,398678,25483,27,0,524
28,9,19,0,11,37457,0,5,106,572
5,3,2,3,11,25837,25837,47,10098,455
15,13,2,0,12,893012,0,8,251,628
8,3,5,2,10,483018,120960,0,0,488
16,5,11,5,13,668092,64622,43,29758,508
9,5,4,4,7,28074,10705,93,8782,536
16,9,7,5,4,212408,168267,115,11021,455
7,5,2,1,20,48688,349,49,349,640
9,7,2,0,8,315127,0,0,0,563
18,7,11,0,17,358254,0,2,3123,506
28,9,19,4,36,306850,609502,116,0,523
5,3,2,2,5,13887,3970,32,2125,514
30,9,21,6,9,352740,281776,0,0,495
7,4,3,1,6,9386,6530,209,7430,456
24,8,16,3,8,84083,4842,2,591,488
23,9,14,1,10,477040,5631,4,5631,511
29,21,8,0,32,817739,0,10,0,551
32,6,26,12,15,209538,312393,165,12873,431
15,1,14,0,7,9029,0,0,0,682
13,11,2,6,12,132133,97394,46,47251,454
19,8,11,5,9,68352,58465,92,37102,427
10,5,5,3,10,46432,29881,94,9356,526
6,3,3,1,14,379986,9261,10,9261,506
8,3,5,3,9,11373,9043,196,3773,528
9,6,3,7,5,330650,54132,118,10377,484
8,2,6,0,11,161969,0,64,32779,698
13,8,5,1,8,719706,15968,24,15968,594
28,15,13,14,16,466732,372207,181,5408,578
28,11,17,2,6,396313,5610,33,34294,525
31,6,25,2,13,79367,8394,28,13870,643
7,5,2,6,11,28579,42254,103,0,481
9,1,8,1,10,4999,4999,17,314,507
12,4,8,3,3,22952,4934,75,5600,432
30,10,20,10,9,45701,39711,263,7898,477
22,9,13,9,21,120119,82297,417,14880,536
15,4,11,1,8,12613,9286,24,9286,532
3,1,2,1,6,9320,9320,24,9820,536
15,8,7,4,16,973714,128331,70,2651,457
10,6,4,3,21,3015,1596,36,940,516
32,5,27,1,7,202555,8496,23,0,490
4,1,3,0,21,252713,0,7,399,678
12,7,5,4,8,354512,17436,50,3250,474
16,8,8,3,9,14275,9004,315,6437,462
9,4,5,0,3,19521,0,37,740,587
44,11,33,2,15,498204,2604,27,21561,444
10,4,6,3,13,558606,27187,45,14173,482
24,16,8,0,8,889684,0,4,0,587
30,15,15,5,10,846514,8718,15,8206,469
16,6,10,0,10,163114,0,0,0,614
170,6,164,4,11,307677,49390,117,8784,537
5,2,3,3,10,31281,51766,34,29208,504
34,12,22,5,8,419283,36056,104,9558,493
6,3,3,3,3,5514,3535,18,1922,456
9,5,4,7,8,43378,57982,0,0,447
30,15,15,7,10,71635,62630,121,23170,420
9,7,2,5,9,33173,28092,250,17661,477
10,6,4,1,16,329855,451,23,550,609
38,16,22,1,16,735784,92,36,25,512
5,2,3,1,7,19239,5379,5,0,470
10,6,4,3,8,529964,156969,79,40284,480
12,8,4,3,19,151692,80678,28,1614,471
24,15,9,9,9,272794,83073,171,18263,469
4,2,2,2,7,12939,9156,55,12070,440
5,1,4,0,13,0,0,0,0,637
17,14,3,0,13,837593,0,8,975,598
9,2,7,0,13,1300,0,105,3451,605
26,7,19,2,18,700834,46320,8,5276,500
59,37,22,38,16,976031,1465033,821,293638,408
13,9,4,8,13,374799,80990,138,30575,390
8,5,3,1,1,926422,1135,1,0,537
16,6,10,6,12,43391,43768,173,14086,381
17,8,9,1,14,508394,12664,40,12664,512
6,4,2,0,12,6201,0,15,247,532
43,5,38,1,16,148046,4229,59,4729,532
12,9,3,5,9,202379,76501,30,9616,499
10,1,9,2,16,4092,4092,5,3751,644
7,4,3,5,12,37264,43622,157,19934,498
11,3,8,1,7,7063,5119,45,0,553
11,2,9,2,7,36955,30154,35,20355,562
46,11,35,7,15,120316,60134,189,15360,488
15,5,10,0,12,86348,0,20,0,535
13,9,4,8,15,172241,97923,109,74277,424
11,4,7,3,13,13028,19746,39,0,486
18,3,15,0,5,24201,0,1,1868,655
12,3,9,1,12,25984,19465,101,1092,492
27,6,21,0,14,234748,0,21,1118,523
11,2,9,0,9,16530,0,13,6375,633
9,2,7,0,15,0,0,2,1155,632
12,7,5,4,7,77755,97193,61,0,517
29,5,24,1,7,62739,4882,16,4882,485
14,6,8,4,13,600701,72448,51,56383,452
5,3,2,1,11,7484,6869,30,0,520
9,4,5,2,8,28421,3615,0,0,492
11,5,6,8,6,276461,347083,0,0,498
20,6,14,0,10,686622,0,24,0,528
7,5,2,5,9,37307,42926,0,0,473
20,10,10,0,6,98149,0,31,250,579
11,6,5,4,7,59498,18233,9,12584,466
25,5,20,2,14,40224,35723,52,2440,447
12,5,7,0,6,193642,0,25,0,628
7,5,2,3,7,8117,4525,12,1643,534
17,8,9,3,12,408905,23529,42,230,509
13,1,12,1,7,9153,8936,179,8936,622
11,9,2,2,11,310019,12748,59,1315,557
34,15,19,8,7,140940,70630,175,3905,498
16,8,8,7,6,94705,6167,163,2079,408
4,2,2,1,8,2786,2786,10,5368,533
13,8,5,2,6,249504,10434,54,1225,489
23,8,15,2,69,224732,6935,11,1486,444
17,4,13,1,11,323684,930,13,930,481
19,13,6,4,13,284522,46955,153,1494,450
13,5,8,4,11,52029,18804,72,0,520
12,7,5,1,12,394075,2989,18,3232,454
7,5,2,0,4,16442,0,0,0,544
14,8,6,8,15,57504,46823,129,11183,386
14,8,6,4,17,26971,22746,63,6241,451
17,7,10,8,6,33367,37902,106,8240,417
65,15,50,2,11,215268,26565,49,29488,462
5,3,2,0,8,6107,0,2,2000,681
18,7,11,1,8,61009,1197,55,633,541
9,3,6,3,20,13168,11056,94,7538,535
14,9,5,6,10,353916,21100,180,15328,502
12,1,11,0,8,0,0,6,6794,674
8,2,6,1,11,17045,6670,25,0,548
34,9,25,3,15,326098,22431,70,3679,497
23,13,10,8,8,518609,80175,94,44369,407
34,7,27,3,15,41485,27143,44,1124,577
12,4,8,2,6,3320,8338,64,6838,468
21,14,7,7,12,23242,23241,159,3375,442
6,2,4,1,7,65540,4145,0,0,453
35,17,18,9,20,204151,119791,106,8202,405
14,4,10,3,15,204827,13968,11,2840,436
9,7,2,6,6,109264,67328,0,0,472
49,22,27,6,29,1396096,775893,2,656957,505
4,0,4,0,7,0,0,20,2087,595
5,2,3,0,3,13265,0,0,0,607
12,9,3,0,9,52936,0,6,0,541
6,1,5,2,13,310437,304640,0,0,524
12,10,2,8,6,113146,103428,150,12128,483
25,8,17,6,10,96193,54670,177,10919,422
5,1,4,0,10,0,0,0,191,664
9,6,3,0,7,316477,0,23,637,596
13,4,9,3,9,355685,16441,54,2053,534
12,7,5,0,8,79138,0,8,423,595
19,3,16,4,7,56171,65125,59,43756,519
21,13,8,2,9,541981,2282,42,3228,543
21,9,12,2,14,325442,4330,89,582,471
58,9,49,3,13,424340,12661,25,13014,520
6,4,2,3,8,10104,2420,19,1493,426
10,5,5,7,8,145055,146786,106,70776,454
18,3,15,0,10,2165,0,31,1520,548
26,8,18,0,13,242417,0,1,10457,559
9,7,2,3,14,69275,67932,60,6147,426
20,8,12,1,10,351267,498,21,0,488
31,8,23,2,22,539612,99347,14,13302,474
35,17,18,1,10,1171649,4971,7,378,586
37,17,20,0,32,1553474,0,10,0,511
50,13,37,13,14,408139,118995,118,8776,474
8,3,5,4,12,8102,22338,75,7221,452
44,14,30,5,14,269421,135397,63,62793,455
21,5,16,4,15,50503,66879,179,35176,396
25,6,19,0,15,137164,0,64,8320,538
24,6,18,3,12,39847,29101,46,16084,495
18,8,10,0,13,797668,0,0,0,604
11,4,7,0,10,37490,0,0,0,645
9,5,4,1,5,18924,732,10,0,531
11,3,8,4,14,17700,17700,25,9942,462
5,2,3,3,8,7063,8919,22,3905,504
17,6,11,2,6,522012,14308,44,0,517
11,2,9,3,10,14007,5430,50,4167,483
15,5,10,2,11,61926,10893,19,7907,498
24,11,13,5,7,61804,7002,174,4123,433
60,3,57,1,9,502329,720,5,4837,563
7,3,4,2,8,50805,21556,39,8917,507
7,1,6,1,5,8729,8729,96,8729,626
12,6,6,2,16,514771,19413,39,1293,485
13,5,8,0,16,818381,0,58,64209,389
17,8,9,4,9,36662,20746,33,4596,415
4,2,2,1,23,177495,177495,1,177495,577
19,6,13,3,13,79681,11612,8,8172,424
11,6,5,7,14,51309,64566,121,21881,424
10,4,6,5,11,19638,36647,81,17092,551
6,3,3,2,11,14448,14448,0,0,500
39,20,19,8,13,3174835,936982,70,4975,467
31,10,21,6,19,382407,67216,107,38888,453
15,1,14,1,14,0,1486,21,4112,641
20,4,16,3,8,21706,16806,147,16692,528
23,11,12,5,9,297820,87965,96,39631,437
7,2,5,3,7,9051,14328,0,17705,545
12,9,3,5,6,829165,387618,39,839,472
39,6,33,1,14,562458,1061,44,2052,510
39,12,27,5,12,51383,55818,79,4973,494
11,8,3,0,11,172228,0,9,1506,500
11,7,4,3,13,170222,68802,43,0,516
5,2,3,1,14,18809,9783,34,9783,480
12,3,9,4,6,57715,45661,64,0,491
24,7,17,0,9,31819,0,12,209,631
57,18,39,0,10,1311851,0,90,3212,646
19,8,11,1,15,173899,35328,21,1243,580
16,11,5,0,9,4229280,0,1,0,632
23,6,17,5,10,566484,65992,44,31269,427
85,15,70,18,15,352748,412295,576,104673,410
88,13,75,7,10,230378,74507,375,3259,446
13,2,11,2,8,9499,9499,47,17334,574
12,6,6,0,10,321711,0,12,0,460
14,7,7,3,11,162684,41208,80,2447,486
10,3,7,0,8,21342,0,0,0,587
16,7,9,1,13,35835,16064,21,701,639
15,9,6,10,8,559676,231787,134,140714,454
24,3,21,0,11,4500,0,29,6077,507
24,9,15,2,6,71801,10525,150,5261,472
39,8,31,4,8,35428,21423,27,7051,454
7,5,2,5,5,25431,32925,38,10883,447
11,9,2,8,6,26428,44030,199,4375,462
30,1,29,1,8,14639,14639,23,14639,607
13,8,5,3,13,89622,88572,73,52468,483
6,4,2,0,8,4906,0,6,520,539
17,2,15,1,8,7187,459,20,1855,610
11,6,5,5,7,292940,166591,0,0,499
17,7,10,4,11,307440,54410,70,1690,525
22,5,17,2,9,258557,14695,33,1744,474
12,4,8,3,14,382943,46069,135,61257,493
9,4,5,3,22,15252,14775,65,4600,492
10,3,7,2,14,74336,55583,44,5411,649
27,12,15,5,13,302739,67943,46,9925,456
26,4,22,1,10,48333,8422,5,8422,443
9,6,3,3,11,29477,36857,31,26517,571
7,5,2,3,11,239289,15300,72,886,495
11,5,6,4,11,61501,52416,0,0,521
10,8,2,3,17,287311,13409,47,5807,468
9,7,2,5,6,61197,7615,94,3811,487
21,13,8,11,18,259711,229020,164,4961,434
4,2,2,1,11,11179,15534,0,0,628
15,8,7,6,28,364292,8099,40,2333,419
12,3,9,2,14,33675,33675,54,1169,504
18,4,14,4,13,19903,19245,70,17119,462
25,15,10,1,9,274185,16376,73,2544,460
22,11,11,7,19,194774,31828,45,7560,508
52,15,37,9,17,465484,271126,83,11410,446
31,6,25,1,20,68245,14115,66,14115,428
12,9,3,8,23,40691,18425,259,7475,417
8,4,4,7,10,160910,275168,125,42567,434
13,5,8,2,8,13118,1840,27,5621,423
3,0,3,3,5,33291,33291,75,0,571
10,6,4,5,8,12748,15709,15,1798,405
6,3,3,0,17,20535,0,1,237,576
5,2,3,0,17,41896,0,14,3287,649
87,9,78,6,13,19872,15716,332,6041,482
5,2,3,2,14,6418,6496,11,4014,532
2,0,2,0,3,0,0,0,0,663
20,10,10,2,16,254507,23005,6,14940,539
20,5,15,5,13,45755,23391,107,14432,466
9,5,4,0,7,1372256,0,0,0,623
6,3,3,0,8,375598,0,17,0,642
14,7,7,3,15,316187,15719,14,1539,474
8,3,5,2,18,32076,35893,19,32076,534
13,6,7,2,8,53588,531,21,654,529
110,19,91,11,15,852612,229040,292,21847,431
4,2,2,3,5,31371,29053,4,1641,519
15,7,8,3,5,686043,43850,57,0,495
12,5,7,0,4,143271,0,0,0,577
17,15,2,1,4,215857,311,3,4371,550
20,9,11,5,7,389856,25251,90,8408,454
5,3,2,1,13,30005,11532,23,11532,417
17,10,7,3,11,199169,9018,37,4404,594
3,1,2,0,3,11418,0,0,0,606
18,8,10,0,15,309651,0,3,5856,532
9,4,5,5,6,19483,11850,25,2800,444
11,6,5,2,19,33612,1789,16,2998,564
46,12,34,2,6,29662,20219,27,13849,493
22,13,9,5,29,638622,71554,198,4474,535
16,8,8,5,11,20479,7783,51,25786,419
8,4,4,2,9,9131,8131,30,6480,558
11,5,6,5,5,57282,48767,0,0,473
8,2,6,3,9,26711,33670,31,9277,597
13,8,5,6,6,33889,33889,151,13772,414
7,5,2,0,6,10668,0,19,0,631
16,1,15,1,11,9656,1522,73,4935,535
13,3,10,2,8,10856,6427,27,5673,511
22,13,9,10,20,910437,303720,169,125171,493
11,4,7,0,10,116668,0,0,0,681
2,0,2,0,4,0,0,0,0,699
12,5,7,2,7,17844,103162,23,0,647
8,4,4,0,18,24371,0,0,0,696
43,24,19,1,10,685116,176,135,637,489
18,12,6,1,9,157327,15033,34,3350,494
8,1,7,1,14,0,374868,0,0,666
8,4,4,2,7,35796,5697,58,0,487
8,6,2,0,18,325961,0,0,0,677
62,8,54,6,11,30597,27897,271,9289,432
13,4,9,1,13,80039,12863,26,12863,468
26,11,15,9,10,781716,146142,125,36121,466
41,20,21,0,69,8539472,0,33,21354,636
18,11,7,2,10,19797,4723,6,916,556
21,4,17,2,9,25320,38,148,1158,548
10,6,4,1,31,1910,1336,36,5913,486
29,6,23,7,14,74838,74838,97,46494,588
42,6,36,5,13,66189,63544,3,1305,474
19,12,7,7,5,224933,67199,60,3984,421
22,9,13,1,16,253511,11161,22,227,470
15,6,9,0,17,124779,0,21,9028,623
7,3,4,0,12,47540,0,18,1063,575
30,3,27,4,17,208953,175684,72,33757,508
7,4,3,0,19,35833,0,27,0,551
86,9,77,2,12,110095,8017,66,45044,514
10,6,4,0,12,953998,0,14,0,482
20,6,14,7,12,61938,59481,110,25074,466
7,2,5,0,8,0,0,8,0,702
8,5,3,0,10,128736,0,0,0,712
15,4,11,5,17,66159,82713,85,21815,488
21,5,16,3,8,68065,9446,237,9013,506
14,9,5,4,15,31412,2371,41,5676,505
17,7,10,3,14,35091,20535,16,10324,471
3,1,2,1,11,11950,11950,20,11950,626
6,4,2,4,8,28189,20968,83,312,498
37,12,25,1,7,104014,194,7,1406,569
10,5,5,0,13,86542,0,0,0,628
21,12,9,1,17,572644,6419,36,6419,578
6,3,3,1,14,251930,251270,48,5236,617
15,7,8,2,10,683955,8275,2,7288,512
17,6,11,0,8,93347,0,0,0,660
10,5,5,0,7,78545,0,4,0,544
12,8,4,8,13,381409,389708,92,16117,469
8,3,5,0,11,179379,0,20,0,540
10,1,9,0,16,35341,0,0,7517,644
7,5,2,1,3,34950,4535,10,0,460
9,4,5,3,13,43258,28052,49,19950,496
14,5,9,2,17,480901,14337,62,2480,496
27,13,14,1,13,367545,760,23,11287,475
22,19,3,4,17,2499955,37830,10,0,531
7,4,3,3,8,25301,25301,136,21482,458
18,7,11,2,4,73340,2690,75,3318,495
19,12,7,0,13,211704,0,8,0,609
9,7,2,7,9,126248,112029,90,38965,450
7,4,3,3,15,334162,126540,33,0,507
6,4,2,3,6,33448,32999,57,15269,464
11,6,5,5,10,480251,511191,73,115295,445
11,5,6,4,8,59848,32384,67,15687,438
15,4,11,2,14,380784,38149,31,18891,495
13,4,9,1,15,391879,20787,63,135,497
5,0,5,0,4,0,0,2,1012,532
3,1,2,1,4,2009,502,20,0,521
10,7,3,5,13,297015,33710,104,0,474
17,9,8,7,3,44856,20944,121,2962,383
13,5,8,2,17,345008,81753,44,37700,468
7,4,3,4,9,44908,44908,54,27346,411
15,9,6,12,10,430761,201183,249,23738,378
2,0,2,1,3,0,5932,26,0,493
11,2,9,1,19,49958,13041,7,377,652
20,6,14,3,16,84478,28910,29,12318,446
7,4,3,2,12,13459,38412,57,1376,525
26,4,22,0,13,44595,0,0,0,720
17,6,11,1,23,32088,360,34,3631,507
9,5,4,2,15,373944,7059,0,6272,528
19,15,4,8,6,21882,12866,95,5126,486
13,6,7,7,7,27709,52811,0,0,544
36,18,18,0,32,2226789,0,16,211,492
9,7,2,0,5,177455,0,1,1725,541
10,5,5,5,14,31621,37766,59,14825,480
27,8,19,4,12,201913,70567,87,28186,448
17,3,14,1,8,2987,2987,40,2987,457
9,4,5,1,9,51931,31061,41,0,442
18,10,8,6,16,439416,317702,124,16071,503
17,5,12,4,18,769349,310651,78,0,501
19,5,14,1,12,15989,407,21,2500,551
21,5,16,4,18,124098,68226,77,10471,526
22,7,15,2,12,6702,4999,101,11224,463
24,8,16,5,17,544852,100085,120,8088,453
14,12,2,1,15,46496,1486,0,0,551
32,10,22,1,18,613550,8850,26,8160,531
12,8,4,9,8,108080,111978,3,1564,464
5,2,3,3,13,14747,12103,21,9042,501
4,1,3,1,6,37710,15878,9,0,679
15,7,8,1,16,374787,4480,9,0,448
58,16,42,6,9,1947423,273938,98,32856,490
52,23,29,4,30,2256722,51469,26,2660,464
20,10,10,6,33,82424,24877,161,9029,443
17,3,14,3,17,86664,86664,51,3023780,526
37,6,31,4,12,157574,66067,147,3110,462
16,11,5,0,12,1992947,0,0,0,661
71,4,67,2,8,26798,8929,78,7899,478
127,22,105,24,16,1032343,1125697,1171,372928,437
25,8,17,0,13,995767,0,0,0,693
6,4,2,0,3,408180,0,0,0,601
10,6,4,4,10,11564,11526,110,1770,529
6,3,3,0,19,13040,0,13,2636,513
15,9,6,3,24,416237,2412,67,22396,469
20,9,11,3,14,2590718,270832,16,9176,495
11,5,6,4,5,22594,19659,39,14272,443
8,3,5,2,5,2305,2305,38,1850,438
88,12,76,0,25,1691598,0,0,0,700
14,2,12,1,11,864,864,69,864,571
19,5,14,0,15,169707,0,15,2127,544
13,9,4,7,8,452442,92876,181,63846,449
12,8,4,5,9,8579,7263,77,9035,440
9,5,4,3,5,43192,16854,121,4200,491
22,1,21,2,13,26759,26759,67,23093,645
26,9,17,0,8,554963,0,24,1137,570
75,10,65,8,9,45685,24463,29,18067,454
18,5,13,2,14,18117,4140,29,1980,486
14,8,6,10,8,103621,67493,23,800,417
24,12,12,1,22,597224,143,10,1224,590
57,19,38,2,21,2246612,475,47,6064,539
9,5,4,4,10,6791,6378,212,2185,501
20,6,14,3,6,13395,8526,26,1466,489
80,20,60,13,16,215473,140207,207,10403,453
10,5,5,5,7,53782,62490,86,3104,412
9,7,2,4,15,24859,21738,51,16792,641
25,4,21,0,6,17215,0,9,2755,603
33,8,25,6,9,121337,120447,35,9506,459
20,9,11,5,12,40330,24754,36,14972,418
16,11,5,6,8,241890,18632,48,11448,429
41,6,35,4,5,42873,37252,41,14976,499
19,6,13,10,10,602003,909875,202,454236,480
5,2,3,2,14,16596,10483,0,9506,475
13,9,4,0,6,99596,0,0,0,624
34,14,20,7,14,121856,55411,163,9663,414
8,5,3,2,8,21907,14950,15,1462,510
4,1,3,1,5,1000,1000,1,2137,565
12,4,8,4,8,21839,34312,26,2969,450
6,4,2,1,4,6269,2174,20,0,551
56,10,46,1,17,288659,19355,51,19355,654
14,8,6,1,12,537844,326787,0,0,516
8,4,4,1,4,7207,3375,37,3375,558
12,4,8,6,8,73413,121925,296,52335,453
12,2,10,1,6,270344,3892,8,0,632
35,5,30,0,21,417867,0,4,13940,532
32,7,25,0,6,272841,0,1,0,611
21,1,20,0,13,22278,0,0,933,667
15,4,11,0,14,29435,0,19,0,607
49,8,41,2,18,295326,11635,25,4315,643
27,18,9,0,9,222130,0,4,122,619
18,1,17,2,13,1183,3550,21,1183,536
53,9,44,5,13,432958,20772,47,3544,453
13,9,4,10,9,150151,210470,98,45046,424
10,7,3,2,9,443584,5793,52,3766,544
31,5,26,4,6,38819,33505,303,7187,528
49,5,44,2,11,11435,1809,29,1833,532
20,11,9,6,18,106447,76077,90,50748,423
4,2,2,0,2,10016,0,1,0,591
10,7,3,0,6,438482,0,14,0,598
21,11,10,9,7,125037,53489,42,10273,417
14,10,4,0,11,1418043,0,2,525,556
3,1,2,0,7,14854,0,15,2938,661
12,4,8,2,9,19540,5647,65,5250,577
15,5,10,5,6,55813,31108,51,5591,428
4,1,3,0,9,27545,0,11,0,674
6,1,5,0,7,0,0,0,0,657
34,11,23,5,10,61437,17863,43,4203,434
8,5,3,1,13,56574,477,21,11694,526
12,8,4,0,10,1866652,0,4,0,672
14,10,4,5,13,59197,35267,50,13513,394
16,8,8,3,11,211792,32755,42,104,457
12,9,3,4,10,133011,25285,50,18171,450
15,10,5,5,7,132642,9246,53,3000,422
11,9,2,7,16,573703,566218,116,270573,447
7,5,2,0,13,288045,0,0,0,667
41,9,32,1,10,685298,9515,31,0,453
18,8,10,2,9,44415,15598,46,15274,443
53,13,40,6,14,209831,50248,65,23239,379
25,9,16,5,18,318929,33032,100,0,520
6,2,4,1,14,16012,9367,12,0,561
15,12,3,7,15,369780,574060,59,0,443
5,2,3,1,4,2986,725,0,0,540
8,2,6,3,11,3906,4792,54,2840,618
16,6,10,3,7,152609,36119,62,9747,455
5,3,2,1,17,1887,1887,24,720,567
10,6,4,1,12,332101,2460,26,0,543
16,5,11,1,13,207366,20674,0,0,523
9,4,5,1,7,37356,365,27,0,491
10,5,5,0,12,86161,0,0,0,625
6,2,4,1,10,1343,1044,51,0,544
25,6,19,0,14,830450,0,65,3300,603
6,1,5,1,7,543,543,9,0,490
9,7,2,5,13,240362,54377,18,4716,395
16,11,5,0,16,146041,0,15,760,677
6,3,3,3,4,215007,131611,49,0,528
13,7,6,5,11,608509,37419,113,1647,470
29,4,25,1,13,51352,32143,8,32143,581
23,16,7,2,10,181045,172,19,147,543
14,4,10,3,8,31280,30795,99,1161500,640
22,13,9,7,18,195855,87159,441,1364,487
159,17,142,11,20,507282,97442,179,19284,466
58,8,50,0,12,23048,0,12,1758,637
12,9,3,5,7,261227,22726,226,17212,423
5,2,3,4,7,12821,23740,75,1332,457
14,9,5,10,21,918579,1511188,8,20478,472
5,2,3,2,18,16742,12989,47,6974,581
14,7,7,5,8,239161,17885,67,11544,528
15,1,14,3,8,49088,49088,0,0,484
21,10,11,0,9,232136,0,0,0,587
56,15,41,10,30,495105,218510,170,42484,477
18,7,11,0,8,94493,0,199,55252,406
13,7,6,7,10,27759,67871,121,993,471
670,4,666,2,11,5355,3373,33,2574,543
9,5,4,6,7,62838,45100,80,0,451
6,4,2,2,7,86512,86512,46,0,484
16,5,11,3,32,53590,12687,42,10247,463
22,19,3,1,17,3900946,3054,1,0,551
13,4,9,5,11,21861,33779,2,527,439
9,4,5,2,14,11458,7989,3,125,643
6,3,3,1,15,148239,6103,6,234,636
14,7,7,1,15,34381,15964,6,15964,516
12,1,11,0,12,398,0,23,0,569
12,5,7,1,6,17556,650,29,2538,526
19,7,12,0,6,60909,0,0,0,620
20,8,12,7,18,184649,184649,81,75743,499
7,5,2,1,13,242696,580,1,1076,578
10,7,3,4,5,339309,109228,49,0,488
8,2,6,2,6,3800,3800,41,2520,546
15,2,13,1,9,3586,4343,0,3957,569
28,17,11,15,22,2877624,2507686,338,51922,457
8,4,4,1,8,313064,702,10,6517,442
10,7,3,7,10,28894,23576,19,2536,439
31,1,30,1,19,76246,4467,0,2153,579
10,4,6,1,6,94319,4683,87,4683,538
16,11,5,0,7,53692,0,0,0,536
37,5,32,3,13,301027,15616,47,1594,510
4,1,3,1,15,12261,12261,29,0,424
8,6,2,0,6,33105,0,13,4515,600
6,3,3,2,11,14448,14448,95,13657,485
7,3,4,3,9,2011,2011,43,1415,424
88,13,75,4,19,294280,6901,30,7030,561
12,8,4,2,19,372380,25036,29,2364,562
30,10,20,0,6,66325,0,0,0,532
18,8,10,1,8,772212,18188,20,0,499
12,5,7,0,16,489288,0,14,0,569
8,3,5,0,3,298881,0,0,0,662
50,12,38,1,17,56497,4459,26,4459,499
19,10,9,7,12,98485,47152,243,25272,464
13,11,2,11,8,162586,160179,278,8428,434
15,5,10,3,6,43953,7106,240,4378,460
4,2,2,3,9,76895,98183,60,0,481
11,1,10,6,15,18918,66992,9,18918,415
28,7,21,4,9,81449,12141,174,6387,497
22,5,17,2,8,31461,26762,72,26278,607
42,12,30,9,6,65904,14131,160,2858,499
11,5,6,2,14,437817,51934,32,28080,425
13,7,6,3,10,29374,24546,61,9954,439
19,9,10,8,18,73910,62714,136,3980,445
26,6,20,1,8,16737,468,20,1099,453
11,9,2,2,15,15054,11725,41,9451,418
18,7,11,9,11,366685,71269,197,21433,495
7,4,3,1,4,33339,5685,5,1088,499
53,13,40,0,17,1106117,0,10,2848,599
15,6,9,4,12,68134,49236,37,20127,486
14,5,9,2,11,475690,34497,21,1307,545
31,5,26,1,16,24081,22273,59,22273,661
7,4,3,4,5,6129,3467,60,0,524
9,5,4,1,8,44885,42,4,42,653
8,6,2,4,11,1171453,185328,103,115518,468
9,3,6,1,10,12856,12600,0,721,413
12,5,7,2,10,188997,9932,39,6036,495
22,6,16,1,8,131796,89079,0,529,513
11,4,7,3,9,50813,42222,57,0,490
12,5,7,6,17,88246,27176,38,11570,458
5,3,2,3,10,1576,1576,23,1039,526
25,9,16,4,14,61102,21647,85,1431,468
7,5,2,0,5,23224,0,3,0,679
25,8,17,3,17,412703,15213,36,1475,531
12,7,5,2,19,47858,14775,48,3720,574
48,18,30,21,20,865190,882693,460,98028,456
51,5,46,1,12,112045,23785,3,77345,441
5,2,3,2,8,26659,9592,12,0,460
17,8,9,2,14,27235,12241,25,11525,489
8,3,5,4,8,24628,24010,8,8801,458
23,7,16,1,16,225511,436,20,2761,552
22,9,13,2,16,397913,13011,40,7425,472
38,6,32,4,14,33615,25979,74,3171,462
8,5,3,4,9,26520,26519,63,13484,459
11,5,6,1,8,94489,5519,29,3411,636
7,4,3,1,9,7472,7472,0,0,556
4,2,2,1,15,200258,6575,31,0,551
3,0,3,0,8,0,0,8,0,607
4,1,3,0,7,516,0,1,0,549
9,7,2,5,12,69278,55926,103,16937,519
25,12,13,1,13,899261,6148,32,6148,458
48,11,37,3,19,247729,78896,70,20400,433
24,15,9,7,17,253553,103068,81,348,453
14,8,6,0,14,303184,0,0,330,635
13,5,8,3,11,32065,16123,50,6146,454
10,4,6,5,8,35860,208802,82,775,571
27,10,17,7,10,186878,128377,164,0,486
18,15,3,14,13,140243,64162,164,8994,491
31,10,21,4,14,330897,16059,29,11148,375
32,15,17,8,14,710182,174165,69,131145,405
5,3,2,3,4,5277,5277,47,3033,467
18,4,14,1,20,29263,29263,291,5208,460
6,3,3,4,14,20537,159675,55,11873,539
20,8,12,0,17,586128,0,0,0,703
8,4,4,4,14,107305,102394,167,39790,540
23,6,17,1,5,63217,186,13,4807,472
5,3,2,5,8,61636,113810,79,5923,462
12,10,2,1,12,14201,1932,3,3536,509
26,11,15,6,15,519726,64462,140,22542,451
20,13,7,7,19,715721,319293,187,0,511
21,8,13,6,7,66601,29789,22,787,427
24,15,9,4,13,308890,73439,73,7161,458
5,2,3,0,3,68513,0,0,0,663
6,0,6,0,5,0,0,13,576,702
15,6,9,2,11,45952,26300,18,22707,547
37,14,23,6,14,253368,100861,34,41630,552
34,16,18,2,12,485008,35092,31,26853,446
18,10,8,4,10,393388,14970,55,3674,466
27,10,17,4,22,418361,75033,56,8700,465
5,3,2,1,8,84438,13300,0,0,540
8,5,3,4,8,265725,34648,7,2937,507
60,9,51,2,9,77687,10569,98,4115,500
41,25,16,0,22,503491,0,14,0,689
6,2,4,2,6,62586,62586,49,57150,538
8,3,5,3,11,25821,22985,56,93865,498
8,6,2,4,7,376460,28254,160,10181,454
7,4,3,0,24,308030,0,0,0,690
15,9,6,1,7,397628,738,12,1680,566
6,3,3,0,13,28854,0,0,0,700
14,3,11,4,8,28064,49902,81,26078,381
10,8,2,4,7,123191,76664,73,611,484
5,1,4,4,14,705067,707364,33,40498,513
22,1,21,0,7,832,0,2,1027,609
21,6,15,6,11,125884,125884,100,7486,458
14,11,3,9,8,26149,24665,266,12395,404
67,10,57,6,12,95547,69514,5,6822,448
18,5,13,1,16,174120,6323,33,0,580
13,7,6,9,11,487849,186811,161,12117,421
18,9,9,0,11,195848,0,4,8131,648
4,2,2,2,6,2967,8168,39,3594,491
34,5,29,2,13,14596,12728,20,25136,477
6,4,2,2,5,29139,959,46,1666,557
11,4,7,0,8,70511,0,9,10,691
8,6,2,5,14,825900,114196,84,16590,479
3,1,2,1,6,2529,2529,35,3098,510
7,2,5,3,11,7024,14718,43,819,517
15,9,6,5,14,94795,25515,63,8692,424
50,6,44,1,69,51220,3887,82,1283,613
29,19,10,9,9,141840,47026,149,7667,406
28,6,22,0,9,15298,0,195,6464,459
10,4,6,1,15,42272,1988,1,3680,701
34,9,25,2,17,63671,10729,44,8372,472
9,6,3,1,5,29821,3966,5,142,545
24,8,16,7,11,400618,63285,107,26572,432
17,12,5,12,9,794018,254314,195,2128,459
11,4,7,5,7,63849,42494,159,17613,469
10,5,5,4,11,40575,40331,57,8181,479
8,3,5,0,6,25517,0,2,157,689
8,3,5,3,9,7100,16841,64,7100,518
105,20,85,6,10,65046,1772,43,31067,478
9,7,2,6,7,15441,15441,84,2387,435
8,6,2,1,10,45507,120,1,120,543
38,15,23,9,20,340574,18674,114,6600,519
5,3,2,1,9,3758,3758,43,3758,617
13,10,3,11,10,94737,98961,204,34463,442
27,5,22,1,8,26151,3241,10,3241,488
59,4,55,3,23,6672,24685,18,2580,449
4,2,2,1,14,295,295,20,0,674
6,3,3,2,16,332500,8295,51,7639,466
5,3,2,2,10,88784,88783,0,50,458
4,2,2,3,6,6305,15370,22,2765,493
16,3,13,0,13,166635,0,0,0,686
24,7,17,0,15,749264,0,14,1188,514
16,2,14,0,13,282264,0,162,9140,679
27,15,12,14,13,587063,486339,349,86078,431
28,15,13,11,7,178297,112023,378,70298,418
7,2,5,1,17,42575,42921,34,0,592
38,5,33,1,8,208144,512,65,1263,456
7,4,3,3,11,18227,16934,22,8651,617
13,5,8,0,14,43459,0,14,0,683
21,9,12,0,11,2394729,0,17,600,572
8,6,2,5,7,41293,40795,81,13914,450
22,13,9,3,14,1321516,8625,0,0,475
17,6,11,1,5,65442,1220,3,387,467
147,9,138,4,13,66451,54664,247,35145,504
3,1,2,0,13,0,0,0,0,662
17,6,11,1,11,9726,404,2,404,462
53,10,43,5,14,884142,27095,202,9496,512
26,13,13,5,14,641950,24633,133,2890,541
14,4,10,3,15,933768,121081,98,1132,504
46,5,41,3,18,67718,63110,72,6129,474
7,4,3,2,11,140730,127477,16,122240,451
24,7,17,2,5,323572,731,4,2578,512
10,6,4,1,17,513504,190,23,190,556
17,5,12,0,8,62651,0,33,5840,650
37,6,31,1,7,192877,5021,21,7001,499
12,6,6,3,10,128033,11074,42,4631,471
20,4,16,2,9,36369,643,145,1389,593
19,9,10,9,14,100191,147332,148,1866,552
8,3,5,2,10,21774,2430,23,1854,537
5,2,3,2,2,11845,22040,15,14804,478
9,4,5,2,11,221735,38729,23,37642,432
7,4,3,1,12,337375,7440,5,7440,458
22,13,9,4,30,3253610,27282,30,5970,441
8,5,3,2,4,36945,2289,17,0,592
29,6,23,3,14,15584,11750,56,520026,492
22,15,7,9,11,685762,233327,121,0,478
34,6,28,6,8,52087,47941,152,16971,438
15,7,8,0,11,41162,0,3,2578,601
8,5,3,3,14,51977,24007,27,1866,433
12,6,6,0,11,90408,0,0,0,582
16,7,9,11,7,623650,974912,307,463434,456
16,5,11,3,6,41461,25332,29,47,467
41,22,19,1,13,2002715,17,49,1301,540
654,10,644,1,14,320370,8477,96,12683,532
10,5,5,5,5,90663,25011,189,6710,416
13,9,4,5,13,60265,32046,142,3450,494
11,5,6,2,12,365619,15632,2,0,680
23,3,20,3,14,19359,19359,28,8872,513
48,10,38,2,19,700189,19318,33,4920,520
9,4,5,0,7,38072,0,0,0,587
10,8,2,3,13,46757,15032,138,4605,520
89,7,82,4,10,77923,33387,33,25242,475
11,5,6,1,15,172765,125538,0,0,561
9,5,4,3,17,36776,25508,55,3115,474
30,11,19,20,8,1660827,3057977,284,281040,391
11,4,7,2,19,75333,3688,34,1647,503
13,4,9,1,6,276887,8336,23,1624,600
15,13,2,10,20,1078755,435207,151,102425,447
32,10,22,6,12,310742,13473,143,4318,447
12,5,7,0,9,144323,0,0,690,619
5,2,3,0,12,4961,0,0,1929,670
17,11,6,2,8,259690,1852,13,0,568
14,6,8,6,8,67813,61079,343,34776,481
5,2,3,1,14,27218,1853,0,0,641
33,6,27,4,14,32297,30784,74,1828,545
47,8,39,5,11,86835,15113,63,6274,555
8,3,5,3,14,79269,55274,18,21882,450
7,3,4,4,7,47310,61200,54,22860,458
24,3,21,2,13,72214,21575,47,13921,629
6,3,3,1,12,481016,31780,49,31780,565
8,3,5,3,6,12705,26974,52,9380,510
27,5,22,0,11,37715,0,3,1377,660
8,2,6,4,11,13420,213515,79,88,512
43,6,37,0,11,360512,0,39,0,640
10,8,2,6,12,92242,70093,122,44318,508
16,6,10,3,11,133722,11613,42,0,485
3,0,3,0,4,0,0,2,3301,589
11,5,6,2,7,417273,3831,30,8820,490
12,6,6,6,11,128994,150374,69,48988,409
9,7,2,0,12,305835,0,0,0,657
20,8,12,0,14,537826,0,9,0,641
19,7,12,9,13,370465,103802,171,27451,432
45,16,29,3,5,268105,13326,88,11613,467
9,7,2,2,7,63018,1442,61,257,475
19,10,9,12,13,162240,163644,7,17167,430
6,2,4,0,4,97614,0,1,0,627
9,3,6,0,18,113104,0,41,0,560
5,1,4,2,7,4309,4309,21,0,519
14,5,9,0,9,16655,0,8,224,549
14,7,7,5,12,343552,51601,113,10308,501
39,5,34,0,6,61543,0,8,0,660
8,4,4,3,13,423650,31568,26,3102,506
20,10,10,6,7,34912,20197,380,7717,485
27,7,20,5,6,43173,26103,108,19463,491
9,2,7,0,6,17488,0,0,0,671
4,1,3,0,11,0,0,0,0,613
9,6,3,1,13,407263,848,13,848,547
25,6,19,11,8,83970,118010,123,12717,390
4,2,2,1,3,41977,521,0,0,513
9,4,5,4,8,107602,78850,64,10242,551
7,5,2,3,8,158026,158026,37,150926,480
35,24,11,13,13,2533347,1146699,134,308796,429
14,7,7,1,12,413267,23986,0,0,658
21,7,14,0,5,32163,0,6,487,617
15,8,7,0,11,63407,0,4,0,677
8,6,2,1,14,186685,565,11,678,438
10,6,4,0,8,21347,0,59,715,581
35,5,30,0,8,249807,0,45,1550,503
5,3,2,2,9,1059,1059,30,281,523
28,8,20,4,17,36648,45082,76,3390,394
10,6,4,6,17,116205,116205,56,41561,464
11,6,5,0,13,569388,0,1,0,503
7,5,2,1,5,428465,221,1,0,546
5,3,2,2,6,6777,6777,35,5032,578
12,4,8,1,7,116437,298,121,913,509
2,0,2,0,7,0,0,12,0,639
34,11,23,0,16,383888,0,0,1120,677
42,3,39,1,11,397313,8051,87,0,547
7,4,3,2,8,632628,28585,54,0,575
62,8,54,1,13,318988,7655,39,2560,553
29,8,21,5,11,23053,19407,63,6712,486
18,6,12,2,14,607246,150679,49,6992,527
14,9,5,0,7,126144,0,26,2446,536
65,7,58,3,11,62004,17299,144,16867,447
19,6,13,7,11,38002,38002,179,16240,374
17,9,8,0,5,307418,0,51,436,597
6,4,2,4,6,25002,16887,167,13572,510
5,3,2,1,5,32061,13461,19,0,502
4,1,3,0,4,4280,0,9,1360,547
18,5,13,4,10,78129,44013,66,19329,423
8,6,2,0,6,27180,0,0,0,601
11,3,8,2,19,29165,17721,24,16561,517
11,7,4,1,6,32797,10468,13,797,523
4,2,2,0,3,40036,0,0,0,540
13,2,11,2,13,11752,11752,37,6290,554
64,23,41,8,18,169927,37497,135,14733,449
17,6,11,7,7,184656,182064,300,62546,453
15,8,7,2,13,195371,13749,4,2774,494
12,10,2,0,18,417564,0,0,0,666
10,7,3,1,15,283225,3090,16,0,539
17,11,6,11,16,457288,194721,153,19204,401
11,8,3,7,4,112305,40585,149,7046,460
10,5,5,1,9,470968,1376,27,1376,640
64,4,60,3,5,20621,24111,29,11377,496
12,5,7,1,21,503895,3502,1,0,587
17,3,14,1,13,11468,1700,2,1700,580
32,4,28,1,8,77533,993,15,14302,501
38,11,27,0,9,445603,0,5,243,506
15,8,7,8,7,26140,17592,155,9142,454
12,6,6,2,12,407806,387129,148,12168,453
7,3,4,1,7,156953,1227,24,0,524
12,7,5,3,12,251261,65366,121,49556,515
4,1,3,2,6,1789,53306,32,0,611
6,2,4,4,11,37630,42947,24,1932,500
13,6,7,1,4,312434,14434,1,14434,564
8,2,6,1,5,23116,9196,18,0,565
29,9,20,4,14,238148,25619,39,11847,413
14,9,5,2,13,51701,7424,17,2480,499
88,14,74,1,16,132713,3246,36,14263,468
29,10,19,9,10,269819,107453,329,37137,427
5,3,2,1,11,64662,14770,12,0,470
91,14,77,7,21,316248,18053,236,3361,453
59,12,47,3,11,215267,27143,31,5035,402
11,9,2,0,8,185594,0,0,0,550
28,7,21,5,16,34794,29698,301,34200,450
11,6,5,0,6,29157,0,18,418,632
16,4,12,5,11,80129,75836,62,15999,474
17,6,11,3,9,94010,15057,23,13201,447
29,11,18,6,9,33582,32656,91,8702,422
20,6,14,0,5,28082,0,21,0,685
10,8,2,6,5,15405,15405,91,6461,499
12,10,2,5,16,375492,35468,48,11413,450
27,14,13,1,16,826336,2472,5,2489,531
8,5,3,4,6,73555,61024,95,0,520
21,9,12,0,17,1773616,0,2,0,639
14,8,6,4,9,671511,14711,82,0,500
63,32,31,1,28,1582877,1065,2,1237,683
14,7,7,7,8,318661,92111,91,14562,451
18,9,9,2,14,190117,1155,61,621,577
11,2,9,1,9,306497,5587,86,10951,431
16,10,6,2,16,1628552,10396,42,779,461
18,7,11,8,14,555023,78883,126,10068,443
4,1,3,2,5,54633,54633,43,0,632
16,7,9,3,14,32086,8417,34,4936,426
5,3,2,1,10,20910,20910,33,6379,520
6,4,2,3,12,30303,14650,76,823,482
21,12,9,0,7,57961,0,1,283,594
15,3,12,1,14,8067,378,36,7580,482
17,7,10,4,5,18084,8228,46,2300,425
11,8,3,0,15,656932,0,28,0,581
24,7,17,5,14,201018,113823,92,2200,492
18,10,8,0,4,75102,0,0,0,623
8,2,6,1,21,11543,2004,13,16953,467
11,4,7,0,10,102365,0,15,0,633
16,9,7,11,9,473959,232303,60,12177,437
28,6,22,4,20,27093,8722,69,9665,465
24,11,13,5,9,86542,31793,46,13907,506
6,4,2,5,4,47481,57805,39,17734,450
23,8,15,1,8,548474,6183,84,6183,535
4,2,2,2,3,16189,15715,92,14249,381
11,3,8,2,9,28983,28523,88,27316,551
13,8,5,5,6,339079,8660,106,3160,419
11,7,4,0,15,334362,0,5,45080,612
21,10,11,1,12,146247,8024,29,0,476
8,2,6,1,7,22724,1220,17,2365,493
17,7,10,3,5,45141,2357,54,1153,521
13,4,9,1,25,22996,6971,10,22181,590
37,5,32,0,18,93667,0,84,3663,654
14,8,6,6,6,36166,13706,324,9140,429
3,0,3,1,4,0,11972,28,0,630
57,5,52,2,20,263404,12121,40,6048,493
15,7,8,9,8,96002,100235,203,11273,447
22,4,18,2,9,18710,1804,114,1597,426
15,10,5,5,12,867743,14028,5,10923,459
8,0,8,0,8,0,0,7,2500,574
9,6,3,1,13,56672,1114,14,3204,502
9,2,7,2,4,17908,17993,0,0,461
16,10,6,8,6,392831,120361,138,153693,412
5,2,3,1,20,11705,11705,0,0,655
70,10,60,5,9,103382,14286,119,7029,453
43,9,34,0,20,37203,0,13,443,677
5,3,2,3,10,201370,68736,37,10282,516
9,4,5,2,8,12392,1356,16,939,569
54,42,12,1,17,4357565,8004,92,8004,453
24,10,14,15,8,385128,237309,346,40888,455
33,1,32,0,10,0,0,1,0,715
16,6,10,4,13,29265,11799,51,2525,433
13,10,3,7,26,331953,49211,91,7709,433
24,7,17,5,20,243839,28178,113,1850,603
17,6,11,1,12,24969,986,22,1773,683
19,10,9,0,4,351329,0,0,0,652
10,6,4,6,8,49707,40940,84,10162,434
12,6,6,1,10,376569,11463,20,291,537
21,8,13,0,10,100093,0,8,0,675
20,15,5,10,14,140576,32449,100,10914,446
2,0,2,1,8,0,8049,4,8049,592
9,7,2,5,13,226163,158259,66,58674,518
18,9,9,2,15,96940,139454,0,0,555
4,2,2,0,6,33430,0,24,4648,511
25,11,14,4,20,874852,73125,82,4924,453
15,2,13,0,6,8065,0,8,0,641
7,3,4,2,9,223452,16564,16,11164,604
25,12,13,7,16,514117,73244,43,21672,495
13,10,3,8,19,197869,170069,38,139274,438
12,2,10,3,11,17684,25218,40,11064,434
17,6,11,4,5,110477,98285,47,91046,492
12,6,6,6,14,19993,19993,122,4088,436
16,2,14,0,8,19812,0,6,5175,599
21,7,14,2,10,55346,2176,49,3289,569
16,9,7,7,16,73329,62851,147,5662,504
17,8,9,0,7,1139079,0,2,60,587
12,6,6,5,20,163868,415413,50,2055,484
11,5,6,2,7,9120,1665,24,1487,534
16,1,15,2,11,3996,20161,27,3996,662
7,5,2,3,6,68687,25408,0,0,464
4,1,3,0,13,2567,0,1,1326,681
9,4,5,2,17,340663,9581,15,17210,417
83,16,67,5,9,73756,1286,512,2704,477
18,11,7,9,17,84769,95752,206,11570,504
8,3,5,3,9,8641,12326,5,1967,551
15,6,9,5,8,974354,120011,43,0,626
13,8,5,4,11,231446,28065,152,11153,475
13,11,2,8,18,161481,161083,207,86707,451
8,5,3,5,9,67740,72945,66,18127,443
5,2,3,2,7,17941,1524,59,0,523
39,14,25,12,28,702118,687341,473,16687,501
10,7,3,0,8,8583,0,6,1077,611
13,10,3,1,19,385928,4498,6,0,578
34,5,29,7,9,12254,32094,90,14880,458
3,1,2,1,15,2477,1485,3,0,536
37,12,25,7,14,51809,50213,68,45203,432
16,9,7,0,15,203554,0,15,0,609
9,7,2,6,6,69460,69460,79,0,550
31,6,25,6,9,33972,45033,433,20773,453
22,6,16,2,8,128163,8846,258,8432,573
30,10,20,5,14,58333,3644,17,2939,474
11,7,4,6,7,48327,37874,132,6743,536
18,4,14,2,14,131228,13279,23,0,533
5,1,4,1,9,13613,2244,0,0,489
16,5,11,3,10,56458,28932,0,0,513
21,12,9,4,12,703333,44881,58,10250,523
14,9,5,8,9,71185,45081,3,298,451
4,1,3,0,9,7584,0,2,0,684
35,24,11,13,13,2529280,1136759,130,304608,429
17,9,8,3,10,213106,27594,39,14364,442
8,6,2,5,15,47336,35230,10,17462,397
4,2,2,0,8,798,0,1,1157,741
12,8,4,0,12,58426,0,6,2432,542
16,6,10,6,9,93272,12851,0,0,462
26,11,15,17,32,345666,457624,644,118812,439
5,0,5,0,8,0,0,28,0,587
8,6,2,1,6,123939,2142,2,0,636
14,10,4,6,7,129113,41757,43,0,466
25,10,15,10,9,445107,81457,399,23370,420
10,5,5,6,8,36181,51335,84,12695,426
15,13,2,13,10,79596,71605,288,8794,422
8,2,6,1,10,13096,12021,13,0,572
20,5,15,1,8,34937,778,5,0,537
8,4,4,3,8,60181,34588,54,16638,435
15,3,12,2,7,28834,31329,29,28515,493
6,3,3,0,8,303895,0,0,0,638
10,8,2,4,8,125124,25441,33,676,466
23,10,13,1,14,385533,11655,19,11655,411
24,8,16,0,13,85207,0,8,2256,668
19,7,12,2,28,16557,352414,19,55,564
22,8,14,7,10,70519,71265,107,37488,464
37,8,29,6,14,452789,55866,151,9628,462
3,1,2,1,5,639,4000,15,4000,645
7,2,5,2,10,6891,4038,10,2177,612
7,5,2,5,7,78936,137772,43,0,453
15,6,9,5,9,19474,18655,100,10680,433
17,9,8,7,69,22980,23528,254,10594,454
15,13,2,0,4,1439319,0,0,0,657
25,9,16,0,14,358711,0,25,2692,541
138,14,124,7,14,257277,107177,78,9081,494
9,1,8,1,14,3089,3089,4,3419,522
16,8,8,5,14,71413,41125,14,29602,484
15,8,7,7,8,31846,28525,77,19744,394
152,5,147,3,10,16337,4512,441,3952,495
14,4,10,5,21,10460,102863,58,0,599
19,5,14,4,13,11243,11242,65,5315,482
3,0,3,0,11,0,0,68,32077,492
9,7,2,3,13,291644,34472,50,3680,478
9,4,5,2,6,431029,11136,95,8742,598
6,4,2,4,5,27570,38024,2,242,541
134,10,124,3,13,75274,59580,86,68203,500
16,8,8,0,19,926293,0,0,0,655
17,7,10,4,4,18369,13069,43,6707,452
6,4,2,1,14,38717,21853,23,21853,487
21,2,19,2,6,3144,6288,53,3144,578
7,4,3,1,5,30421,886,12,886,525
11,9,2,10,5,326065,42016,97,11580,402
20,12,8,2,29,731134,36243,72,2365,611
3,1,2,1,3,1980,1980,10,0,595
5,2,3,0,11,34835,0,0,2864,652
22,10,12,1,14,39304,911,6,1129,466
12,5,7,4,7,76789,74778,91,3116,462
4,2,2,3,7,11969,16673,16,17670,429
43,10,33,9,11,96380,89762,99,47462,459
12,3,9,2,16,548275,13157,25,12114,430
19,7,12,6,15,26092,112173,13,4318,511
32,17,15,2,69,710348,5952,27,4583,554
9,4,5,3,8,62609,55039,64,0,572
14,6,8,2,17,249624,1114,9,1114,473
6,3,3,2,14,26884,15123,40,0,553
8,4,4,0,4,250706,0,0,0,600
24,20,4,11,5,413379,151298,137,6487,384
8,4,4,8,7,63709,89092,131,0,596
8,5,3,3,11,293680,20655,52,1866,439
16,10,6,8,14,24354,20455,314,4721,379
4,1,3,4,7,148189,153260,0,0,527
12,4,8,3,2,45296,5612,17,3308,498
16,6,10,9,8,71061,79021,120,31187,451
17,7,10,5,14,143864,35266,110,3397,494
4,2,2,0,7,21041,0,5,218,556
11,7,4,4,9,96452,62401,37,2943,502
14,2,12,3,13,22016,86021,82,21596,549
9,3,6,2,18,38492,1429,22,759,543
10,8,2,7,4,252258,158311,148,3975,466
6,3,3,1,12,37925,1199,24,4311,478
18,6,12,2,20,32564,4535,15,4152,461
5,3,2,4,5,94045,98483,43,4646,502
12,4,8,4,8,98089,129840,113,1844,447
52,6,46,6,14,68994,31117,120,15840,440
6,2,4,3,7,36422,35269,143,834,649
20,2,18,3,8,5341,9554,7,4319,462
15,5,10,4,12,52151,32432,79,12552,426
5,2,3,1,26,13770,4961,6,3841,465
6,4,2,2,4,59686,55095,39,32966,508
18,8,10,8,12,632145,103650,12,3360,425
8,6,2,4,14,20625,20270,45,5571,434
9,3,6,1,14,13267,1000,5,3315,649
6,4,2,0,13,93580,0,8,6807,479
5,0,5,0,4,0,0,2,1182,635
12,4,8,2,8,26169,20483,69,12824,552
11,5,6,0,12,22994,0,0,0,670
74,10,64,5,14,415510,54272,63,4936,514
7,4,3,3,12,60306,5225,83,0,536
13,3,10,0,11,12666,0,0,0,651
13,8,5,1,7,219157,617,27,5663,497
9,7,2,5,6,298623,26340,308,10458,414
19,7,12,2,12,40258,31824,192,30744,474
13,6,7,0,8,105946,0,38,1464,634
22,4,18,4,18,56675,73179,69,2229,481
5,3,2,3,10,21972,19431,171,15663,516
10,4,6,8,6,61066,178057,171,39448,441
13,9,4,5,69,57577,48832,148,13927,473
17,12,5,9,4,217773,134848,139,10715,422
15,8,7,5,16,142501,142338,106,4510,438
17,8,9,1,14,187438,36380,22,1129,479
14,6,8,1,9,364373,1597,84,10814,486
39,8,31,4,12,535518,26439,151,10362,483
8,5,3,3,6,25568,6792,64,4044,479
21,7,14,3,14,465103,20992,57,2714,510
5,2,3,2,14,35896,20816,28,18465,486
29,8,21,6,14,60809,37498,56,19354,447
12,8,4,1,4,411712,3040,1,3040,543
10,5,5,0,14,59315,0,61,993,654
16,3,13,3,14,9349,6613,102,10480,548
16,5,11,4,13,25239,26679,29,9257,453
30,19,11,19,18,126774,126774,66,19049,433
6,3,3,1,6,37499,12113,0,0,534
14,5,9,0,5,70475,0,89,704,638
9,2,7,3,6,8505,8505,10,2026,428
15,6,9,5,11,477842,25860,75,10857,482
12,3,9,3,9,27827,22423,66,101981,500
7,3,4,0,7,124114,0,0,0,725
18,4,14,0,7,285019,0,13,0,685
9,5,4,1,13,45267,6373,24,6373,529
11,6,5,5,5,25223,21102,108,3438,423
30,7,23,4,14,397034,11368,128,8128,493
12,2,10,2,14,21542,21542,102,30084,533
10,7,3,6,4,97377,92695,36,4572,440
8,5,3,4,6,36581,42268,86,29085,434
30,7,23,4,13,355269,38300,55,14080,558
9,6,3,0,5,41755,0,2,593,646
9,7,2,7,8,37355,27980,33,10650,394
20,6,14,4,18,49753,50732,35,12189,674
11,6,5,5,16,759422,115432,6,62722,415
19,2,17,3,14,35133,37349,30,34167,515
20,13,7,15,14,238748,334924,271,67072,427
11,7,4,4,7,12872,2123,92,1340,480
6,3,3,0,5,62321,0,1,1499,528
4,2,2,1,14,25309,10061,18,10061,540
7,4,3,3,10,13625,8417,35,6035,451
16,10,6,3,9,15518,4903,13,3058,540
39,14,25,11,9,99111,96743,381,24389,390
9,6,3,1,6,12845,3274,2,3274,448
11,5,6,5,16,80558,21062,254,6404,527
13,4,9,0,10,48267,0,122,692,560
8,4,4,3,6,31308,3265,63,1068,578
26,12,14,0,28,1048226,0,0,0,606
14,1,13,1,18,1350,1350,42,6451,639
17,8,9,1,12,464589,9888,22,745,582
13,8,5,6,11,276102,138806,7,100,446
12,7,5,1,15,0,61817,141,99457,647
43,8,35,8,9,127042,61231,360,15513,496
27,6,21,2,18,15813,1905,61,6547,523
11,5,6,3,10,24453,20455,30,13071,501
9,6,3,3,9,460900,77144,51,45208,493
18,15,3,15,7,90659,93255,394,13160,406
15,9,6,11,15,192281,245445,113,46320,431
29,6,23,0,13,22054,0,58,1566,658
47,25,22,15,18,797404,416874,259,63264,434
5,3,2,2,18,38395,11610,27,0,480
15,7,8,6,6,172487,19404,17,2221,437
10,6,4,1,13,10961,2158,24,3478,529
41,7,34,0,4,316298,0,0,0,675
5,3,2,2,13,26113,3062,20,2707,511
129,18,111,15,8,740734,173074,508,25369,390
89,9,80,6,14,28544,17360,96,2794,482
36,18,18,7,27,1212923,32751,111,6460,453
15,5,10,5,6,71272,78141,59,15095,424
18,12,6,1,12,272476,866,21,1325,518
35,13,22,5,69,366685,96583,129,54286,465
4,2,2,0,10,0,0,1,0,682
6,4,2,2,21,20338,15364,6,10268,633
10,7,3,7,13,27105,27105,78,8713,454
8,2,6,4,7,6950,17541,29,1221,588
14,4,10,0,21,94280,0,1,0,686
16,5,11,2,7,30329,3807,23,3645,534
72,11,61,4,8,391246,38937,59,33059,507
33,12,21,8,36,944967,140397,109,81106,469
12,10,2,0,17,94491,0,12,5122,501
5,3,2,0,4,56311,0,1,0,492
14,8,6,5,6,35872,28217,77,1919,486
30,5,25,3,8,6486,22647,69,5310,517
9,6,3,0,8,25552,0,6,5054,509
15,13,2,3,13,408122,42730,50,31885,552
18,9,9,3,14,42308,18208,51,1702,483
6,3,3,0,14,27411,0,0,0,664
14,4,10,6,7,34780,46798,66,14420,462
11,2,9,1,14,253783,25342,49,0,597
14,10,4,8,7,74536,137868,149,9851,460
20,14,6,0,16,1354961,0,11,0,502
6,3,3,3,7,45880,45878,65,28613,618
48,5,43,1,16,154188,5743,7,3100,650
16,11,5,4,4,80044,20272,74,0,490
10,8,2,8,9,46129,46129,46,9386,388
81,15,66,10,9,344797,134169,272,12313,454
23,8,15,6,8,70887,58334,331,13123,448
7,4,3,1,4,47259,2265,32,2569,462
26,8,18,1,6,40103,2002,5,2002,543
24,12,12,0,7,432803,0,0,0,610
9,5,4,1,12,224514,146983,17,0,625
36,16,20,0,19,281530,0,17,8316,668
9,5,4,1,5,61160,50,48,1817,485
5,3,2,1,13,56099,1105,1,785,584
5,1,4,1,7,261,261,18,261,563
6,2,4,2,13,92258,92257,43,10182,500
17,3,14,0,24,77731,0,6,0,595
11,3,8,4,19,38989,157881,43,35982,494
10,6,4,8,6,75442,66067,124,6762,419
9,3,6,3,13,4932,4932,129,4897,401
43,11,32,8,15,139424,165849,159,3006,501
19,10,9,9,16,124093,16754,72,5212,459
14,7,7,0,15,624742,0,9,0,695
17,5,12,5,7,396581,385814,0,0,502
15,11,4,0,27,1186262,0,0,0,716
15,5,10,6,8,27673,88070,174,13033,478
92,12,80,5,14,621599,7761,66,2910,440
75,11,64,6,14,49362,43702,246,5000,492
14,6,8,0,6,114370,0,0,0,652
10,8,2,6,13,216480,16391,26,7582,427
51,12,39,12,7,88418,92519,289,39951,431
10,6,4,4,9,100182,21593,31,8123,490
7,1,6,0,8,0,0,226,3325,614
52,14,38,7,15,409295,32792,109,5377,494
11,2,9,0,7,40545,0,40,6709,637
100,2,98,3,10,396875,57330,60,0,508
19,13,6,0,14,77038,0,6,759,566
23,6,17,0,11,170175,0,1,1464,477
13,5,8,4,18,49922,23131,50,4842,479
15,7,8,1,8,80153,5105,6,0,606
20,9,11,2,69,260013,15009,44,14110,469
50,10,40,3,10,153067,9243,9,3664,529
16,10,6,5,13,103143,25228,13,1350,446
45,18,27,13,13,475461,343799,331,51156,414
24,8,16,6,10,469851,142619,2,1507,487
10,2,8,2,18,17628,17628,50,1773,555
12,10,2,0,9,121012,0,0,0,591
16,9,7,0,12,423245,0,22,0,423
16,9,7,6,9,345256,18939,26,2675,462
20,11,9,10,10,258066,112185,0,0,547
9,3,6,2,8,28652,8620,50,630,501
20,10,10,10,17,820900,772152,213,151688,511
27,8,19,0,18,337289,0,41,0,517
4,2,2,1,7,3246,1116,72,1116,530
3,1,2,2,4,8388,8388,24,5500,507
10,3,7,2,13,222405,100204,16,0,579
43,13,30,2,11,304207,2828,99,38710,589
17,10,7,7,13,29977,29977,206,11516,425
21,12,9,12,8,75258,69247,379,16674,411
6,3,3,4,13,490592,489318,0,0,500
131,15,116,3,5,59491,20373,5,2012,399
16,1,15,0,9,323131,0,85,324,633
11,5,6,0,17,40026,0,13,48054,589
5,2,3,1,11,109772,109772,20,450,494
28,8,20,0,9,50347,0,13,6778,504
5,3,2,3,6,9905,21727,16,3528,525
25,13,12,8,10,345002,77677,366,19082,432
12,7,5,0,13,1436302,0,24,0,469
21,4,17,1,8,4573,4921,0,0,524
15,3,12,3,12,4621,4621,1,7822,451
20,13,7,11,9,406292,136941,186,21174,430
12,6,6,3,17,44906,20661,24,10228,394
4,2,2,1,10,3794,2850,9,5359,542
18,13,5,9,14,256766,94239,216,18172,525
18,10,8,0,22,614082,0,11,12582,468
20,12,8,10,14,874732,153815,144,42758,497
11,8,3,6,17,345521,63426,101,46057,454
54,10,44,9,14,214342,199494,174,2225,502
11,5,6,0,17,1145188,0,6,0,661
16,8,8,1,7,80380,1996,69,1996,593
20,12,8,8,17,181223,52015,182,17951,425
12,8,4,6,11,71368,24299,91,107,494
13,5,8,0,17,58331,0,2,0,659
14,9,5,1,33,86192,9820,50,1894,494
11,8,3,2,13,58460,645,4,5051,456
34,7,27,2,15,165305,22208,49,1232,509
9,1,8,1,6,544,544,40,1076,481
17,3,14,2,15,2920,2272,34,1332,540
9,2,7,0,15,0,0,2,1155,632
3,1,2,2,7,54010,37367,1,2191,508
11,9,2,9,3,57464,25012,67,8735,408
18,6,12,0,14,44484,0,3,0,611
7,5,2,2,17,10122,24730,116,14709,373
9,7,2,1,13,98013,14829,5,14829,535
11,8,3,0,9,66020,0,34,1134,578
7,2,5,1,7,109915,105410,34,0,549
4,2,2,2,11,3649,3649,16,3187,439
14,7,7,0,13,336242,0,0,0,555
54,11,43,10,16,478802,201267,362,77544,559
5,2,3,2,10,36018,54767,37,0,534
21,10,11,9,14,807718,561916,186,196560,456
7,5,2,4,25,5893,3055,85,971,426
12,9,3,4,11,232084,1253,31,9863,469
4,2,2,1,13,525535,2900,24,2900,508
16,8,8,2,15,121213,3730,19,737,615
12,2,10,1,9,3795,3795,14,4908,660
21,10,11,9,16,510797,72514,495,15130,506
32,11,21,12,8,124511,140530,155,61474,418
20,11,9,8,18,182041,142544,192,32975,375
12,7,5,1,10,608810,2434,1,0,654
15,9,6,0,8,92829,0,6,0,542
15,8,7,2,8,9479,5981,0,0,498
10,5,5,3,10,74987,56110,73,0,494
19,7,12,6,14,607035,32275,78,7849,452
21,15,6,0,8,417450,0,0,0,658
10,3,7,2,14,401633,110018,0,1485,485
41,4,37,4,16,86200,24843,151,15010,455
27,5,22,8,10,95719,84395,335,16905,431
12,7,5,1,6,45599,1565,13,2508,583
48,15,33,11,9,146350,95710,193,28886,415
12,9,3,0,13,936305,0,0,1159,485
19,5,14,8,8,34339,69596,132,29768,441
101,15,86,11,22,1870722,299741,246,43537,387
12,6,6,1,5,35078,3009,27,100,479
43,11,32,11,8,144434,142217,135,13785,441
17,2,15,1,7,3470,1594,18,3100,545
7,5,2,0,11,519965,0,1,0,548
34,6,28,1,7,89589,495,127,3129,520
32,20,12,1,10,57343,4225,80,5871,463
29,9,20,1,13,97420,13349,41,7076,508
4,1,3,1,12,9355,9355,13,0,478
11,5,6,2,8,7644,2741,43,2487,474
16,9,7,4,19,1439475,451412,54,25908,453
11,7,4,0,19,125946,0,5,0,607
52,11,41,11,12,69301,64034,295,14542,482
16,9,7,6,9,494965,28988,101,2452,469
10,6,4,0,9,1746329,0,2,0,605
7,4,3,0,2,169089,0,0,1269,590
6,2,4,0,14,510,0,32,1792,650
19,11,8,6,14,629624,132076,123,84782,367
58,2,56,3,9,31346,31346,117,21125,536
51,24,27,6,17,584086,45890,174,17778,512
8,6,2,1,6,474864,38713,0,0,526
15,9,6,8,10,1204601,613243,97,229386,488
64,13,51,9,15,354351,107431,168,18759,457
9,7,2,0,2,34736,0,0,0,634
8,2,6,2,16,38446,25469,38,15569,479
7,5,2,5,4,43844,42405,221,4620,464
22,8,14,3,16,561599,46110,63,33050,560
15,7,8,5,19,36163,13741,89,7298,506
14,5,9,1,7,92973,721,16,721,495
18,14,4,1,13,103583,251,16,430,501
10,4,6,0,14,349086,0,1,3862,571
15,4,11,0,6,34083,0,37,964,608
5,1,4,1,9,15463,6439,41,4135,548
8,6,2,5,8,29376,27814,25,19422,406
21,9,12,0,10,139020,0,17,4950,520
10,6,4,2,7,824847,17,9,0,552
17,8,9,8,15,193031,312996,136,39943,452
5,3,2,2,7,15624,4267,34,1250,525
56,11,45,4,10,350543,24375,428,6985,429
5,1,4,1,11,12707,11351,0,0,601
29,8,21,3,7,268908,12798,43,12076,602
8,4,4,3,7,9699,9699,32,8468,493
13,10,3,2,10,460777,971,20,0,452
23,10,13,0,10,128382,0,76,276,522
10,8,2,6,8,66834,22213,88,0,496
6,2,4,3,5,5613,6575,63,0,472
34,10,24,1,5,377990,4170,105,4912,473
10,5,5,2,8,46970,42203,14,1671,504
29,8,21,9,14,27833,20942,116,4452,411
8,6,2,5,12,455799,22167,0,0,525
12,4,8,1,9,130186,7551,48,13316,488
27,3,24,0,10,23173,0,0,0,543
15,10,5,6,15,555848,119855,135,66684,498
18,6,12,1,11,78709,1749,1,0,568
4,2,2,2,12,9648,62005,19,0,502
13,4,9,2,15,40415,2296,60,12235,483
7,5,2,3,9,13147,1107,10,1660,465
16,5,11,1,13,188596,2000,1,2000,572
2,0,2,1,3,0,6659,17,6659,597
14,4,10,2,17,94581,31360,39,7622,600
2,0,2,1,15,0,66112,8,0,618
18,9,9,1,9,893732,45518,18,45518,567
7,3,4,4,12,435134,583731,98,396296,553
4,2,2,2,13,16458,26455,48,0,615
10,3,7,0,5,12502,0,0,0,601
18,11,7,1,16,329421,6120,6,990,679
27,8,19,3,15,259496,47591,110,33709,469
9,5,4,2,9,543127,64808,0,0,527
19,10,9,1,22,1358957,399,1,0,714
13,6,7,4,34,18092,23867,51,13314,429
20,9,11,7,18,45338,59647,25,7224,440
21,10,11,4,7,49087,10258,132,6956,524
13,7,6,8,13,62960,76889,122,12552,427
38,10,28,5,10,69159,48397,16,10766,412
19,3,16,2,10,38679,38557,69,0,572
18,7,11,1,20,810878,318185,31,0,541
5,3,2,0,9,16586,0,0,0,533
32,7,25,5,6,29859,7297,221,5008,438
8,5,3,2,15,226750,34072,65,0,580
25,5,20,1,10,81050,4049,15,1700,474
13,7,6,0,9,76990,0,0,0,666
7,4,3,3,9,13857,26311,56,1480,494
4,2,2,1,8,4130,3065,0,0,504
14,4,10,1,7,10676,8550,24,8550,530
6,2,4,0,4,9860,0,16,1026,623
17,9,8,0,12,126383,0,3,0,669
16,4,12,0,7,43467,0,96,1046,598
14,4,10,3,17,19380,19380,81,10668,448
23,11,12,1,14,251943,9845,33,9845,515
13,2,11,3,11,10945,14331,45,1466,427
6,2,4,5,14,7413,30371,0,0,616
10,1,9,3,17,103181,103181,98,0,494
7,4,3,1,11,22805,1186,3,2166,596
75,10,65,3,12,28256,18611,55,0,548
35,12,23,9,17,91570,46319,127,9609,419
26,21,5,1,11,332894,2970,14,2970,504
11,7,4,4,10,34274,4487,58,2383,478
7,4,3,2,8,75415,72174,38,64468,459
12,4,8,4,14,5901,14939,48,2440,482
20,5,15,4,22,545269,430191,119,102006,549
8,6,2,6,7,32842,32842,64,12020,494
19,7,12,0,12,232834,0,1,7,591
48,7,41,5,10,76879,57972,293,45041,477
24,4,20,2,7,263843,170484,41,2415,522
13,9,4,10,10,176502,171235,128,79855,449
8,3,5,2,12,3487,3487,26,1884,425
43,11,32,7,7,31734,14522,247,1237,455
4,1,3,1,20,34520,34520,34,0,532
15,13,2,10,13,96719,78878,74,10989,449
29,9,20,8,7,48329,43780,312,18390,442
10,5,5,4,10,12904,5224,76,2828,531
23,11,12,9,12,90088,89481,334,33744,400
15,9,6,8,17,877196,337000,163,10095,485
14,6,8,3,15,425603,48040,190,19156,524
87,13,74,9,15,154101,97316,87,9160,459
5,3,2,2,11,17014,7960,1,1250,522
15,10,5,11,6,52098,63481,112,17192,459
19,5,14,0,3,53842,0,3,7126,464
10,5,5,8,5,331748,484992,72,751,510
12,5,7,2,7,87715,4257,28,2754,449
17,9,8,6,13,58194,34231,21,555,455
11,4,7,4,9,29884,36857,70,18224,608
9,3,6,4,11,22212,23227,233,15877,513
22,4,18,1,7,16003,2068,0,1120,591
8,4,4,4,13,18690,72778,37,217,478
28,13,15,0,10,549257,0,3,0,559
26,7,19,5,15,13227,14474,103,9347,419
23,5,18,2,10,59382,57114,53,54161,431
18,7,11,5,11,257009,12846,106,2409,462
14,3,11,1,7,302150,1490,1,1490,495
95,5,90,7,17,20690,28377,67,12840,455
8,6,2,4,14,39262,13436,49,4686,449
30,14,16,0,14,138645,0,17,2525,632
14,8,6,7,17,219383,216030,185,0,543
17,8,9,6,3,158172,42925,53,22503,466
12,10,2,10,11,51341,51341,31,5044,497
25,4,21,3,13,2043,13820,0,0,513
14,5,9,1,13,55147,18141,25,4489,455
9,5,4,0,8,10941,0,7,16414,565
11,5,6,3,17,13064,11802,45,5278,514
33,14,19,0,15,592108,0,39,175,482
6,3,3,1,11,18676,15033,95,19883,535
33,2,31,1,8,3643,1447,62,2305,539
25,3,22,3,12,20291,12508,31,9576,475
17,10,7,0,15,225616,0,31,0,598
8,6,2,3,8,1499,2428,60,1120,486
15,6,9,3,20,624149,41073,20,3300,465
54,18,36,10,16,270678,28922,131,5604,435
5,3,2,1,37,53744,5518,25,0,492
13,7,6,0,6,351070,0,0,0,587
18,12,6,0,25,1642224,0,0,0,610
14,7,7,2,19,16160,2679,32,1905,443
10,5,5,5,9,44579,44579,63,26430,504
17,3,14,4,12,380396,32618,79,12111,444
13,6,7,1,4,110437,11989,39,11989,510
6,1,5,0,13,20654,0,0,1598,590
4,2,2,2,3,36415,23189,35,0,415
25,7,18,5,15,44201,23085,52,10017,448
35,10,25,4,9,91900,22039,89,1647,442
32,10,22,0,17,802250,0,20,237,545
16,10,6,7,4,610546,16064,63,11389,366
11,5,6,3,19,338060,13895,132,9348,529
38,15,23,12,18,785063,489625,268,67348,421
14,12,2,12,14,57739,56131,71,11917,453
4,2,2,2,7,11952,18318,36,11472,509
15,7,8,1,8,24994,24478,119,24478,441
7,3,4,2,8,311051,2762,0,0,451
18,9,9,8,14,166632,66469,142,35000,453
5,3,2,1,13,5607,1143,22,1143,658
47,14,33,8,18,255586,119734,149,24754,622
9,2,7,2,11,27261,27261,74,4215,586
7,4,3,4,11,429027,56575,7,5850,482
7,3,4,4,4,9699,14024,96,4614,486
12,5,7,2,6,38159,6243,114,220,516
23,13,10,3,15,618035,15311,13,7500,522
9,3,6,0,6,78211,0,0,0,624
7,1,6,0,12,0,0,6,0,621
11,7,4,5,13,1583522,320181,121,119261,438
37,21,16,12,13,279794,174794,188,4080,446
31,12,19,9,8,94227,66301,81,8121,521
8,5,3,0,12,11566,0,0,38683,612
22,6,16,1,24,283387,48927,9,2318,553
13,8,5,3,9,86122,20198,49,8986,424
20,11,9,5,11,709854,153085,93,4908,446
18,7,11,2,7,135765,2019,26,5827,464
43,10,33,9,26,180931,186240,356,12249,442
42,8,34,2,9,442213,1885,221,2106,440
3,1,2,0,5,1156,0,6,1923,507
5,3,2,3,7,19769,33150,26,0,513
22,7,15,7,7,96595,84965,125,6823,483
6,4,2,2,7,7925,7925,92,7146,573
41,16,25,0,19,1019177,0,1,2898,605
11,8,3,8,5,72163,66970,143,0,509
45,6,39,1,11,426839,325,105,57252,494
8,4,4,2,9,17654,7935,28,5725,459
7,5,2,1,15,107750,1513,1,990,491
40,6,34,4,9,29084,29454,105,1990,482
8,6,2,4,11,300881,29951,44,17191,498
5,3,2,3,12,45467,36274,19,9608,468
29,10,19,1,27,300935,8445,55,6909,500
10,5,5,7,8,22520,43950,105,340,442
49,3,46,1,7,25313,2877,16,3374,555
33,17,16,0,23,2081671,0,6,193,515
14,9,5,6,8,37443,19023,30,0,487
5,2,3,2,12,7229,7229,30,5979,495
17,10,7,13,7,61548,79625,211,12810,413
73,18,55,2,69,317622,28482,15,26122,514
5,2,3,3,9,7077,7953,54,0,546
7,4,3,4,9,4752,17155,71,0,452
12,3,9,2,14,12314,12314,20,9513,545
25,7,18,8,9,110827,124626,122,29098,473
8,6,2,1,14,85212,4190,0,4519,476
11,3,8,1,14,67033,67033,47,67033,560
73,14,59,4,19,503080,22133,57,84152,389
5,0,5,2,3,6696,6696,20,0,573
25,13,12,8,14,3422466,1996913,2,3413,455
14,11,3,7,14,906579,81924,0,0,443
6,4,2,2,15,312381,2341,35,3404,522
54,12,42,7,14,218146,63832,71,16255,427
16,10,6,9,6,96069,57194,226,16110,432
12,10,2,1,19,510374,50,23,0,517
14,2,12,0,8,5449,0,16,1609,644
13,11,2,1,7,401024,1638,6,2973,512
35,10,25,9,19,179298,259823,82,139012,483
24,22,2,12,11,584480,43850,28,8943,471
13,11,2,8,21,227653,35600,120,7240,441
14,11,3,8,16,410790,67262,155,26919,414
13,5,8,9,5,220950,346053,122,106578,416
9,3,6,0,5,20190,0,4,1441,502
17,8,9,5,8,107010,47661,76,3826,501
21,3,18,3,7,4165,4165,30,2183,463
15,9,6,8,9,54195,50155,306,12596,447
12,6,6,2,8,32216,11676,181,1902,504
28,17,11,20,8,210270,246585,325,22786,445
30,16,14,9,14,128641,39944,66,6794,455
73,8,65,6,13,405306,96234,105,322869,395
8,5,3,5,23,10112,7476,56,3878,491
20,9,11,7,17,45348,38041,64,26919,435
23,9,14,5,18,223860,21343,60,5317,445
34,9,25,6,19,37310,25283,134,9933,458
24,3,21,1,8,1094,2933,53,1200,565
45,8,37,5,13,105358,113030,108,19498,463
12,2,10,2,10,769,12352,42,11583,526
15,6,9,1,7,273079,6016,35,6016,626
14,9,5,1,8,394603,2834,0,157,421
16,10,6,0,12,120866,0,4,0,668
21,6,15,2,17,69933,3753,18,4503,502
10,0,10,0,14,0,0,0,3457,578
12,6,6,3,12,46301,43343,72,474,495
17,1,16,0,17,0,0,0,4410,604
3,1,2,2,3,0,20084,18,0,618
9,6,3,6,5,105108,40972,81,6128,494
12,10,2,5,2,233821,7740,24,0,513
24,15,9,3,12,652968,3587,101,29012,431
14,10,4,8,23,158272,137490,183,2871,435
193,21,172,13,14,281697,137700,249,9452,396
31,8,23,1,21,26710,4423,97,7795,541
4,2,2,0,12,5375,0,0,1547,626
6,1,5,1,8,1905,1905,36,1905,607
3,1,2,2,8,4791,39862,39,0,463
33,11,22,6,17,608432,167693,105,6236,444
37,24,13,0,26,1662964,0,5,4025,644
14,5,9,3,9,96856,26406,45,3184,481
5,2,3,0,9,0,0,4,1717,529
18,5,13,4,14,388034,34879,65,5412,459
16,10,6,4,7,549092,40478,49,29372,466
13,8,5,0,5,145673,0,12,0,565
9,6,3,6,17,52903,47069,83,16989,541
22,6,16,7,8,29832,35930,77,16690,429
11,4,7,3,6,20166,20435,45,1376,521
22,8,14,2,13,290276,48425,56,4651,492
8,5,3,0,7,129279,0,0,0,665
21,6,15,5,15,32469,27469,20,11970,485
30,7,23,6,8,47699,83436,116,5659,493
14,3,11,2,13,6898,3770,5,0,472
18,5,13,5,14,32935,17484,90,8050,604
13,3,10,0,9,596447,0,14,0,480
7,3,4,3,8,17005,17005,76,11444,458
14,3,11,3,8,9016,24469,69,534,577
13,9,4,1,6,140197,1896,1,1896,469
26,15,11,3,10,237242,16941,34,0,469
11,4,7,5,18,70320,76259,79,28602,465
23,13,10,7,20,2861062,199386,94,28649,434
45,0,45,0,8,0,0,10,438,681
6,4,2,0,4,57407,0,0,0,596
30,9,21,4,9,668588,13543,66,9573,382
10,8,2,9,7,50828,59013,203,5627,453
16,2,14,2,19,24367,17859,0,0,603
14,8,6,0,11,342419,0,4,767,625
13,4,9,4,8,959194,226288,63,1140,475
19,9,10,6,9,43797,32382,154,10203,429
15,6,9,2,16,10650,10650,37,10235,400
14,9,5,1,11,374620,368,1,1304,477
99,3,96,0,10,2027,0,7,0,696
10,4,6,5,13,38947,35532,48,7080,484
16,9,7,8,18,60817,60817,179,8223,442
21,11,10,0,11,870714,0,2,0,547
10,4,6,2,11,369263,2626,43,1728,550
17,2,15,0,11,0,0,32,4181,576
31,17,14,14,17,1231753,98289,166,13677,395
5,3,2,3,7,60811,54324,57,3942,459
5,1,4,0,6,0,0,0,0,765
41,18,23,3,23,472164,15620,21,2407,452
3,1,2,1,5,13992,6045,8,0,620
13,6,7,0,20,229355,0,24,19578,550
13,9,4,9,10,62735,78410,179,3868,454
14,4,10,1,13,101860,4275,25,2755,579
8,3,5,0,2,15130,0,17,7465,586
13,1,12,0,7,0,0,212,1011,558
14,3,11,3,14,13855,13855,46,6093,518
17,11,6,13,9,235837,179124,267,417,438
25,13,12,1,13,320939,631,18,5064,551
10,7,3,4,12,35066,6407,0,0,528
10,5,5,2,22,730496,86961,7,368,515
18,7,11,6,10,172492,98098,71,28721,472
3,0,3,1,6,0,11852,6,0,622
9,0,9,1,13,3008,3008,15,21425,567
9,7,2,2,5,98086,31356,0,0,506
15,5,10,6,6,18322,22788,21,7888,439
65,21,44,18,11,483802,144501,386,914,488
10,4,6,1,7,64543,48564,27,0,534
15,4,11,3,7,16850,21062,28,11835,524
6,2,4,4,10,4919,7509,70,2759,447
5,2,3,1,10,4529,4529,43,0,459
13,9,4,9,8,164174,145764,140,2070825,489
16,10,6,0,15,68258,0,28,2385,453
7,1,6,1,9,0,7909,31,218,648
44,8,36,3,8,77660,9068,325,13152,433
27,5,22,4,21,174329,144005,101,30324,427
37,6,31,0,30,721311,0,1,0,710
18,9,9,0,8,284435,0,1,1624,584
7,2,5,2,14,496090,4203,26,3768,491
16,8,8,6,14,47096,39105,103,13698,455
19,8,11,3,14,460396,223506,0,0,529
15,4,11,1,17,911547,15481,16,619,555
11,8,3,4,15,141808,68548,184,3641,481
11,9,2,4,13,457958,27590,31,18869,464
8,5,3,3,8,62920,64252,45,0,514
5,2,3,2,17,1135,1135,120,837,636
5,2,3,2,11,28058,1636,9,9827,501
5,2,3,0,4,57897,0,1,966,563
9,4,5,0,15,1978684,0,13,0,563
4,2,2,3,10,17227,16910,0,0,454
14,6,8,4,7,63651,20966,62,9199,482
8,4,4,4,8,90783,83021,0,0,633
68,16,52,7,12,167288,44695,98,12285,335
3,0,3,0,7,0,0,19,0,555
8,5,3,7,8,30712,61530,152,25476,447
11,4,7,0,7,33030,0,0,0,662
10,4,6,3,9,34535,5479,76,2550,546
12,4,8,4,9,444666,35622,110,0,513
17,5,12,5,14,111438,110271,82,68586,448
11,6,5,4,11,354435,24371,82,0,482
3,1,2,3,13,14545,19777,32,5232,654
7,5,2,5,7,15423,5129,119,2974,463
6,4,2,0,7,73890,0,15,0,504
26,10,16,1,13,213763,959,6,1229,516
8,3,5,1,3,35342,623,25,1191,541
17,5,12,3,18,50113,50113,58,25124,557
22,8,14,6,20,61657,39627,229,10445,424
5,3,2,1,7,3073,3073,127,3073,588
40,3,37,0,19,2955,0,24,2931,639
9,5,4,1,23,482030,508,16,0,670
10,7,3,5,13,285948,206207,56,1688,478
7,5,2,3,6,13796,30485,35,5204,468
27,8,19,0,9,406207,0,6,0,479
4,2,2,0,6,164,0,0,0,708
43,13,30,2,18,3632036,987725,147,3994,503
13,5,8,2,17,317595,139595,38,75561,464
17,11,6,5,6,184269,99075,0,0,452
9,1,8,0,10,42102,0,1,1386,656
24,7,17,3,18,99109,56527,73,1113,526
17,9,8,2,16,136784,4715,18,2009,471
15,6,9,3,14,69145,50701,84,21025,535
5,3,2,0,8,144069,0,28,5498,532
46,7,39,0,10,85480,0,176,1072,508
13,7,6,2,12,402761,87577,37,2480,493
32,13,19,8,10,361876,136976,562,96015,437
13,7,6,2,28,503213,8064,11,21005,551
14,2,12,1,19,55205,4087,12,4087,499
14,4,10,3,12,13116,13116,26,3300,500
11,8,3,0,15,404760,0,8,0,658
10,4,6,4,7,24574,22764,65,4580,543
18,4,14,0,12,13641,0,14,1668,581
10,6,4,3,8,18243,10486,41,6317,518
7,2,5,3,8,40513,65456,63,38983,501
21,14,7,2,8,226820,6110,67,5087,512
16,4,12,0,9,96347,0,6,1556,609
11,6,5,2,7,56760,4685,35,4455,508
6,0,6,0,11,0,0,34,0,611
13,2,11,1,8,424,424,54,2563,479
5,2,3,2,6,52806,69469,32,0,474
59,2,57,0,14,19932,0,64,43595,572
11,5,6,6,4,129683,129683,127,67271,509
42,9,33,7,14,942254,22513,356,10836,474
22,10,12,4,12,284078,9305,65,1748,513
8,1,7,0,8,10767,0,4,0,662
11,4,7,2,11,49429,26484,44,3857,445
24,7,17,2,11,171752,8418,57,70196,467
9,6,3,6,7,65008,64114,94,0,440
19,12,7,3,7,188226,6945,15,0,467
9,6,3,6,6,59335,59727,103,0,482
17,7,10,7,12,706510,50428,108,18654,429
9,6,3,5,8,17316,15928,84,6111,435
17,7,10,3,8,39949,1803,149,1670,482
18,9,9,5,19,481356,156701,98,596,501
31,9,22,7,9,229297,123579,107,43200,465
5,3,2,4,8,11756,16200,148,12252,462
6,3,3,5,7,63171,63171,297,31969,482
16,6,10,3,14,13095,8180,39,11028,556
10,5,5,1,32,699,98989,16,0,632
53,14,39,9,13,1281289,512325,250,238971,426
11,1,10,1,4,477,477,7,484,476
6,4,2,2,14,378105,31454,24,22270,511
6,3,3,5,9,30461,57375,330,25534,612
22,9,13,0,10,1006914,0,9,0,554
14,3,11,7,9,131930,108542,16,7194,476
12,8,4,7,8,42258,41923,49,15911,409
13,7,6,1,4,230631,218,18,218,498
20,10,10,6,21,374880,100277,107,42694,433
10,3,7,1,9,412503,1020,11,1053,545
4,1,3,0,15,0,0,1,1269,681
17,6,11,2,9,162409,18042,9,0,568
7,5,2,4,9,27474,26894,5,12280,541
8,3,5,0,4,197683,0,0,0,657
56,14,42,11,10,190395,184090,258,19690,437
13,3,10,3,7,17907,28527,0,0,564
11,5,6,0,3,38329,0,46,687,502
57,11,46,6,21,249505,190148,146,74064,536
17,3,14,3,15,42235,9210,50,3907,532
14,12,2,12,7,22948,27145,90,2893,416
21,10,11,0,6,113808,0,13,5818,573
103,11,92,1,11,104627,40210,76,608,574
12,5,7,2,11,81278,16636,19,15016,514
53,6,47,5,14,76243,14492,100,4866,481
53,20,33,0,16,755772,0,11,774,592
16,6,10,1,13,43258,10597,20,265,526
10,3,7,1,12,4116,2618,24,2618,497
13,10,3,7,6,309930,56948,156,28260,456
20,9,11,1,13,151441,4174,19,0,623
62,6,56,2,10,320032,9214,50,1443,615
13,7,6,2,7,61218,3067,40,2009,479
5,2,3,1,7,19479,19479,147,19479,550
13,9,4,9,17,94560,93229,131,16207,466
9,5,4,3,15,32328,14821,97,5997,567
5,2,3,1,18,10316,3305,33,3306,674
45,11,34,1,16,456112,33536,0,0,528
2,0,2,2,8,118888,120731,0,0,622
26,9,17,4,9,71316,15261,25,12731,541
18,9,9,8,6,20391,25181,160,24258,413
69,12,57,7,19,387454,115144,135,5202,513
11,5,6,5,14,271581,479799,101,0,523
21,8,13,4,12,28551,983,5,347,501
9,5,4,2,8,636298,3688,43,0,514
56,6,50,0,19,129376,0,5,4600,568
8,4,4,3,19,24770,37191,16,4204,552
14,6,8,3,18,456483,288039,44,5911,529
4,2,2,2,4,3908,2590,29,1500,564
30,6,24,7,14,25915,30343,57,35730,461
11,7,4,3,11,919837,63501,85,34448,521
36,10,26,3,8,212164,3246,131,3133,406
39,6,33,4,13,18862,21225,21,3025,558
7,5,2,2,31,30046,12991,52,1191,518
49,15,34,11,26,407035,284842,457,66327,468
6,3,3,0,16,9066,0,1,0,656
12,4,8,2,12,18758,4618,51,2668,482
8,6,2,2,10,31342,15364,20,0,520
18,6,12,5,13,56123,47852,73,9320,476
86,9,77,3,17,21444,2513,378,5682,453
6,4,2,0,11,203416,0,0,0,498
33,6,27,2,17,15427,15427,283,11121,511
55,13,42,1,14,211768,1476,14,14274,684
7,3,4,0,8,214944,0,7,1142,652
15,8,7,4,33,582704,601876,94,88257,465
15,3,12,3,15,315927,172111,39,12097,575
18,6,12,3,11,79124,74409,33,28266,492
56,6,50,3,8,52695,18244,34,7360,448
16,10,6,10,8,48695,47695,118,17495,412
6,4,2,4,14,66932,60058,0,0,490
7,4,3,1,14,187764,3025,2,0,541
7,1,6,0,7,0,0,57,878,514
37,9,28,5,11,82672,58060,42,14682,462
11,2,9,0,18,477806,0,45,840,534
25,11,14,5,13,178749,10281,43,4031,505
29,15,14,0,17,731338,0,4,0,636
9,5,4,4,6,15295,53093,32,4542,386
4,1,3,3,8,15909,34878,31,10148,510
38,14,24,3,14,714569,10888,196,3961,459
10,3,7,3,9,27509,27509,11,10029,506
7,3,4,3,8,21702,34671,46,0,454
28,3,25,1,13,23691,6656,9,6656,520
5,2,3,3,3,20161,20161,57,1800,471
33,12,21,3,13,156316,22849,126,12297,508
3,1,2,1,6,13929,13929,95,13929,616
12,7,5,1,17,41054,4608,9,4608,488
12,9,3,6,8,657889,254648,128,0,502
7,5,2,4,15,7869,151727,72,6443,447
8,5,3,2,7,13980,869,10,320,439
12,10,2,6,20,128739,28073,122,30809,420
7,3,4,4,8,26133,42804,0,0,487
11,6,5,4,6,19581,4850,29,1521,449
129,9,120,4,18,102059,53878,195,27397,431
13,4,9,1,11,52035,4300,68,13900,513
14,6,8,6,17,119347,329121,148,0,490
5,3,2,2,15,12579,12479,7,845,512
9,5,4,0,11,10641,0,35,0,426
30,8,22,0,9,220476,0,1,0,658
16,4,12,0,12,162221,0,41,2309,540
13,10,3,7,5,100683,88197,140,12149,446
21,4,17,8,10,125995,150009,165,7602,492
17,9,8,7,15,43000,32014,84,13969,407
15,9,6,2,30,846411,41614,40,0,565
21,15,6,0,11,228039,0,28,4737,580
7,4,3,2,8,13399,8605,48,458,503
13,6,7,4,9,174066,174066,61,20164,443
4,2,2,2,7,2620,2620,22,1421,458
22,4,18,2,18,17464,10864,52,2476,505
63,21,42,8,16,402673,75535,192,51399,469
18,4,14,1,13,34670,1116,2,5768,544
18,8,10,4,16,51186,51185,148,33303,505
20,4,16,2,19,244227,226182,26,225172,536
7,4,3,4,14,482804,92917,67,0,489
9,5,4,4,9,19305,19305,312,15572,501
18,6,12,2,8,73346,73346,56,1350,445
9,3,6,0,14,318218,0,0,168,626
12,5,7,1,14,17901,15151,26,1326,529
11,5,6,2,13,530187,10715,19,0,474
3,1,2,1,19,709,709,15,709,573
39,13,26,3,13,424098,5258,227,10158,461
9,4,5,7,9,81397,115243,111,36508,456
10,4,6,1,11,408178,38309,4,0,454
25,16,9,8,12,539943,202719,34,8393,382
16,4,12,7,8,92433,143953,86,8021,577
13,6,7,2,9,1217013,3720,39,0,475
6,3,3,0,7,50156,0,23,0,625
15,9,6,5,14,115567,36394,133,17913,387
9,2,7,1,9,0,20633,19,0,551
9,5,4,5,6,10942,10942,322,4544,449
13,9,4,8,8,22495,20880,36,6940,417
11,5,6,3,7,62174,3433,53,1503,613
23,5,18,1,11,42568,5315,16,5315,536
147,11,136,6,7,30137,65669,91,8629,439
8,5,3,2,8,100787,2888,18,2838,471
15,12,3,7,20,747241,180373,109,34393,507
10,8,2,0,10,538861,0,16,5849,491
5,1,4,1,9,84461,344,1,0,635
23,10,13,3,12,114411,43468,25,20248,359
7,3,4,4,13,46508,60740,81,26841,481
15,10,5,8,13,120869,137349,120,0,488
29,8,21,7,11,46718,46718,62,20891,438
15,8,7,1,8,161490,882,6,0,612
4,2,2,1,10,9247,2504,61,0,547
9,5,4,3,22,41176,13161,0,10141,493
5,1,4,2,14,82299,46292,0,0,645
141,8,133,4,6,400387,13616,17,5366,482
12,9,3,4,9,33811,5437,0,0,469
39,24,15,7,4,180065,14495,72,6740,476
11,7,4,7,7,69387,57953,331,19865,376
5,3,2,3,4,27497,12609,16,1092,581
17,4,13,3,16,298663,16015,47,7992,509
5,3,2,2,12,348334,128817,18,90769,527
45,9,36,3,16,539955,15203,42,12692,572
21,2,19,0,10,456,0,1,857,670
15,7,8,0,7,118754,0,8,0,555
8,2,6,2,10,2064,2064,53,1964,618
25,4,21,2,11,8246,2695,112,22830,525
15,5,10,0,14,206030,0,1,1100,682
10,7,3,3,11,41216,8140,192,6825,498
12,6,6,5,6,245553,25637,41,20206,497
16,7,9,8,13,122024,131616,148,49503,491
17,8,9,7,20,151976,135436,420,34365,419
11,7,4,6,8,23200,22878,496,14643,512
29,5,24,3,7,56006,37156,62,0,495
15,4,11,6,5,188147,248740,77,107946,511
17,10,7,17,6,750879,1089003,149,154795,431
16,8,8,4,16,391873,41232,62,7377,448
40,14,26,17,13,411441,521753,280,270133,418
22,4,18,0,12,290693,0,56,0,604
24,5,19,2,13,321106,34272,13,31169,435
58,13,45,15,16,267149,307680,613,27290,428
8,5,3,2,9,33532,198292,40,2981,440
26,10,16,4,7,104664,8701,23,1717,477
12,8,4,1,21,302389,2869,14,0,529
5,2,3,2,11,20734,20734,66,1148,462
10,3,7,1,10,43357,40430,25,0,482
3,0,3,0,7,0,0,197,14696,624
7,3,4,0,3,30165,0,1,0,623
5,1,4,1,11,76103,76103,0,866,474
8,5,3,1,7,20641,1709,6,300,633
12,6,6,4,9,405884,23083,82,0,505
4,2,2,2,7,454679,11322,0,0,511
20,5,15,3,11,80017,29126,114,13956,444
5,2,3,0,8,14919,0,38,273,574
11,5,6,3,16,63457,39434,0,0,521
69,19,50,0,15,1651280,0,5,1295,606
22,7,15,3,17,291268,15203,43,0,511
4,2,2,1,14,98554,46243,11,46243,524
13,5,8,4,15,41059,41059,55,22351,444
7,4,3,1,6,379420,668,11,668,566
13,8,5,12,7,122739,165900,140,33774,418
12,8,4,6,8,358447,27495,187,13273,522
6,2,4,1,13,549,549,22,549,472
19,11,8,4,5,1512595,33597,36,23504,444
10,8,2,7,15,161407,142917,70,63136,450
11,5,6,3,12,10172,9702,52,16614,444
11,9,2,7,7,1025257,186010,120,2523,536
16,6,10,4,10,29470,29470,68,17961,534
15,9,6,5,10,60128,30255,97,0,497
25,8,17,10,11,144051,154402,57,48872,447
20,12,8,0,12,1357762,0,1,0,625
58,15,43,6,13,214547,21987,297,6524,488
18,8,10,2,13,52536,37935,195,35503,459
14,7,7,8,8,323723,333692,85,286142,477
14,10,4,1,10,465235,47579,21,0,531
7,3,4,3,18,62826,51677,81,13693,636
5,2,3,2,8,17060,24394,13,0,495
10,8,2,9,9,217925,160476,163,42623,421
20,2,18,3,12,2249,133838,71,0,500
7,5,2,2,6,202507,101950,50,0,532
7,5,2,6,13,55254,63252,56,20834,429
5,3,2,3,10,57396,54543,10,34990,459
37,18,19,2,17,394451,1372,11,3456,503
17,8,9,3,22,269891,11573,59,5765,508
12,2,10,1,13,27408,24315,25,0,648
10,2,8,2,18,14027,14027,60,12070,635
11,3,8,0,5,146650,0,1,235,573
15,9,6,8,17,275834,215072,112,20302,501
28,10,18,10,17,101360,128367,150,29852,418
7,4,3,6,6,69871,123572,75,66757,423
7,5,2,5,7,22688,30298,78,12512,561
16,5,11,5,7,89787,53071,108,17147,414
7,4,3,3,8,11012,11012,347,7734,449
10,8,2,2,5,68363,5787,9,2000,528
26,11,15,1,10,65728,29078,33,2460,451
24,7,17,1,16,908737,3592,39,7917,495
23,13,10,1,7,146931,4309,2,4309,520
29,12,17,2,14,223573,2945,32,2218,552
14,5,9,0,11,3292,0,0,0,680
30,6,24,3,12,76680,11703,52,5694,435
12,9,3,4,19,185705,79142,0,0,453
19,8,11,1,15,194837,751,5,0,630
7,2,5,3,14,13946,15762,187,17559,496
25,13,12,2,9,708540,10792,51,7500,437
10,6,4,1,8,200584,397,21,16,569
12,7,5,2,18,979131,15695,31,8546,478
7,4,3,5,22,521690,86851,117,0,534
7,4,3,0,12,6314,0,0,0,614
20,11,9,7,12,293133,112466,310,93408,410
3,1,2,1,4,846,846,54,846,597
4,1,3,1,12,24425,24425,0,0,619
10,4,6,4,8,24703,30946,68,14390,539
25,3,22,2,18,5384,1703,35,6112,558
11,8,3,7,13,41287,29974,108,16239,469
17,4,13,4,19,10280,23965,52,4971,507
29,5,24,5,15,115295,88321,109,50386,463
8,3,5,1,9,23334,11761,0,0,602
7,2,5,1,12,435,154,2,0,572
18,13,5,2,18,2672946,126442,62,0,516
8,3,5,3,9,11936,19739,95,5875,506
14,7,7,5,13,579271,218908,66,1250,471
11,8,3,6,7,55998,55777,128,19854,403
30,4,26,1,10,49288,4150,14,4150,656
11,5,6,5,13,72889,58465,57,18908,435
27,9,18,1,17,478244,1289,15,1565,617
30,5,25,2,10,177247,24784,50,5020,536
15,12,3,14,7,564804,705997,360,261532,412
10,4,6,3,16,37820,50368,65,20925,507
6,3,3,3,7,21212,21212,97,9456,512
9,6,3,6,11,58483,77019,65,22599,410
11,8,3,1,17,250252,7680,21,7680,548
25,5,20,3,13,39211,29292,164,23345,586
9,1,8,2,14,1500,6857,26,5357,454
10,5,5,3,9,410428,12850,79,2666,471
18,15,3,4,6,93942,227,26,228,505
10,4,6,1,9,360370,1377,7,1377,532
19,10,9,0,20,127332,0,1,0,618
56,8,48,2,15,163391,18849,1,1200,523
7,5,2,2,9,2626,3396,34,0,510
23,5,18,3,13,21627,2055,66,1884,537
19,4,15,0,11,265759,0,9,3439,669
8,5,3,2,8,45299,44899,26,13824,483
30,2,28,3,8,39197,39466,321,27910,587
14,11,3,3,12,478789,40632,67,26943,608
9,4,5,0,11,109583,0,30,0,524
39,19,20,14,11,461827,90084,481,14403,447
9,3,6,0,3,30857,0,0,0,609
19,10,9,11,14,146084,218331,186,14874,388
18,3,15,0,4,23871,0,7,6162,670
11,5,6,3,9,63012,46091,26,0,455
16,7,9,5,9,39582,25556,76,4158,522
19,7,12,3,9,447352,72639,48,61201,475
11,8,3,6,8,301280,44527,122,0,457
21,9,12,5,11,328732,18448,74,4275,505
37,10,27,6,8,333838,45026,93,10016,462
13,6,7,2,12,23893,8849,19,0,495
19,10,9,2,8,173170,7304,193,6918,528
19,7,12,2,8,154045,1534,0,0,488
12,7,5,0,12,246741,0,0,0,548
21,10,11,3,8,786167,101919,100,30,491
17,9,8,7,7,74925,83034,122,0,486
21,8,13,1,14,1827995,2520,10,1170,540
35,18,17,0,21,448316,0,32,0,506
28,8,20,5,7,40098,47050,177,9450,461
25,9,16,9,8,61912,66088,259,28021,439
6,4,2,0,21,5939,0,5,930,543
15,7,8,6,19,30239,32740,12,12694,461
21,5,16,2,16,284131,5343,42,9388,486
17,7,10,1,12,290672,4203,14,0,546
8,5,3,3,10,15250,13199,70,4064,418
27,15,12,8,17,1010749,291444,41,0,421
20,5,15,5,6,27217,25285,100,8640,514
9,5,4,4,13,23811,23811,113,15916,509
56,22,34,6,15,2592786,111128,110,22429,340
13,10,3,1,33,541677,52,32,588,446
9,7,2,6,13,217718,222263,0,0,459
79,14,65,13,14,76494,71290,299,21454,413
6,4,2,3,9,16647,11084,17,7200,474
29,4,25,10,8,79098,87874,187,15085,470
11,6,5,3,12,253873,28576,69,3757,467
6,3,3,2,7,8605,838,64,644,579
10,4,6,0,16,91300,0,16,0,721
22,9,13,7,14,379132,44580,123,8798,422
22,5,17,4,12,6073,5767,69,2578,530
19,13,6,1,13,507891,1238,18,0,563
41,5,36,8,19,244701,244701,121,15516,506
12,7,5,4,18,33483,21349,86,4141,469
18,6,12,1,3,191087,1864,4,1864,597
10,3,7,1,18,369735,13559,41,13559,540
6,1,5,0,12,366699,0,0,0,591
13,7,6,3,18,548851,27326,108,22220,495
7,4,3,3,15,651341,54020,49,467,507
13,4,9,0,8,65584,0,7,0,554
8,6,2,0,16,1076664,0,0,0,702
12,7,5,4,19,419722,118463,39,13416,469
25,8,17,2,10,68738,6342,174,5903,452
7,3,4,4,13,24716,17974,9,12250,447
6,4,2,0,7,30055,0,0,0,433
13,6,7,3,13,225932,6623,63,4956,528
18,13,5,4,13,317658,7991,1,2167,470
33,13,20,3,15,565554,10975,1,4408,497
23,10,13,10,8,90930,116480,352,40216,413
14,7,7,1,16,261750,3494,6,7184,444
36,6,30,5,12,66717,51122,96,2571,486
17,5,12,4,11,314754,41477,67,30498,543
25,9,16,4,22,86553,7550,32,4387,431
6,3,3,1,4,14686,6291,9,6291,479
20,14,6,7,9,62038,47407,113,14962,407
14,5,9,3,30,122496,133917,28,0,694
9,3,6,3,12,19262,19262,44,8930,518
39,12,27,6,10,141332,67146,167,31563,423
9,2,7,4,6,15025,11268,43,0,482
17,3,14,1,13,235812,10330,51,0,517
16,2,14,2,15,7561,18757,44,4741,530
15,9,6,2,7,273717,9328,21,25044,396
12,5,7,6,12,65119,81780,83,24765,480
74,8,66,4,9,526204,21535,316,18231,414
54,16,38,10,12,300870,66249,56,12077,458
8,6,2,5,7,7023,7023,14,1563,476
27,11,16,4,19,358769,46741,42,5362,469
16,9,7,0,8,203911,0,15,410,625
14,3,11,1,6,55357,908,18,2217,494
21,14,7,1,12,855510,148,31,0,568
12,8,4,5,14,1404143,1392564,48,51020,415
8,1,7,1,9,33582,33582,17,2233,485
6,3,3,1,4,50804,3667,117,4870,482
8,2,6,2,14,8602,12593,0,0,499
6,3,3,1,7,2883,1453,15,1453,538
8,6,2,5,10,246353,6212,72,963,447
7,4,3,4,13,563868,32257,84,4094,441
11,7,4,0,9,29084,0,22,0,489
25,10,15,1,14,497514,1161,7,2134,579
28,13,15,4,14,635732,8692,8,4187,417
9,4,5,0,18,60792,0,29,2115,529
12,6,6,1,9,139271,514,11,2269,635
8,3,5,2,11,531123,37039,10,3704,461
7,3,4,3,14,196022,210962,64,0,651
22,5,17,2,14,28152,15358,31,11791,528
12,3,9,2,8,11587,7431,127,6940,514
6,1,5,1,14,4191,4191,23,4191,658
22,13,9,2,14,136227,1458,32,0,535
37,9,28,8,17,55163,50474,169,18907,384
7,4,3,5,8,36385,49600,51,500,498
20,6,14,2,6,76134,2798,25,0,499
44,9,35,7,11,163876,107111,135,6908,427
12,5,7,7,12,22872,60970,105,7100,450
4,1,3,0,13,0,0,0,4773,653
10,4,6,0,16,52226,0,0,0,682
8,5,3,5,5,5540,9347,68,2125,456
23,7,16,7,10,21159,19466,197,9616,466
32,10,22,7,10,133758,189133,242,143508,432
6,3,3,0,6,16230,0,22,210,670
22,5,17,6,17,577791,133754,147,10654,459
19,4,15,4,8,296793,7651,23,611,459
49,9,40,2,9,257925,3562,39,496,478
16,5,11,5,6,30102,33896,98,20281,475
21,9,12,6,18,275119,38075,149,21394,446
17,11,6,9,8,348526,100121,116,48449,458
35,9,26,6,14,151461,57571,97,3508,499
11,6,5,4,14,150298,38562,61,6926,447
7,5,2,5,7,106968,116680,86,76802,464
9,3,6,1,8,879265,71849,58,71849,435
16,10,6,0,9,245494,0,1,0,617
38,8,30,3,11,164795,7789,49,6509,491
10,6,4,3,8,302151,46175,60,39809,464
8,4,4,4,6,13683,45922,83,3641,487
9,6,3,0,17,281396,0,0,0,588
23,9,14,3,25,3084417,319220,65,0,528
6,2,4,1,14,14483,4493,15,4493,483
21,9,12,3,6,226282,8981,98,2809,534
7,5,2,3,7,15955,15955,67,5516,509
22,6,16,3,11,390684,50684,0,0,500
23,9,14,3,19,45324,19915,56,8308,405
8,3,5,1,7,12337,499,5,499,555
12,7,5,6,9,15465,18650,147,4321,533
7,5,2,2,7,73865,62283,53,36881,423
21,10,11,4,20,613612,139942,77,0,687
9,5,4,0,6,140490,0,0,0,636
25,15,10,14,24,1245330,760079,310,2198,434
11,5,6,3,7,13095,11764,65,5999,451
13,4,9,4,7,41459,30974,63,16041,454
11,5,6,4,15,197291,197291,94,118322,457
17,7,10,3,3,29458,12452,41,6690,481
12,2,10,2,5,213,6881,39,2044,496
6,4,2,4,5,21912,35173,70,705,456
37,7,30,3,12,219829,18447,39,0,447
6,3,3,2,11,28100,27199,39,25399,623
14,5,9,3,22,6440,6440,38,3259,477
11,6,5,5,7,340610,10492,46,7023,457
10,6,4,0,8,62490,0,15,362,465
43,12,31,11,7,45554,52425,83,10714,416
17,5,12,4,14,129104,8431,41,4750,518
21,9,12,0,11,797791,0,10,840,511
14,11,3,6,15,147762,137293,255,71777,381
11,6,5,3,28,1204186,12958,26,9586,453
24,9,15,3,12,325254,10929,23,6169,478
35,9,26,4,20,432010,305754,197,2472,472
19,3,16,2,9,37375,32342,61,26646,455
16,4,12,4,12,14172,11072,70,4008,494
11,7,4,5,7,30535,22212,47,8891,468
15,9,6,7,13,706277,38659,129,5008,431
11,6,5,5,8,132349,101175,83,6414,370
42,7,35,2,8,260612,1254,12,1132,570
5,0,5,3,5,21685,21685,19,0,561
13,8,5,0,18,368797,0,17,60002,552
8,1,7,1,12,4912,4912,100,62735,480
17,11,6,8,9,73100,66649,213,594,492
10,4,6,1,6,10755,5699,13,1900,683
18,6,12,5,4,36750,12196,97,8582,530
57,12,45,3,13,181586,34031,38,4864,525
10,4,6,2,12,60721,14481,29,0,659
37,14,23,3,8,327203,3160,17,1739,520
3,1,2,2,16,7697,11571,24,7697,458
17,3,14,1,8,9394,2412,34,2560,591
5,2,3,0,5,0,0,0,0,669
24,7,17,6,14,305730,25325,152,8902,412
18,5,13,1,18,35502,6150,96,8802,453
13,9,4,3,21,17421,15667,42,3167,616
41,13,28,0,17,1009428,0,14,4797,646
14,7,7,0,5,29909,0,24,8785,537
15,4,11,5,12,122388,65221,24,14163,454
4,2,2,2,7,16400,8438,18,7350,540
13,8,5,5,15,37693,240414,68,19236,399
14,9,5,8,12,32365,32018,0,0,505
11,6,5,1,9,63788,15364,27,0,563
73,15,58,8,15,282376,249062,289,37711,469
12,6,6,0,15,146429,0,23,0,521
10,4,6,2,7,367015,29114,47,0,477
10,4,6,3,25,153185,24703,80,3511,513
9,6,3,0,8,21245,0,44,4215,439
47,10,37,7,9,95712,111581,129,14339,454
21,15,6,14,14,380464,402791,144,83330,422
22,7,15,6,7,783513,69876,111,15799,484
19,5,14,0,5,15396,0,30,315,650
30,8,22,2,24,337022,22251,26,2156,518
21,10,11,1,26,300582,5942,0,0,546
3,1,2,0,7,3683,0,22,0,516
11,8,3,10,8,161758,192972,134,63287,468
21,10,11,8,10,458884,81665,139,10092,378
110,4,106,2,18,16627,15185,53,3375,505
16,4,12,4,11,14311,18989,24,7888,435
9,7,2,2,5,182852,67840,33,3615,445
8,4,4,2,7,25644,9237,7,1200,534
5,3,2,3,4,8154,11628,7,3248,459
14,5,9,4,8,26874,25488,86,13152,458
13,3,10,4,11,6854,19824,69,1005,568
12,4,8,3,17,5471,5471,39,3454,436
30,13,17,7,11,808242,560605,165,9430,447
18,6,12,5,18,53592,62578,99,9597,446
6,2,4,1,8,9186,6733,21,0,466
6,3,3,4,9,55456,83392,45,0,442
10,3,7,2,9,38098,573,24,761,596
26,10,16,3,14,1100890,19037,24,898,541
16,11,5,9,9,67528,61977,109,28076,439
17,7,10,0,13,19034,0,0,4068,485
7,4,3,2,7,264042,8068,46,0,516
92,15,77,16,69,861130,891092,392,152363,411
9,4,5,3,9,20962,7558,0,0,473
25,10,15,8,15,128638,51355,454,22169,462
9,2,7,2,9,643,643,17,502,496
8,6,2,2,16,63776,23676,36,0,572
3,1,2,1,9,3945,3945,15,0,641
17,5,12,0,7,327602,0,78,542,680
10,5,5,2,6,75715,9810,39,3287,498
25,14,11,8,15,277578,27645,143,6816,411
13,7,6,0,7,257020,0,0,0,695
20,10,10,9,8,75992,25836,128,1791,414
14,11,3,6,19,75329,73342,74,32969,425
24,17,7,15,10,1989468,1112868,110,16625,414
18,8,10,6,16,455520,113754,160,16045,531
26,7,19,2,15,31293,11970,97,10645,562
6,4,2,1,15,59989,945,22,1516,648
45,3,42,0,16,112401,0,0,1076,661
5,3,2,2,8,13949,419,8,1147,556
57,8,49,3,19,130743,64050,156,6440,529
7,2,5,2,7,45538,7350,14,0,561
19,8,11,5,12,117654,21575,38,8239,503
21,12,9,6,9,130632,42754,84,11345,474
17,9,8,5,14,47542,5135,217,2672,469
4,0,4,1,8,0,2137,12,2756,632
10,3,7,5,15,22021,31016,57,13867,478
26,16,10,0,17,1853639,0,18,5768,652
27,10,17,9,15,145608,129676,137,70509,432
40,7,33,5,18,142191,137831,65,123759,441
16,8,8,1,12,54061,2001,1,2001,609
8,6,2,6,19,122878,71182,105,25912,469
17,12,5,11,25,645277,139150,189,6167,438
11,4,7,4,9,81537,81537,232,16482,500
6,3,3,3,13,37052,36962,48,19716,442
5,2,3,0,6,5329,0,0,0,634
10,7,3,3,7,152312,14746,79,2412,434
9,1,8,1,5,1494,1494,9,0,598
14,7,7,6,16,45543,30043,62,10636,439
11,4,7,2,9,102573,15904,59,11093,591
39,3,36,1,9,4219,4219,272,8438,575
10,2,8,2,8,40196,4408,21,1062,562
11,5,6,1,17,340617,7822,33,1678,464
10,7,3,5,9,63273,29349,75,429,439
13,4,9,2,7,35438,14451,16,198,545
12,4,8,4,8,88513,81794,62,18684,583
33,12,21,2,10,218022,1362,42,9797,513
4,2,2,3,13,12755,19265,65,11505,483
27,7,20,0,20,158196,0,22,0,575
17,1,16,1,8,3747,3747,27,4247,556
8,5,3,2,17,350924,32012,34,20669,625
8,5,3,0,2,27304,0,15,1203,550
13,4,9,2,17,225225,31173,54,61754,558
17,9,8,7,9,210659,146049,90,28316,449
15,10,5,0,8,406258,0,13,2435,579
10,4,6,0,8,33325,0,0,0,612
15,3,12,3,7,35065,26223,62,20250,496
7,5,2,3,7,289582,34557,81,0,528
11,4,7,1,12,259734,10865,4,10865,678
49,10,39,1,19,458182,4798,330,14257,431
21,5,16,1,8,26126,1320,31,1320,601
17,8,9,4,25,302897,138172,31,62305,586
19,5,14,1,10,66225,8559,0,0,478
39,10,29,0,12,185132,0,20,3706,592
11,4,7,0,12,17399,0,10,2821,548
5,3,2,1,15,31994,15718,10,2932,616
15,6,9,8,11,1661067,835533,259,57817,447
16,6,10,5,12,73672,64710,60,19069,500
15,5,10,0,6,44019,0,1,261,563
16,9,7,8,6,37418,37418,108,10327,513
26,14,12,0,10,1430419,0,1,0,559
7,5,2,1,9,1076,457,5,457,462
6,3,3,1,8,4994,4601,0,0,566
23,13,10,0,19,527650,0,0,3202,590
12,10,2,10,9,641836,733452,238,181332,487
28,3,25,0,7,9579,0,0,0,551
18,8,10,1,10,235282,4956,43,4956,562
65,14,51,13,17,696430,221453,94,24973,422
3,1,2,2,7,8971,12830,48,8971,484
13,6,7,6,10,173788,148927,99,0,466
41,6,35,6,10,60857,60857,115,36046,467
6,3,3,2,12,12012,12012,191,10039,536
10,5,5,4,3,39371,19224,56,1405,487
25,7,18,2,20,379819,3507,0,0,495
15,13,2,12,13,1395449,450895,108,0,446
11,6,5,0,7,337446,0,1,0,667
8,3,5,0,7,16217,0,69,1525,610
7,2,5,2,8,302526,31751,19,29263,522
18,11,7,9,9,212189,243019,392,70637,446
52,20,32,17,13,1164072,737404,396,384011,418
7,3,4,1,13,236173,68109,40,1200,640
19,9,10,0,6,141999,0,10,13,586
37,11,26,0,11,699575,0,21,0,501
50,10,40,6,15,197429,13006,91,4140,423
9,4,5,3,14,1058206,942765,68,1265,498
12,3,9,5,3,53796,42456,63,5092,427
20,6,14,7,12,593905,91189,125,20271,600
12,9,3,0,14,302387,0,37,887,565
17,6,11,4,9,29422,7321,54,25499,451
15,6,9,5,9,993761,1111160,47,743502,459
17,5,12,5,10,548993,63222,120,16471,472
11,3,8,4,22,619922,101638,59,14293,481
10,4,6,3,10,178081,9527,46,4762,443
23,7,16,7,11,60051,66943,304,32251,506
7,4,3,3,12,639103,37826,42,177953,446
22,15,7,0,13,456927,0,1,17877,677
23,13,10,9,9,1029564,82990,146,15082,457
9,6,3,4,14,142115,52360,33,20354,431
16,3,13,4,8,7519,14727,44,4310,455
69,10,59,11,7,149279,144217,210,7942,437
7,4,3,3,10,80328,20923,38,2710,473
10,5,5,1,9,345110,5980,24,5980,610
11,6,5,0,9,92999,0,1,0,648
12,6,6,1,5,75809,128,18,1343,485
19,14,5,1,7,128654,5484,23,0,521
21,8,13,2,12,31521,11542,12,11590,396
15,8,7,4,21,368774,352170,102,54067,474
10,5,5,1,8,27099,2931,11,2931,489
22,6,16,1,8,26423,47456,73,1090,447
27,8,19,4,11,521073,16417,223,13534,383
20,13,7,0,13,158575,0,14,0,671
5,2,3,0,3,5066,0,4,1555,599
6,3,3,3,11,21518,21518,132,21154,451
11,6,5,3,12,20460,10055,50,8824,511
49,6,43,5,9,6502,1822,47,4187,599
10,5,5,1,12,19972,2179,5,2179,521
20,14,6,10,15,578605,239261,104,9097,414
17,8,9,4,17,194910,8862,9,5239,427
10,3,7,3,4,41518,19533,52,5593,495
6,3,3,2,8,9861,9861,106,9285,602
10,6,4,5,12,365717,32764,41,4416,439
11,4,7,4,7,29883,21138,222,11548,479
10,6,4,1,12,7713,1335,16,1644,462
55,13,42,4,7,56455,8122,57,7320,488
18,1,17,1,12,4488,4488,13,4488,607
7,5,2,0,7,56731,0,27,4180,597
33,9,24,5,24,504508,147508,95,30791,449
8,1,7,1,16,16868,16868,32,3334,541
10,7,3,0,69,171765,0,4,0,706
15,6,9,5,13,31038,38034,83,7360,455
30,15,15,3,26,1411556,8970,0,0,489
31,5,26,0,7,27423,0,190,3421,447
7,4,3,3,7,12196,8901,306,9329,505
27,5,22,6,12,156572,106863,324,71201,498
7,3,4,0,8,127949,0,0,0,670
15,7,8,9,12,66945,63350,100,22680,426
17,7,10,5,7,192267,20680,25,4422,459
8,3,5,2,5,3694,1392,32,959,554
10,5,5,4,10,3388,3388,33,1768,489
16,11,5,11,10,134828,82102,179,2249,453
8,5,3,1,12,571336,514,33,24165,502
17,11,6,3,6,660899,139122,16,3000,464
36,10,26,4,14,237563,48250,56,17330,409
81,14,67,15,12,175350,196073,331,28221,348
20,2,18,1,15,51643,8189,28,8189,424
21,11,10,3,15,101051,4461,4,659,469
25,6,19,3,10,27519,20210,73,10733,460
16,11,5,2,19,549033,144191,65,75401,480
63,30,33,2,15,8585087,4934,23,0,659
9,4,5,2,8,8657,3275,47,2252,553
27,15,12,11,21,778046,558674,198,6117,520
3,1,2,2,9,29294,29294,31,16937,571
11,8,3,2,20,239076,2395,47,0,484
9,7,2,4,12,63376,24032,23,7924,454
24,6,18,2,9,52221,19951,0,0,476
11,4,7,5,7,31637,33326,67,13216,391
22,9,13,5,8,128256,55505,118,4374,504
45,9,36,7,12,29186,27721,72,8562,477
2,0,2,1,7,0,6755,9,0,505
10,6,4,5,10,180828,96867,90,40479,431
14,7,7,0,33,6358,0,2,0,671
6,4,2,2,5,17095,13579,0,0,491
14,5,9,4,9,13953,13953,51,10445,420
23,14,9,0,8,168339,0,12,0,557
23,8,15,0,7,98221,0,5,481,591
3,1,2,0,16,136122,0,9,0,632
5,3,2,3,6,37544,44036,0,0,436
25,8,17,10,9,103963,106584,325,33143,453
16,7,9,0,12,427805,0,36,5569,496
4,2,2,2,6,6770,6770,12,4559,447
5,1,4,1,8,4343,6511,0,0,570
12,6,6,3,14,268873,14909,29,18409,466
21,6,15,7,12,309580,76592,139,12431,469
11,4,7,1,10,24324,389,7,4095,465
13,9,4,3,7,305774,72297,24,1028,494
4,2,2,0,2,17090,0,3,0,547
14,2,12,3,4,15796,15796,22,6863,528
10,4,6,0,9,103005,0,5,0,685
12,5,7,0,12,91146,0,0,0,641
27,4,23,0,6,241630,0,28,0,634
13,8,5,0,25,206523,0,79,96772,502
6,4,2,1,20,515165,126146,1,9578,523
34,7,27,3,12,339780,56772,20,45220,574
15,9,6,6,7,324983,27320,30,0,483
12,4,8,3,8,31007,31007,220,22467,487
9,6,3,3,12,253304,104863,109,0,532
28,8,20,5,30,132004,88746,63,4297,415
8,3,5,2,15,696770,23549,70,0,527
6,4,2,0,13,227183,0,6,43180,672
53,8,45,3,10,12316,3137,91,2480,447
34,18,16,0,10,29581,0,6,137,675
47,7,40,2,21,1333059,5813,151,8110,404
20,7,13,3,14,840318,196416,167,74633,506
10,8,2,8,4,76113,63276,35,13984,409
41,26,15,3,31,3077030,32319,59,6577,465
12,7,5,5,8,95134,33055,70,19342,482
18,8,10,0,11,307251,0,2,0,452
87,13,74,11,7,693077,75783,513,16449,427
70,16,54,4,38,977964,222761,114,139895,445
8,5,3,0,11,151244,0,0,2490,620
52,14,38,7,10,59458,5649,141,3909,480
13,8,5,5,9,191300,80895,90,9510,439
5,2,3,2,11,9447,9447,32,750,629
7,4,3,2,11,491202,21644,4,3094,443
12,6,6,3,38,8220,10362,2,3998,504
19,4,15,2,10,15375,890,17,2350,455
17,12,5,7,14,865969,107073,40,5845,421
8,5,3,4,10,57602,57796,81,629,442
5,2,3,3,4,29379,28997,63,21756,442
12,5,7,3,7,547989,211458,18,6668,515
21,8,13,1,11,73272,2053,17,0,497
27,15,12,15,11,444420,114370,325,9869,389
13,8,5,8,4,45121,42306,99,21044,482
6,1,5,1,8,4562,125,3,2022,531
13,7,6,2,14,134680,134680,6,3720,467
52,13,39,7,16,510025,50314,134,18580,381
20,7,13,7,8,89328,98156,0,0,456
18,6,12,2,18,425341,11684,22,2,500
11,9,2,0,6,72745,0,0,0,705
17,2,15,1,17,6606,5663,24,5663,624
29,7,22,3,11,32032,16018,192,2740,459
15,6,9,1,9,907676,15385,12,17221,435
2,0,2,0,6,0,0,0,0,642
12,6,6,7,7,85895,119535,140,46040,423
5,1,4,2,14,54437,52846,6,1026,553
32,5,27,2,14,260482,10091,13,9873,531
30,11,19,5,15,621170,149233,93,135684,431
8,6,2,4,9,71742,56879,15,31033,416
29,14,15,6,13,494170,75562,120,28820,470
15,3,12,2,11,30025,12710,5,3968,474
36,16,20,11,15,291419,47181,79,11931,452
5,2,3,1,7,770,770,11,4420,490
67,34,33,31,30,3136571,4125181,422,814638,399
8,4,4,4,12,40500,14372,1,4198,422
11,6,5,1,20,371168,13495,62,13495,647
16,14,2,3,22,547858,1311,0,0,601
10,6,4,7,7,16686,15082,60,1925,442
8,4,4,1,9,14840,7017,22,7017,457
11,7,4,5,18,35783,23392,35,12253,516
16,1,15,0,2,2843,0,0,0,562
11,9,2,1,3,730358,1806,16,1806,518
18,6,12,5,15,71577,28890,201,9265,420
47,12,35,4,7,116765,18621,157,2230,528
23,4,19,0,10,48037,0,20,5269,551
20,11,9,12,13,281949,277161,235,11277,517
26,15,11,5,6,168708,50197,46,17936,435
54,11,43,3,19,690441,29483,23,31654,407
8,5,3,2,15,13585,8414,14,8114,462
37,3,34,1,19,425817,1660,88,1660,500
12,5,7,2,14,64729,7961,57,6352,612
4,2,2,3,13,2243863,1329859,49,10701,649
12,9,3,0,24,28056,0,31,0,578
19,5,14,5,13,56169,56169,114,18118,501
16,6,10,4,11,62643,62017,83,48452,426
2,0,2,0,8,0,0,0,0,634
23,11,12,7,14,219513,84418,81,5096,488
36,13,23,6,6,201663,34290,124,9722,432
6,4,2,1,9,518,518,26,518,578
13,4,9,5,9,34965,261039,80,22430,406
14,7,7,1,11,115313,91370,1,3900,434
5,2,3,4,10,15447,20876,0,0,500
17,3,14,4,26,374762,374762,52,354260,566
10,6,4,0,16,220794,0,0,0,529
21,4,17,2,10,227656,6236,29,4970,560
19,6,13,8,12,81559,107506,0,0,492
6,3,3,2,14,9370,9369,32,7781,532
19,11,8,6,19,458413,217348,24,59386,457
6,0,6,0,7,0,0,11,3771,617
14,3,11,1,15,159887,27369,35,0,681
12,9,3,10,6,235925,210035,93,13272,420
30,7,23,3,11,27171,5433,53,4009,405
5,3,2,0,4,24714,0,33,6809,492
7,5,2,0,5,10477,0,0,0,503
17,12,5,9,13,1381327,86366,57,0,446
17,13,4,8,12,1523817,28050,52,0,481
13,3,10,0,14,37768,0,0,1679,644
22,8,14,7,28,1438703,211681,145,32579,505
6,2,4,2,9,3640,3640,41,2207,625
24,7,17,3,12,1046114,6530,50,0,512
4,1,3,2,4,10291,10291,12,0,571
14,3,11,1,7,46327,2533,67,0,544
33,9,24,5,12,147311,19647,32,3990,419
31,8,23,6,6,25825,16990,60,2145,417
17,7,10,8,13,85201,109578,190,16137,498
6,3,3,1,8,109556,109353,21,1140,469
20,6,14,6,5,279767,224779,165,22358,446
8,5,3,3,5,26699,8269,21,6775,519
25,13,12,0,22,763234,0,51,0,565
16,4,12,2,11,15089,3088,11,2617,482
6,4,2,4,15,53285,53284,78,30466,457
7,5,2,2,9,13929,10490,49,7607,542
19,7,12,6,11,242537,32313,102,5298,477
7,4,3,2,25,4389,4389,44,3502,544
3,0,3,0,26,0,0,0,0,622
10,2,8,0,4,82640,0,0,186,612
6,3,3,1,7,57771,11358,30,11358,573
8,4,4,0,4,29772,0,3,2405,523
10,4,6,0,3,166064,0,0,0,678
17,7,10,0,11,0,0,1,606,710
16,5,11,6,9,4824,4824,64,2258,520
35,6,29,2,10,19562,12722,14,1726,543
35,5,30,8,13,15055,19613,467,18210,448
64,8,56,8,19,29575,28643,348,13879,483
12,5,7,5,7,64678,73364,89,29814,405
41,8,33,3,9,36245,17582,61,11073,474
16,7,9,3,16,498679,54757,16,43493,464
7,5,2,2,4,38843,911,42,879,522
34,14,20,2,15,1434639,687,33,777,593
35,6,29,0,11,293596,0,0,13986,550
5,2,3,0,16,37852,0,0,332,636
15,12,3,3,9,541624,2591,15,1392,583
11,4,7,0,11,2504,0,119,2786,547
17,7,10,1,18,102316,3,17,3212,594
7,1,6,4,8,19691,45887,40,1429,648
19,7,12,2,15,267614,14846,114,8891,540
18,5,13,4,6,12036,10621,134,4556,457
13,6,7,0,10,214359,0,0,247,659
19,11,8,10,27,1497658,1207670,127,0,493
26,7,19,0,27,157371,0,8,3800,579
14,8,6,1,5,94943,477,14,477,465
5,3,2,0,45,98184,0,0,0,632
31,8,23,4,69,489641,8690,30,8071,514
9,3,6,2,4,19169,19539,111,6708,443
12,8,4,4,11,263798,64422,44,17640,458
24,8,16,3,16,56151,3813,147,843,446
4,2,2,0,12,0,0,17,8340,556
7,5,2,3,6,216008,9406,36,2132,528
7,2,5,2,11,15137,11105,33,9093,435
20,4,16,2,17,19897,19897,27,18987,456
7,3,4,3,8,6658,9658,62,6377,565
21,9,12,6,7,610825,78532,18,4678,466
8,3,5,0,7,29464,0,23,0,526
30,10,20,8,9,464762,57270,211,2850,439
33,5,28,5,17,57057,22707,194,8832,413
15,8,7,6,7,28261,27814,86,14886,396
30,6,24,2,10,271539,11675,50,7523,500
22,10,12,4,11,420405,25687,75,0,415
16,5,11,6,14,53340,68971,48,34805,448
44,13,31,9,9,909079,848446,282,2898,535
71,4,67,6,10,8206,7580,272,30637,436
19,7,12,4,26,52932,66589,68,721,487
13,5,8,4,15,25218,34689,72,8410,423
8,6,2,1,4,13115,710,28,5465,522
10,5,5,5,10,116299,21164,72,5480,502
6,4,2,2,10,25845,24636,59,13983,498
24,7,17,4,19,54661,50918,83,52041,525
14,12,2,1,15,55859,7263,8,7263,592
32,12,20,5,12,517303,80889,40,62138,361
7,2,5,7,7,2719,11241,559,3953,489
6,2,4,1,27,12470,5836,1,5836,706
4,2,2,0,7,0,0,22,439,626
19,7,12,0,12,311669,0,0,0,597
14,7,7,3,21,588659,8442,59,3628,480
13,2,11,0,7,37763,0,0,0,606
7,4,3,1,8,13486,1038,15,1038,570
8,6,2,4,14,25892,23910,50,12250,400
10,0,10,0,1,0,0,0,0,640
42,26,16,12,16,996153,275043,213,67968,453
27,3,24,1,10,294143,3712,28,0,534
13,6,7,2,19,500995,31582,24,0,503
24,14,10,1,7,131802,460,39,3132,529
8,5,3,3,7,126965,114964,0,0,543
5,2,3,2,6,9061,5160,94,2580,441
11,4,7,2,5,6706,205,33,559,561
6,4,2,4,7,302988,19121,0,0,503
5,3,2,2,11,28206,28206,26,2614,553
6,4,2,2,2,35226,18647,3,18200,480
33,4,29,3,7,105487,52170,74,35650,501
29,10,19,2,14,401824,26457,92,25134,558
17,6,11,7,8,43421,51523,182,24809,372
11,9,2,4,9,121204,79347,69,0,523
24,14,10,10,9,72812,39482,125,13352,386
9,4,5,1,10,25158,3397,13,3397,578
6,2,4,1,2,6409,4865,10,0,419
18,7,11,0,23,178894,0,1,1,559
23,14,9,9,8,580677,76528,53,14910,423
17,10,7,1,13,91230,3746,6,1224,664
65,12,53,2,15,167298,3623,47,2398,548
6,3,3,4,7,11764,10056,83,1350,513
9,5,4,5,6,19049,35352,108,2138,482
22,10,12,8,38,10077111,10071836,109,9995775,474
34,13,21,2,13,478530,33321,83,85163,513
42,9,33,6,14,103803,31563,72,10021,439
15,6,9,4,12,217374,14986,98,5133,612
51,9,42,2,8,406884,26360,39,15640,392
11,4,7,3,16,292099,82091,10,39527,459
63,11,52,4,14,57520,29655,68,21637,464
4,2,2,2,13,25704,25704,30,8408,478
7,3,4,2,15,127097,93874,3,1139,490
12,4,8,1,9,27089,12412,95,12412,478
193,14,179,9,9,156428,70525,94,11454,469
25,14,11,16,19,941991,208251,311,66232,375
44,6,38,2,9,277840,6567,14,3714,500
11,6,5,5,19,570614,491080,25,28687,422
6,2,4,3,6,30384,40672,0,0,521
15,7,8,0,8,646777,0,21,0,584
31,7,24,5,14,53753,53753,93,21291,460
16,6,10,0,10,146042,0,37,690,572
10,7,3,2,9,12338,5816,39,3627,478
7,3,4,0,10,91538,0,11,0,529
14,8,6,0,10,661215,0,0,563,626
11,5,6,2,6,39144,2182,27,4006,501
14,5,9,1,30,14695,14695,18,14695,545
4,2,2,1,7,8488,6209,4,11208,594
18,13,5,13,17,795964,598791,116,22999,435
17,7,10,6,14,32393,23203,163,6297,457
8,4,4,3,20,11528,4167,4,234,529
7,2,5,0,13,2206,0,1,1376,524
18,4,14,0,14,155439,0,36,6549,597
15,8,7,4,3,30734,7457,62,6177,481
23,6,17,4,31,2001,183299,10,4434,471
3,1,2,1,9,11182,11182,29,0,496
6,4,2,2,12,43201,11872,18,9829,555
32,13,19,10,11,84795,69234,64,1147421,441
10,5,5,2,11,48509,2399,36,0,568
33,6,27,2,7,43669,186,312,831,566
10,1,9,1,7,6947,6947,37,6947,512
39,10,29,9,12,88882,88882,155,15654,447
19,7,12,0,8,55397,0,29,878,511
11,4,7,1,11,20836,1080,0,0,624
8,4,4,3,2,50948,874,78,746,535
16,6,10,4,12,15077,14172,62,8101,432
12,4,8,0,13,400915,0,9,0,502
4,2,2,0,17,171791,0,0,0,639
17,8,9,6,19,413586,85908,143,23921,484
12,6,6,4,10,68018,54238,43,25380,454
16,7,9,1,8,289215,1527,4,0,458
15,6,9,0,11,182827,0,3,561,624
33,3,30,2,7,5892,1392,29,5995,486
30,24,6,1,15,556472,611,6,469,599
47,9,38,3,10,49808,20983,115,13998,469
44,13,31,6,31,108619,20729,136,7600,463
17,4,13,1,12,247663,2766,97,5520,540
12,2,10,2,16,5588,5588,49,4388,547
22,13,9,3,16,147460,131027,65,77749,639
41,11,30,12,10,94193,88337,469,15450,390
24,8,16,9,17,359599,49959,423,10807,453
64,7,57,3,16,41768,19579,249,16890,465
23,11,12,0,13,752339,0,5,0,530
20,5,15,2,12,453303,7452,76,39596,478
24,10,14,1,15,916351,96716,5,0,640
6,3,3,2,7,6406,5763,34,0,539
8,5,3,6,7,42884,15712,0,0,487
23,11,12,13,15,465058,748684,207,32474,519
16,11,5,0,22,3747131,0,21,23706,404
12,6,6,0,6,247261,0,0,0,636
8,4,4,3,5,49268,43192,46,2131,420
14,7,7,3,7,71529,22666,60,0,454
11,7,4,6,7,346030,24450,123,10966,371
21,7,14,7,17,47379,109946,84,197,430
14,9,5,2,13,641773,5931,8,0,639
8,5,3,2,10,127805,104153,37,0,506
8,6,2,5,5,42151,41883,112,22215,462
13,5,8,8,7,44256,92699,129,8937,409
40,5,35,0,16,63546,0,112,16393,564
25,10,15,6,9,26116,14704,41,7760,406
6,3,3,3,7,29284,29284,0,0,548
70,37,33,0,29,4477244,0,12,0,464
12,8,4,1,16,78981,10658,22,0,530
13,5,8,2,11,24755,7696,33,8777,440
9,7,2,6,7,80840,80052,106,13550,418
7,5,2,3,19,41170,30527,0,1356,578
6,4,2,3,13,25868,12821,28,6333,402
26,11,15,10,9,114269,80310,321,21422,458
3,0,3,0,5,0,0,23,371,623
9,7,2,4,10,564248,120457,71,46333,451
12,6,6,4,11,391082,38506,25,5488,447
122,16,106,11,9,218643,62037,292,27338,467
25,9,16,5,13,220755,20320,0,0,451
8,5,3,0,16,48714,0,2,991,566
11,4,7,1,14,191740,2256,17,0,526
59,18,41,5,13,137472,18722,416,9489,431
6,2,4,4,9,559293,159458,0,0,482
25,10,15,9,11,448623,340502,217,5480,472
8,4,4,5,9,24370,23825,0,0,451
11,4,7,1,16,43717,14898,23,14898,637
6,3,3,2,9,11740,11740,50,0,556
12,7,5,0,14,409058,0,0,0,550
6,4,2,1,9,85632,46924,32,1950,543
6,2,4,2,8,23070,16439,196,13863,517
101,6,95,0,15,8834,0,16,15771,605
16,5,11,0,13,39477,0,17,2053,699
17,7,10,5,7,68215,22138,20,10204,401
9,7,2,1,12,128694,14271,22,14271,673
122,9,113,6,15,574763,119197,35,47886,427
12,2,10,1,13,14236,1654,3,1654,655
4,1,3,1,12,13135,13135,3,13135,418
28,7,21,4,7,37177,12048,122,10333,452
17,3,14,0,22,0,0,25,7221,664
6,2,4,3,7,17896,17070,28,8948,512
37,8,29,7,11,148890,116813,83,2331,488
8,5,3,5,10,20666,20666,64,3176,468
5,3,2,0,12,0,0,0,0,667
15,8,7,5,6,130874,95839,66,61122,511
10,3,7,5,11,11862,22551,24,4689,501
8,4,4,4,11,351926,67200,41,0,443
52,14,38,0,16,613061,0,8,514,523
8,6,2,0,6,184460,0,0,0,678
72,7,65,1,16,439418,50554,26,353,561
9,4,5,3,7,16753,15373,176,11694,529
8,2,6,2,10,326219,3793,33,7886,551
22,15,7,1,19,485728,2925,4,10431,517
21,11,10,8,15,62939,57007,395,20175,482
24,3,21,2,19,47531,31863,23,2203,477
5,3,2,1,10,48350,5515,35,3603,629
10,5,5,4,17,22268,21901,221,14872,475
20,13,7,7,14,47374,44055,61,18718,503
42,10,32,6,28,203329,78587,129,32888,594
13,8,5,5,6,41148,27045,85,14637,429
3,1,2,2,7,40664,39015,35,0,491
6,4,2,3,7,18719,8781,72,1462,462
20,6,14,7,12,60272,43294,115,25646,450
8,5,3,2,9,12637,1802,0,0,452
11,7,4,0,6,88723,0,18,0,535
26,4,22,4,10,10222,6799,84,3986,572
12,8,4,2,7,330233,12735,9,4803,521
7,4,3,4,17,19392,31497,52,8061,427
22,14,8,0,10,603433,0,0,0,688
12,2,10,2,9,14537,39268,54,0,519
49,11,38,1,13,72428,13,178,7411,529
8,2,6,0,8,11945,0,55,9116,644
7,5,2,0,8,44164,0,3,700,559
4,2,2,2,6,32191,17839,60,14336,468
8,6,2,0,7,29437,0,8,3399,488
11,6,5,5,6,49923,42947,70,27828,514
22,9,13,6,18,100528,100527,0,0,488
21,9,12,10,14,108600,89813,203,23278,517
25,14,11,5,13,297096,15417,79,4319,397
16,10,6,8,20,207206,207206,84,50870,547
13,7,6,5,27,262065,324298,94,168535,413
27,9,18,0,22,2929299,0,46,0,520
21,3,18,4,12,388943,45481,48,25850,523
22,12,10,1,15,99397,1425,20,1425,598
41,3,38,2,11,22305,17305,201,15669,572
9,5,4,0,7,15405,0,64,1710,551
9,6,3,4,5,6884,12947,88,1978,658
16,8,8,9,8,222551,303656,189,113009,382
6,4,2,1,5,9795,2850,46,6250,654
10,5,5,3,14,95378,10046,28,0,513
4,0,4,2,4,30290,30290,10,17811,620
17,14,3,1,12,854444,390,6,8616,594
6,0,6,0,2,0,0,0,0,685
9,7,2,0,4,86020,0,1,0,469
36,5,31,2,13,6000,47564,33,7446,548
19,5,14,0,12,285084,0,1,0,609
46,13,33,11,14,67511,60056,207,15553,415
7,5,2,1,7,61530,2871,0,0,513
4,1,3,1,6,2726,2726,14,2726,437
8,1,7,3,8,63623,61474,0,0,555
14,4,10,4,11,18730,18730,43,6893,544
17,7,10,2,12,342169,13696,139,8533,455
14,3,11,3,10,7713,8665,115,5791,622
13,7,6,1,18,363916,3957,24,3308,519
11,2,9,5,4,7925,16367,81,4791,456
31,4,27,1,10,53851,117,99,1461,433
23,10,13,17,4,709859,1277710,161,178973,394
17,7,10,3,10,29850,10244,22,9044,601
25,9,16,2,11,273691,1190,34,2811,449
8,3,5,4,7,11655,22023,37,1388,509
9,7,2,5,8,13355,4534,26,1709,535
5,2,3,1,7,4768,4768,13,4768,584
7,4,3,0,5,39680,0,4,0,523
11,7,4,1,19,563757,3237,47,1485,541
16,6,10,2,13,374789,18769,16,8555,465
12,3,9,4,9,305964,47388,2,14352,494
6,3,3,2,11,171105,171105,80,831,498
29,2,27,1,7,51733,4398,0,0,638
9,4,5,0,15,524773,0,17,16109,691
29,16,13,14,22,65001,64428,197,99899,479
17,11,6,9,5,307566,188555,198,12299,471
40,5,35,4,13,11087,8307,87,2700,455
44,12,32,0,5,164998,0,1,1850,514
26,16,10,1,11,1835128,4726,25,12070,577
11,9,2,7,8,44786,43490,125,8482,526
5,2,3,1,11,738,738,12,738,604
21,11,10,5,7,89636,25835,18,11340,527
17,15,2,12,11,419808,42376,144,9106,423
19,9,10,5,19,273761,482579,198,127794,449
7,2,5,4,13,20114,21381,35,7855,497
27,7,20,5,7,49801,25581,188,13130,488
14,7,7,12,13,284035,388867,32,79202,433
4,2,2,2,13,12869,12869,218,11619,570
46,4,42,1,23,467042,17991,8,17991,505
32,10,22,2,69,360312,17449,24,631,494
11,7,4,5,5,23750,23750,162,13905,452
58,4,54,0,6,122602,0,20,6000,598
6,3,3,0,3,15384,0,0,0,637
5,3,2,1,6,27837,6111,18,6111,621
10,6,4,7,10,325524,373642,170,94596,531
11,7,4,5,7,48182,38916,54,20088,460
24,8,16,1,11,508818,34454,169,34454,612
14,6,8,1,8,250383,1351,41,1351,454
46,4,42,1,15,36420,20880,26,1420,603
21,9,12,2,15,129611,26248,58,22928,513
5,3,2,0,5,292542,0,19,2339,514
38,3,35,1,7,358846,5502,11,0,543
10,6,4,4,10,17270,7761,320,11373,500
17,9,8,1,25,117510,293,9,632,600
13,8,5,2,12,196898,1172,25,12872,522
21,8,13,6,19,32121,8163,23,3581,424
26,15,11,15,13,464708,449052,123,11240,455
19,10,9,2,14,125078,5606,18,4578,525
28,6,22,5,12,619416,32904,0,880,495
6,3,3,2,7,472290,5289,14,0,544
329,26,303,2,7,201246,774,123,2718,469
14,11,3,3,9,68644,12701,28,0,439
15,10,5,2,11,320428,2247,20,1925,366
9,3,6,3,10,2168,8865,5,500,509
25,9,16,3,10,49061,5717,32,7215,534
9,4,5,2,6,272141,3967,25,3672,440
23,6,17,2,12,37401,6681,23,6535,574
12,4,8,2,11,282111,3564,80,1653,526
29,16,13,0,13,1203342,0,0,0,602
23,5,18,0,12,157885,0,0,0,695
11,5,6,5,11,26321,26321,81,15897,459
22,10,12,2,12,581662,169270,38,160,445
25,5,20,3,9,106905,12632,155,6536,458
3,1,2,1,13,479,5371,44,0,637
6,2,4,0,9,80318,0,15,3938,571
29,10,19,5,13,418293,16560,108,19208,424
22,7,15,2,7,149289,316,21,296,543
18,13,5,2,19,330530,27487,36,21276,525
4,2,2,1,4,10158,2090,51,1009,528
11,9,2,5,69,204959,82702,83,11772,455
30,11,19,0,14,258988,0,16,180,590
27,8,19,4,14,204882,81115,134,35464,529
22,7,15,2,12,178260,34662,64,657,446
10,5,5,4,19,378455,21859,45,816,436
14,8,6,5,41,399473,34094,86,10832,538
15,6,9,4,6,33269,13881,104,12388,478
12,5,7,3,10,57170,33926,0,0,540
25,15,10,6,9,283708,41058,77,16918,425
8,3,5,1,8,360150,36881,0,0,561
20,11,9,3,7,549247,1724,13,639,465
18,8,10,8,8,42273,26984,301,9325,405
38,5,33,2,19,15350,15350,217,10653,453
14,7,7,3,14,53933,36869,11,22110,459
30,9,21,7,10,427160,207326,88,24348,426
14,6,8,1,22,599158,6217,14,17726,573
43,13,30,0,19,2230783,0,0,0,697
10,5,5,0,8,730968,0,24,9043,528
6,3,3,0,15,61857,0,1,0,642
8,2,6,3,7,190887,174031,23,0,614
25,7,18,5,8,221690,26712,235,14676,423
22,10,12,7,14,349590,64923,43,0,480
10,7,3,0,10,170368,0,11,2480,650
11,4,7,8,8,212467,193628,137,2891,503
6,4,2,5,8,26696,30726,45,11492,520
12,7,5,3,7,363672,52172,33,23912,471
30,8,22,8,10,62427,58869,298,20713,449
33,9,24,11,9,76902,85779,507,34563,435
27,9,18,2,5,61722,7682,19,7136,436
16,8,8,4,8,85791,20639,140,4464,455
6,3,3,0,2,8221,0,0,0,589
10,4,6,2,10,28748,12261,12,11559,518
20,3,17,2,18,169516,52865,34,11171,512
12,5,7,3,11,62470,34666,33,21894,492
9,7,2,1,3,35969,1900,0,0,448
14,5,9,4,8,9719,20599,229,3130,521
12,5,7,4,17,528701,72795,54,12747,476
7,5,2,4,17,15462,20032,78,9485,491
9,5,4,7,3,47834,61015,109,31538,452
2,0,2,0,13,0,0,0,200,700
26,15,11,2,16,779384,2561,5,0,582
22,5,17,5,10,44664,44664,108,20444,472
21,2,19,1,12,778025,220709,25,2452,603
17,11,6,1,8,685148,618,4,1085,484
7,3,4,5,9,22445,28744,55,2070,415
14,4,10,2,8,20600,20600,212,17600,477
5,3,2,0,7,0,0,10,185,632
16,7,9,5,7,37227,15203,73,2315,408
3,0,3,1,10,0,6594,17,0,526
17,11,6,2,9,224148,48745,5,0,633
7,4,3,5,20,42137,62745,125,14118,480
14,7,7,4,7,56713,9808,96,6844,469
10,6,4,2,10,23360,729,10,0,539
8,4,4,0,4,34083,0,10,898,618
23,7,16,7,8,222174,192844,114,763,506
10,6,4,5,5,11579,10948,17,2127,439
13,7,6,7,8,425381,121025,27,5168,422
19,9,10,11,13,751698,931808,218,113890,494
14,10,4,4,9,230030,51633,10,0,425
22,9,13,7,9,137667,57528,84,18377,450
7,3,4,3,8,72754,72754,90,0,485
10,6,4,4,19,26785,16651,25,7325,493
19,12,7,0,38,326780,0,9,1184,529
18,10,8,12,7,115832,114422,333,26005,469
5,2,3,2,11,3993,6462,40,0,543
18,8,10,5,10,313431,19427,22,7842,489
44,15,29,8,21,226592,52117,239,15754,447
19,9,10,3,7,139771,16707,13,3774,522
17,7,10,9,17,71437,110065,47,3426,410
11,2,9,0,15,14406,0,4,3623,597
24,4,20,0,12,346090,0,17,1097,458
25,4,21,2,9,18677,7640,96,1896,474
11,8,3,1,14,213036,10920,39,0,451
7,5,2,6,7,26096,25839,111,7583,526
19,10,9,0,28,1152892,0,1,0,612
7,2,5,2,7,6306,15212,76,7000,488
20,5,15,4,10,40712,40712,194,25929,459
12,7,5,6,18,50367,49723,71,12792,448
25,9,16,1,14,911997,7768,24,8522,462
7,3,4,1,5,135730,3567,33,0,582
6,3,3,0,7,16910,0,6,0,612
7,3,4,2,12,3004,1761,10,16474,527
16,7,9,5,12,73060,86660,107,44513,436
5,2,3,2,7,4835,4277,30,1476,548
7,4,3,2,16,13058,12197,33,7730,534
12,8,4,5,5,25841,12193,75,607,522
7,3,4,2,14,31780,5219,16,5447,545
25,3,22,6,14,284482,68328,84,6733,481
11,5,6,4,7,34323,32953,309,19712,549
4,2,2,1,2,6769,400,14,400,497
34,8,26,3,23,116180,175650,246,7000,527
22,5,17,4,8,89164,88778,79,1606,433
12,9,3,4,13,161175,56184,2,827,494
9,6,3,3,7,45282,27511,42,4375,450
9,6,3,1,12,49686,23870,22,23870,543
40,12,28,6,16,138021,103502,187,4350,474
2,0,2,0,3,0,0,1,20,638
18,8,10,5,8,16547,4457,56,44053,408
19,5,14,4,16,162052,16021,24,14600,482
13,4,9,2,14,62203,1291,12,0,439
6,3,3,1,6,8461,283,1,1250,665
6,3,3,2,11,34193,14061,40,0,543
9,5,4,4,11,26630,41350,8,5227,498
9,4,5,2,9,38622,16455,20,2350,497
7,4,3,2,5,23389,6854,102,898,474
17,3,14,3,7,23376,23376,223,16955,507
10,5,5,4,6,45907,28361,239,15894,500
11,7,4,4,11,17989,17989,131,16590,527
12,7,5,7,18,27260,27260,71,9030,384
5,3,2,0,3,17150,0,0,0,624
35,9,26,5,15,696744,46585,41,973,466
10,2,8,0,12,6903,0,0,219,620
12,4,8,3,8,18007,15832,194,10805,532
4,2,2,2,13,47312,47312,35,45782,502
8,4,4,5,13,70430,70430,29,15574,456
21,9,12,6,8,61666,40395,115,11331,451
9,1,8,0,12,0,0,3,665,669
12,6,6,8,9,48790,49171,72,2593,431
14,3,11,1,10,65105,4648,28,19331,503
5,3,2,0,5,119583,0,0,0,665
9,4,5,1,11,644420,2480,12,2480,533
4,1,3,0,5,0,0,2,0,644
12,5,7,3,26,63631,236733,70,0,614
7,5,2,1,4,32335,2057,2,2057,515
16,4,12,1,8,298194,1828,4,1828,620
52,12,40,3,12,102869,20896,69,10130,418
13,8,5,7,8,58133,48119,456,9672,459
17,9,8,5,17,1068427,83999,115,0,528
12,4,8,3,6,19553,25049,130,12507,512
24,7,17,0,38,88309,0,11,2909,597
33,9,24,9,8,35419,33824,146,17954,446
41,3,38,2,7,23319,6006,290,1828,534
17,5,12,1,9,26133,3485,44,4288,502
11,4,7,4,7,69027,83933,69,10616,506
18,3,15,2,8,9012,8781,5,2650,539
4,2,2,2,14,6444,6444,37,4980,518
8,3,5,3,19,9571,9571,32,5891,419
49,9,40,6,10,182895,133033,156,51965,459
10,6,4,4,7,58340,18597,27,0,491
5,1,4,1,8,96493,30218,25,0,666
8,5,3,0,8,8307,0,14,0,537
13,7,6,0,6,21100,0,10,0,612
93,9,84,7,5,116352,82664,104,28028,418
20,12,8,9,23,613977,400020,228,21757,477
10,4,6,0,22,159142,0,7,0,660
14,7,7,4,14,14451,14451,56,5290,452
26,10,16,3,11,145080,7388,30,1684,486
32,10,22,2,6,275477,1946,18,1693,449
11,4,7,3,8,20960,28254,92,10674,538
8,4,4,4,8,127569,123404,64,4836,463
40,12,28,1,16,217466,4568,1,4568,480
20,6,14,2,12,407268,7175,43,0,557
12,6,6,4,11,503010,100727,113,74737,419
21,7,14,0,21,250245,0,8,11460,546
7,4,3,3,8,37055,17292,64,12949,548
13,6,7,6,9,49533,50219,155,15715,379
14,7,7,3,12,163985,43716,30,4570,541
29,8,21,10,9,131235,146385,190,22585,411
70,6,64,6,16,19004,17484,453,11611,469
39,20,19,10,16,687863,199384,54,13533,443
26,18,8,0,33,880976,0,26,0,613
68,16,52,14,4,298600,162845,267,12368,396
10,2,8,1,15,122220,39429,10,1183,691
54,7,47,5,11,39217,14995,101,7301,494
20,3,17,2,18,25572,16963,45,8962,559
10,4,6,4,9,14850,30057,19,3304,541
16,10,6,8,19,1267708,735335,125,152712,464
6,1,5,0,7,0,0,5,4,650
9,4,5,0,4,23229,0,20,283,590
38,10,28,0,11,1409325,0,41,9560,495
18,3,15,0,13,31859,0,8,3693,514
27,9,18,1,11,707929,2020,5,389,652
15,8,7,1,14,208365,538,61,5007,499
5,2,3,3,9,70330,70330,65,0,488
10,4,6,3,25,313707,51583,100,8727,459
37,15,22,4,20,1036471,312874,157,3474,421
15,3,12,3,9,44525,44525,230,27476,470
9,6,3,6,19,201698,232534,91,30608,511
14,1,13,2,15,15044,26407,41,15044,581
7,2,5,3,6,40728,41209,38,0,448
13,11,2,3,6,46075,1352,62,1144,485
13,2,11,3,6,49640,49640,57,19721,534
27,4,23,2,10,140106,17620,35,85,588
4,0,4,1,8,17850,17850,21,5951,466
5,1,4,1,8,6462,6101,16,6101,437
18,11,7,3,11,1202926,4865,29,5,491
14,8,6,0,5,304842,0,11,0,618
15,10,5,6,6,129742,37308,91,17019,434
5,3,2,2,14,114100,114100,0,0,558
5,2,3,0,13,60527,0,1,7500,649
37,7,30,5,18,445652,57510,60,20507,516
21,3,18,2,11,392386,45843,1,41435,484
14,2,12,1,10,4265,2923,48,1642,505
80,8,72,0,12,20075,0,174,82274,482
22,15,7,0,9,623687,0,17,0,524
21,7,14,4,10,39600,27405,65,7893,439
3,0,3,2,3,0,18992,26,12886,494
9,2,7,1,8,2086,1004,66,1004,593
4,1,3,1,6,34007,34007,22,0,510
30,12,18,12,8,242542,189811,265,27426,413
6,3,3,0,7,50377,0,7,0,580
48,13,35,13,11,119741,119741,176,11194,388
9,6,3,0,11,147383,0,0,0,609
16,4,12,4,5,37175,18491,104,4863,495
17,8,9,1,11,297984,36626,40,36626,465
3,1,2,1,7,0,6533,0,0,585
97,16,81,6,18,82566,27241,278,6596,465
22,13,9,5,25,669719,671064,72,102523,502
46,10,36,0,14,62492,0,4,900,628
7,5,2,1,9,1431,498,30,0,459
8,5,3,3,6,45667,24927,29,957,564
8,4,4,1,13,26711,13678,36,13678,386
34,3,31,4,10,66876,15210,0,0,442
26,4,22,3,8,37401,16057,75,3866,507
138,5,133,3,7,27894,9670,124,9273,466
8,1,7,0,9,0,0,23,725,528
9,7,2,4,10,106433,214257,80,13230,499
26,11,15,7,17,33761,40191,94,50695,446
22,3,19,2,15,160010,154375,47,3545,462
18,6,12,1,5,152207,4613,1,4613,614
4,1,3,2,9,19852,27984,31,19852,530
74,15,59,7,21,169516,92908,171,37448,437
27,15,12,1,21,1234918,8006,21,6777,466
5,3,2,3,6,56162,46778,48,2030,522
10,4,6,4,17,69074,69074,307,29715,445
19,5,14,2,15,25960,463,35,1091,467
23,8,15,10,8,194931,207078,150,75268,444
16,6,10,7,11,23181,30692,66,9914,455
58,18,40,0,15,8810338,0,58,1034,579
14,4,10,1,4,10264,1057,38,5560,657
19,8,11,8,16,103419,46569,134,5077,457
15,7,8,1,8,139918,7512,46,0,522
12,7,5,6,8,391050,28274,33,4269,420
27,9,18,8,15,1218817,156410,173,30254,481
6,3,3,4,15,582859,95608,43,0,537
34,15,19,12,16,173060,92710,369,65966,420
30,12,18,6,10,259694,34513,32,2864,454
7,4,3,3,12,261949,31189,63,17809,510
24,17,7,14,12,543875,65115,319,28724,423
11,7,4,5,12,17144,16664,23,12756,387
14,12,2,1,20,403082,2363,65,6572,526
7,3,4,0,15,18442,0,0,0,644
8,4,4,6,6,11508,46010,65,33346,450
15,4,11,1,8,3054,2756,24,2756,613
18,13,5,15,13,94785,115309,269,10150,475
14,5,9,3,12,296628,19071,122,20114,478
8,4,4,2,9,15153,14538,87,8434,556
22,6,16,0,14,107834,0,14,3824,600
14,6,8,2,10,153425,4379,19,3476,513
33,10,23,0,8,74588,0,9,0,647
4,2,2,2,5,8426,35255,0,0,511
35,15,20,10,15,141462,74674,153,9025,427
5,3,2,4,4,16813,16813,112,7722,438
11,6,5,1,14,188184,2806,19,2806,551
16,4,12,3,19,13525,12865,47,9585,492
15,6,9,0,9,623133,0,0,0,551
19,6,13,5,7,50888,30729,66,11161,494
16,3,13,6,12,837011,834536,52,3510,468
8,5,3,5,7,17306,26317,6,1250,551
17,8,9,0,10,208152,0,3,587,675
16,6,10,4,11,27328,29194,160,9940,438
8,5,3,2,8,51860,20100,8,7299,463
49,14,35,8,14,253989,40625,123,15934,461
11,6,5,1,13,44310,28292,70,6540,427
11,7,4,9,6,17762,28486,140,3769,448
8,4,4,3,12,66356,40527,53,0,531
4,1,3,0,11,255503,0,4,3136,630
24,3,21,4,7,23624,20984,103,8500,437
15,6,9,4,5,72876,4329,34,2297,433
15,10,5,0,18,205311,0,2,0,605
6,2,4,3,10,9747,9747,49,4429,518
53,13,40,2,16,452406,3309,65,10005,522
5,2,3,1,7,70811,30492,16,0,508
27,9,18,0,20,27849,0,3,825,625
19,7,12,3,18,46803,10788,317,10858,490
14,9,5,4,7,225466,20293,12,1050,429
22,18,4,16,18,747913,467010,197,80567,425
12,10,2,7,19,72161,62974,110,15458,393
13,10,3,3,14,596071,34332,101,2518,493
37,7,30,4,8,106421,21066,197,836,547
22,16,6,1,22,946664,893,4,12638,427
20,11,9,9,16,722131,76077,48,21881,426
13,5,8,6,8,26106,43290,166,20339,415
21,11,10,6,10,76577,40324,74,10452,418
5,2,3,1,8,37026,1401,13,0,516
18,12,6,1,18,488217,48,4,48,537
29,10,19,8,9,115346,102951,145,59151,414
7,3,4,0,5,120136,0,24,0,634
8,1,7,0,9,0,0,46,0,528
9,5,4,0,9,62483,0,3,0,514
8,6,2,7,15,24478,34117,62,13016,519
8,3,5,1,11,0,43055,17,0,608
19,4,15,3,12,621493,63687,72,8745,481
19,10,9,3,17,49961,13009,128,10223,439
24,6,18,3,11,36374,36068,43,11525,474
11,9,2,6,15,183782,32784,75,8928,378
14,12,2,12,9,143151,107691,74,33325,448
6,4,2,5,4,118733,86734,99,0,515
5,3,2,4,6,31184,56541,0,0,482
5,0,5,1,8,0,16072,35,722,580
20,9,11,0,6,464219,0,0,0,576
37,15,22,8,13,328532,72231,162,8503,466
22,10,12,2,9,874496,16602,22,286,495
32,15,17,9,13,713094,35613,265,10709,439
20,9,11,5,13,517987,9899,51,9424,561
3,1,2,0,8,4177,0,11,480,656
11,7,4,0,8,48827,0,52,2083,485
41,14,27,5,9,132359,25434,51,3856,442
15,2,13,0,10,2283,0,28,2900,485
24,9,15,9,13,261913,111891,147,12322,377
17,3,14,1,18,4906,4436,21,1475,496
9,7,2,4,7,115016,11014,14,1913,453
12,5,7,3,11,56239,22858,99,0,517
23,8,15,2,16,1278558,13117,33,0,560
5,3,2,3,13,18031,18031,121,15516,473
16,8,8,4,10,40463,12318,38,4691,446
11,9,2,1,29,920321,7787,46,7787,558
10,5,5,3,18,404651,26151,120,5987,547
8,4,4,1,8,54727,203,1,0,597
11,3,8,1,13,22516,638,7,25134,615
35,7,28,4,22,386310,36581,162,4957,453
9,7,2,7,7,35513,35513,179,8657,432
22,5,17,6,7,401179,54610,206,9567,595
59,22,37,4,14,1880303,1884485,0,0,501
15,4,11,1,15,263825,9378,18,880,480
43,16,27,4,12,196135,13246,94,2526,459
33,4,29,3,13,19255,13718,37,4619,421
6,4,2,4,8,46683,40576,226,22847,459
57,9,48,12,18,163395,156592,220,19166,444
15,5,10,4,12,129386,129386,69,0,464
12,6,6,6,8,103856,103856,92,73127,419
11,7,4,6,15,102157,77378,115,24896,479
30,13,17,0,12,732552,0,0,435,616
19,9,10,7,9,34492,32561,98,8428,426
16,10,6,6,7,227200,145257,211,110732,435
22,6,16,6,14,42679,42679,86,12575,470
8,2,6,1,11,446138,5329,6,0,690
6,2,4,0,16,12413,0,0,212,707
7,5,2,4,14,88263,241951,57,1824,510
5,2,3,0,4,44730,0,8,0,602
11,4,7,3,29,34687,34687,44,4143,693
11,6,5,1,6,19901,7701,10,0,500
14,5,9,1,4,46071,786,9,0,516
19,8,11,8,10,45291,45291,97,2350,439
35,6,29,4,23,9559,13492,39,3933,561
11,4,7,5,14,68167,116306,2,1010,469
13,8,5,1,10,8213,43,9,1923,590
12,6,6,6,15,42727,51928,79,15819,461
12,7,5,7,10,33180,40881,94,9442,486
4,1,3,3,8,105810,145348,78,3453,565
11,6,5,0,13,336275,0,3,174,512
13,11,2,10,12,69465,61963,194,8542,519
18,10,8,7,9,145425,87731,99,13470,417
32,10,22,3,15,588355,37107,113,3101,545
31,15,16,3,16,248246,19264,7,210,480
13,7,6,8,15,187344,197601,90,10176,423
23,3,20,3,9,51528,24668,3,1210,541
8,3,5,3,10,143213,153375,0,0,463
13,8,5,4,8,39722,5392,85,1505,481
12,5,7,1,11,206676,2392,7,9525,531
6,2,4,3,6,12345,26683,39,0,525
8,5,3,4,12,13709,13709,99,4148,531
8,4,4,6,14,19312,38863,0,0,471
6,4,2,4,8,13786,13786,57,6869,394
6,4,2,1,2,35998,559,1,0,623
10,8,2,4,10,337324,71574,29,0,439
14,6,8,5,19,273269,246278,3,247,497
52,11,41,2,10,307293,60232,46,59724,461
12,7,5,4,15,302042,134168,88,54851,423
6,3,3,4,3,18456,9539,17,0,503
24,17,7,1,18,517099,1959,36,1959,553
20,12,8,10,12,364133,380174,97,2999,494
43,7,36,4,4,42857,24038,201,14032,425
9,3,6,0,10,405867,0,0,0,631
11,4,7,3,15,2861,44985,74,797,550
14,8,6,2,12,275676,1736,40,1149,472
12,9,3,7,21,125778,123707,210,39564,456
5,2,3,1,5,1927,827,29,827,645
11,8,3,5,8,30923,3158,44,1161,541
4,2,2,3,7,35563,48527,51,24733,577
14,9,5,5,7,791357,54400,139,64500,429
32,4,28,0,16,52366,0,5,0,705
34,15,19,0,16,829101,0,14,57,661
21,3,18,1,18,186620,167935,49,5417,581
11,8,3,0,8,130659,0,0,0,684
11,4,7,5,8,44600,59914,0,0,443
18,10,8,0,10,337993,0,16,13927,669
5,1,4,1,14,5528,5528,3,5528,617
33,13,20,5,12,172875,252773,47,177778,489
22,12,10,9,16,124667,150738,197,50085,428
43,4,39,2,13,2503,2503,0,0,505
7,4,3,0,14,370591,0,16,27707,608
28,9,19,10,19,33411,41044,69,11901,503
15,3,12,2,15,34994,31811,23,29738,436
14,5,9,3,16,369106,83368,12,52912,494
33,4,29,3,9,229536,20140,41,367,621
3,1,2,2,7,9356,13365,22,0,520
7,5,2,0,15,70574,0,0,0,697
4,1,3,0,12,495,0,2,0,645
25,6,19,6,9,20646,16358,125,4160,393
8,2,6,1,17,330908,5025,12,6973,563
12,5,7,2,21,219560,211383,62,206832,488
8,5,3,1,9,138099,166,2,166,556
23,8,15,6,8,27873,25560,121,9846,462
11,3,8,1,15,27627,1674,1,1674,622
11,0,11,0,9,0,0,46,0,583
3,1,2,2,10,12786,31263,34,12786,592
3,0,3,1,4,3710,3710,0,0,532
9,4,5,3,15,409271,148234,68,1134,523
6,1,5,1,7,34244,34244,25,0,485
14,7,7,3,7,84704,80271,0,0,494
5,1,4,1,9,3234,3234,0,0,629
56,5,51,5,8,117795,114595,30,94502,426
22,12,10,4,16,324970,21897,20,8096,443
10,8,2,6,3,373651,33268,28,937,464
9,4,5,3,11,50283,11337,83,2775,532
6,3,3,3,9,10550,11062,33,759,541
26,12,14,8,16,246472,190376,172,70811,439
9,7,2,0,4,59372,0,0,0,484
19,6,13,4,7,49801,9098,40,5210,446
20,9,11,4,13,53763,16884,65,7191,474
12,4,8,5,9,20488,21362,150,13330,546
8,3,5,2,7,2399,1045,0,0,487
6,2,4,0,3,212824,0,0,0,619
49,15,34,1,11,51337,149,176,6185,356
25,6,19,6,6,42788,63021,120,17442,403
6,4,2,3,5,17312,6612,7,2863,584
6,4,2,2,10,15565,2995,16,2370,537
9,7,2,5,19,87391,64216,74,16070,507
10,5,5,2,19,190994,25093,68,4999,539
10,8,2,1,5,27923,3346,5,3346,418
5,3,2,4,3,47275,30565,23,0,449
7,2,5,0,9,544,0,68,1745,683
28,8,20,6,6,52387,20372,118,13756,455
27,8,19,6,11,65946,39741,41,7605,471
19,9,10,10,14,133994,154763,197,27601,456
16,4,12,1,12,420,43023,12,786,602
19,8,11,0,4,24383,0,3,1700,520
56,11,45,7,18,301549,24360,117,4337,455
5,3,2,0,2,51911,0,20,1360,512
12,5,7,4,14,36463,34829,24,2830,459
14,6,8,7,10,78887,109715,0,0,465
6,3,3,4,4,23227,21057,16,9015,444
13,3,10,2,15,17920,16442,203,15132,542
8,5,3,0,7,98805,0,1,0,568
19,7,12,1,13,276264,1400,11,0,506
25,4,21,3,13,84673,66494,0,0,498
9,5,4,6,5,13051,18696,107,6805,415
15,7,8,1,9,100634,600,27,0,645
15,6,9,4,12,15080,14499,40,4080,450
14,7,7,1,12,114938,13377,28,13377,477
46,9,37,0,8,260335,0,101,1101,589
16,8,8,0,14,924043,0,0,0,628
34,21,13,4,9,1582187,80628,27,30951,489
3,1,2,1,3,0,2083,7,2083,611
27,11,16,7,6,829157,203454,165,2895,417
4,1,3,3,6,3236,281199,61,3236,499
12,7,5,5,10,50683,57511,3,2321,528
25,17,8,1,28,937554,5903,32,5903,514
10,5,5,2,9,34978,2161,176,5123,472
7,5,2,1,6,35098,4276,26,1725,539
8,6,2,2,3,33392,17663,9,12447,404
7,4,3,1,13,22077,22077,0,0,479
44,9,35,4,9,49964,12289,133,8194,435
15,7,8,5,9,82170,29017,70,27093,439
15,8,7,3,21,469066,2169,22,0,525
29,10,19,1,23,1189462,17068,32,2185,568
20,6,14,0,21,59012,0,64,5246,519
33,13,20,4,9,58935,20746,269,7675,524
14,8,6,1,6,21002,12738,35,12738,478
4,2,2,1,6,409,409,36,409,580
6,2,4,2,7,8144,22866,37,2912,545
11,7,4,0,7,242197,0,0,0,596
8,4,4,0,10,15262,0,0,0,557
26,8,18,6,14,340692,45625,103,43821,465
8,4,4,1,7,20463,4688,14,0,570
8,2,6,0,10,111728,0,0,395,692
13,7,6,4,21,660678,19869,40,0,519
18,7,11,6,15,63239,31603,53,4700,459
5,1,4,1,7,0,20406,15,0,532
6,4,2,2,11,195604,195604,36,696,549
14,2,12,2,15,11289,6535,53,5659,623
17,11,6,4,17,324319,56577,88,35617,477
17,3,14,4,10,603471,167068,43,115340,481
26,11,15,14,15,360402,431571,70,8353,404
3,1,2,1,12,2175,2175,0,0,520
99,6,93,0,12,246079,0,2,6000,583
21,6,15,3,19,14089,14089,70,2205,495
9,5,4,5,7,6378,6655,66,4696,469
21,6,15,6,7,297236,26812,83,11190,464
7,2,5,4,8,66494,85976,67,34234,480
10,6,4,3,11,357862,9423,0,0,459
8,4,4,1,9,365321,3193,19,3193,542
23,6,17,3,8,25178,11232,52,3744,621
20,6,14,4,8,60938,46938,52,14536,477
3,1,2,1,7,19556,19556,34,0,557
30,10,20,3,19,850670,239391,9,222714,593
13,11,2,8,13,576216,62600,204,24178,486
31,10,21,4,13,92658,9507,98,1139,495
21,7,14,6,8,51144,46955,354,17886,439
4,1,3,0,3,85098,0,0,0,623
16,7,9,10,8,227687,342366,192,109817,437
38,13,25,4,16,279224,194959,107,30,531
9,3,6,3,14,584709,51700,50,0,529
11,6,5,1,4,36767,317,1,0,607
36,12,24,1,13,356802,814,39,4882,481
14,8,6,2,10,91477,852,24,17768,481
40,10,30,2,16,160668,2468,46,2880,466
10,6,4,1,7,21760,1543,5,1543,441
17,1,16,0,8,11326,0,96,13414,657
8,3,5,2,12,12970,10633,0,10337,498
10,8,2,1,6,64626,125,1,0,553
8,5,3,0,14,292313,0,49,66208,432
11,4,7,0,24,477678,0,0,13812,511
14,4,10,2,13,51625,26706,24,13120,503
26,13,13,2,11,87204,6061,71,3232,519
16,9,7,5,7,548509,46580,87,409,493
33,15,18,0,17,2811228,0,2,3839,633
9,3,6,2,3,105884,5491,156,5106,486
8,1,7,0,8,0,0,14,0,653
61,11,50,4,16,67642,21137,52,8254,427
9,4,5,3,8,356191,44768,48,6912,427
10,6,4,4,4,460573,75199,0,0,464
8,6,2,5,14,39908,25430,1,2438,443
22,8,14,0,46,327778,0,6,8369,538
17,13,4,2,7,261603,5188,18,4649,503
41,17,24,7,11,422539,27210,100,1262,486
10,5,5,0,9,145167,0,0,0,654
24,7,17,1,7,105711,13,7,13,633
15,1,14,2,7,2105,8982,107,3991,481
23,3,20,3,13,5613,5613,2,1796,428
9,3,6,1,7,464951,19606,24,0,636
12,6,6,0,11,26420,0,83,3198,607
23,9,14,6,14,215149,39294,132,12167,446
14,9,5,1,11,378835,3367,31,3367,604
16,6,10,2,15,251857,13107,14,9917,433
5,3,2,3,4,9257,9257,39,737,461
10,2,8,0,2,21453,0,0,0,600
13,8,5,7,14,148984,58099,3,3144,386
18,6,12,0,9,12119,0,85,2510,551
32,1,31,0,10,5262,0,28,3567,648
18,2,16,3,8,4310,11061,3,589,531
24,8,16,1,13,132182,1047,9,11028,471
43,16,27,16,14,159429,129338,531,20468,417
8,3,5,2,6,19493,19493,65,10221,521
41,13,28,0,12,1677681,0,138,2218,603
14,8,6,4,13,124068,25938,30,9869,459
44,4,40,5,7,16968,28926,88,0,525
10,7,3,6,14,28787,25917,77,7506,468
14,8,6,3,13,30619,23758,64,12280,489
22,4,18,2,6,8644,8204,152,7124,395
13,4,9,4,7,63602,70822,74,11215,493
28,7,21,2,7,447799,3555,8,612,516
14,12,2,5,8,663702,4417,74,1533,453
12,10,2,10,7,216924,164567,132,113888,396
13,8,5,4,6,40896,39282,42,0,460
27,9,18,1,14,105786,5072,4,2800,639
10,1,9,3,10,16135,39151,121,0,618
6,3,3,2,3,12613,988,11,527,455
41,16,25,0,15,1305682,0,33,1220,510
36,21,15,1,23,2185637,11840,44,11840,550
6,3,3,3,11,54366,10166,19,542,403
19,7,12,9,14,355555,340663,328,36275,483
12,4,8,2,11,182957,22693,31,12837,459
10,6,4,5,7,71678,71678,285,4170,600
3,1,2,2,8,39525,54827,45,0,522
17,6,11,0,12,190988,0,1,0,621
17,7,10,4,14,1020675,9677,42,6917,583
11,3,8,2,18,4896,4665,22,3896,471
44,7,37,5,11,60895,88791,197,29256,477
18,3,15,4,5,131028,31554,49,20361,583
2,0,2,1,5,1861,1861,44,5040,596
10,4,6,0,13,41220,0,0,0,702
35,9,26,0,15,321934,0,64,275,544
13,3,10,0,9,0,0,12,0,581
5,2,3,2,9,14964,14964,22,5303,471
17,11,6,0,7,736002,0,5,1152,631
11,4,7,3,8,88230,82528,72,0,523
46,15,31,9,18,61954,59554,162,19399,437
28,7,21,1,8,35802,1236,64,1735,556
11,7,4,3,13,213700,3370,39,1577,509
11,9,2,0,11,240037,0,0,0,585
5,3,2,0,26,41778,0,5,937,510
4,2,2,2,10,8856,14759,11,5903,547
23,11,12,0,15,1748341,0,1,7917,604
7,4,3,2,9,32526,7611,29,6806,454
13,7,6,10,13,148532,156368,67,2700,446
28,4,24,3,7,5736,5736,14,3727,455
9,3,6,1,12,132800,4426,51,0,583
10,4,6,2,7,32815,2684,19,579,621
18,8,10,8,11,309364,40452,373,17752,432
32,9,23,4,10,43878,15984,300,14119,506
5,2,3,0,6,425,0,2,0,507
12,5,7,0,8,125167,0,5,874,643
47,10,37,1,69,66437,144,21,2079,619
10,7,3,4,16,130593,130589,70,3304,475
6,4,2,0,19,50126,0,11,2633,674
4,0,4,0,6,0,0,5,0,653
19,8,11,4,18,56991,35972,43,4502,482
21,9,12,4,12,143573,52932,150,12758,427
9,6,3,7,12,38796,91182,165,14410,467
22,11,11,0,9,178097,0,8,0,561
12,10,2,1,4,1405970,10,3,540,556
9,3,6,2,9,89939,89939,50,4315,514
7,3,4,1,8,20435,7018,25,117,530
9,6,3,0,6,344891,0,20,462,523
28,11,17,2,15,247654,1378,26,2020,532
7,3,4,1,5,135730,3567,33,0,582
28,9,19,9,9,56268,73158,460,12541,420
33,10,23,6,14,443657,43607,81,9218,438
11,3,8,1,12,102785,17156,22,0,644
4,1,3,0,2,1699,0,0,0,663
19,11,8,8,13,53497,46566,70,14604,423
57,6,51,1,3,28619,2533,5,4719,519
7,4,3,5,8,31887,53711,0,0,437
10,2,8,2,9,3592,5376,27,1350,596
18,15,3,4,16,336062,69806,98,27998,427
28,15,13,5,30,865638,433646,116,7528,434
25,11,14,0,8,358679,0,74,1232,640
15,3,12,0,7,63334,0,0,2578,559
16,9,7,0,12,168861,0,6,0,589
10,4,6,3,17,21428,21428,189,11120,674
8,5,3,0,10,73429,0,0,0,591
14,7,7,0,17,175939,0,17,0,538
5,2,3,1,6,26479,2221,17,0,634
38,19,19,21,9,194115,354914,266,27782,327
6,2,4,2,11,31664,31664,16,4719,515
10,7,3,1,11,480254,910,9,0,502
28,13,15,10,12,617475,614089,0,0,502
14,10,4,6,20,256021,12962,201,6159,507
14,5,9,2,14,14387,10273,39,7462,539
15,9,6,0,16,327823,0,11,3954,556
8,3,5,0,18,12136,0,0,906,588
11,6,5,2,6,54159,5555,46,1142,565
29,10,19,7,6,142264,26492,82,11050,475
10,3,7,3,18,17478,17478,42,11315,540
14,5,9,3,14,38387,24634,165,26956,495
17,7,10,0,13,161537,0,7,291,696
34,20,14,0,11,1474282,0,4,0,655
4,2,2,2,4,120617,108946,49,103840,529
16,6,10,5,12,28219,28219,554,26500,507
7,4,3,3,12,149808,149390,28,18865,552
13,5,8,5,11,53903,69790,116,658,602
6,3,3,5,8,73395,112944,93,56894,504
14,5,9,1,17,388536,8893,47,8893,633
10,6,4,1,10,191896,54503,0,0,524
7,5,2,5,17,399997,58003,66,22275,452
5,3,2,1,15,18673,18248,21,18248,569
11,6,5,5,7,58953,58685,26,27000,441
8,5,3,1,26,589907,31758,5,10019,491
9,7,2,0,13,13618,0,9,0,513
28,6,22,4,11,352480,47887,45,5620,440
39,20,19,15,25,119556,111936,234,8684,382
15,5,10,4,7,21131,4367,135,4093,522
66,13,53,11,8,42631,33240,429,2509,371
19,13,6,0,16,428641,0,13,250,531
8,3,5,0,7,19451,0,22,236,608
4,2,2,1,12,3126,3126,21,526,557
16,7,9,0,13,135024,0,1,0,658
23,9,14,0,15,140288,0,0,0,599
22,6,16,6,15,646729,21418,64,6240,469
9,3,6,5,8,94607,94607,82,23290,448
27,3,24,2,17,536836,83783,22,0,496
23,11,12,1,10,365142,3487,20,3487,647
33,15,18,4,18,845401,26156,26,4297,402
17,11,6,10,8,281208,161109,92,1938,478
11,4,7,0,69,302850,0,1,8628,624
10,4,6,3,10,3415,145430,42,3415,464
76,14,62,14,19,253898,221875,231,17951,417
7,4,3,1,4,198616,3287,6,3287,511
36,2,34,3,10,100924,95620,45,57891,517
14,7,7,4,14,441990,322071,73,85042,446
7,5,2,5,7,25732,25732,171,15196,528
13,4,9,0,13,54392,0,2,0,566
7,3,4,2,6,4363,4880,0,0,498
14,5,9,4,8,19162,19162,324,16820,449
18,5,13,0,12,146400,0,4,0,552
17,8,9,0,9,348769,0,2,0,627
2,0,2,0,11,0,0,7,0,580
8,1,7,2,16,35447,41085,23,35447,533
7,1,6,0,1,9085,0,0,0,604
15,10,5,8,12,499578,36009,372,8454,419
9,7,2,5,9,390404,35332,53,4382,397
3,1,2,0,4,0,0,8,670,627
6,4,2,0,9,198591,0,0,0,610
15,8,7,1,6,106501,2568,5,0,623
16,4,12,3,11,122616,91245,103,77085,506
8,4,4,2,4,30741,236,238,1237,477
10,6,4,1,3,251596,128851,5,0,512
6,3,3,2,3,11710,9710,31,4915,477
22,4,18,5,10,73807,70914,162,28200,454
6,4,2,4,5,12822,12822,65,9260,513
21,11,10,9,13,120354,95272,185,22269,476
16,9,7,0,44,126585,0,1,0,738
16,7,9,5,4,21856,5928,13,0,443
7,5,2,0,4,37009,0,0,0,610
18,13,5,9,27,346515,1909608,128,22456,443
11,4,7,2,14,109972,906,51,374,528
14,6,8,5,10,1035971,778526,69,249987,461
60,10,50,4,15,159267,29567,308,24432,481
18,4,14,4,16,407277,57348,102,10970,502
10,7,3,5,9,45396,42389,255,16515,442
18,15,3,14,9,933963,62637,237,3683,407
13,6,7,3,8,3948,1687,34,1595,649
13,6,7,1,13,329650,197163,14,0,512
12,6,6,3,10,97403,48463,55,21136,489
18,3,15,0,9,55336,0,2,775,703
42,19,23,7,17,993820,159752,106,28390,390
23,17,6,0,14,710899,0,15,845,575
26,6,20,4,9,51025,12155,236,11610,465
10,6,4,6,9,140656,128838,0,0,544
16,8,8,3,5,342529,47779,14,46345,430
22,9,13,7,14,375175,324331,62,150887,391
17,8,9,1,19,216849,2500,1,3717,561
13,6,7,6,17,71394,22047,26,10502,444
9,3,6,2,22,16303,18571,14,12140,536
6,1,5,1,8,16026,16026,37,2392,510
8,6,2,7,14,83748,62780,43,25315,475
12,9,3,9,9,95734,82365,187,5599,481
9,5,4,5,7,5039,4693,68,1387,476
10,6,4,4,7,32633,24706,51,5042,460
12,9,3,2,30,459037,262717,7,984,582
6,3,3,2,13,25698,25698,45,5053,645
18,11,7,9,15,181343,80300,95,51368,424
6,4,2,0,12,6201,0,15,247,532
15,10,5,7,14,35009,35260,74,16662,457
9,5,4,6,7,77328,64544,43,19649,491
13,3,10,2,7,22821,9949,103,5239,536
11,4,7,4,24,50253,60118,44,20736,597
6,3,3,2,19,19673,11769,46,2765,453
23,9,14,9,12,730129,98508,424,23400,495
13,7,6,2,4,24600,6827,48,0,510
30,12,18,2,20,1371964,47905,77,5800,549
41,14,27,9,10,216926,24659,126,7831,415
19,8,11,9,14,41730,54041,159,17062,463
10,8,2,1,30,35059,13875,45,0,522
6,2,4,2,9,2850,1586,3,951,556
6,4,2,5,18,8022,9967,47,1958,465
19,8,11,2,5,43363,1226,7,107,582
12,9,3,7,21,243427,57912,152,12972,476
6,3,3,4,9,45163,66816,36,21588,507
5,2,3,2,10,4389,10579,36,466,521
9,1,8,2,8,11211,11211,23,8239,644
29,12,17,8,13,501414,95198,140,62033,439
6,4,2,6,13,16176,21764,80,9324,480
19,5,14,5,29,253385,197868,74,14288,480
15,10,5,2,13,97070,15457,27,13720,572
14,6,8,4,6,39846,20512,71,14592,567
6,0,6,1,8,0,11111,4,11111,604
6,2,4,3,22,22215,131584,68,109369,520
4,2,2,0,8,548,0,0,0,634
15,9,6,0,14,823070,0,22,1850,559
17,10,7,9,18,488478,38212,158,6981,467
14,6,8,3,12,55314,21169,60,2738,447
28,4,24,0,14,142045,0,9,671,593
4,1,3,1,6,28352,10590,25,0,501
14,3,11,4,9,301461,133385,39,10103,526
55,8,47,6,17,278925,26779,206,8578,469
11,2,9,3,8,57558,42651,45,22618,580
8,4,4,5,10,162072,159561,0,0,518
17,6,11,1,6,24594,14584,31,493,509
72,17,55,15,17,694408,223682,291,24515,377
31,10,21,6,9,149104,61039,293,10112,466
202,12,190,11,19,381797,378140,107,100234,444
14,2,12,4,10,70084,26273,56,0,527
16,8,8,9,10,41316,42678,97,13490,431
8,2,6,1,18,13012,10687,27,2875,574
30,21,9,15,12,428047,365241,306,202772,375
14,6,8,7,10,60790,70967,255,20715,492
13,7,6,0,6,104013,0,4,810,626
8,4,4,2,20,6830,7968,0,0,539
12,2,10,3,7,27772,27772,115,17454,529
9,5,4,0,9,16642,0,0,0,686
7,4,3,3,20,264778,183321,74,120671,486
27,12,15,3,3,66269,296,7,5017,536
15,9,6,0,9,37700,0,0,343,705
61,17,44,12,11,304707,84726,419,22882,479
27,11,16,10,16,596922,121428,214,17119,504
21,5,16,5,12,65297,65297,317,52457,451
47,14,33,0,13,1357996,0,64,694,658
8,2,6,0,10,6492,0,0,0,688
7,3,4,0,2,35103,0,0,0,602
4,2,2,3,5,2922,4342,12,494,444
20,5,15,2,6,153855,7254,29,5820,437
57,9,48,0,7,635529,0,2,6715,512
10,4,6,3,11,175865,107389,45,102635,502
17,4,13,4,13,10833,15313,101,5601,485
13,2,11,1,7,67969,3070,28,3070,640
14,4,10,1,16,163709,16037,24,4276,567
15,3,12,1,5,24308,2866,10,2866,464
5,3,2,2,12,12123,7261,40,898,563
9,5,4,4,13,93405,84993,0,0,447
7,5,2,2,12,9036,9036,42,7228,530
38,6,32,6,9,65120,69814,312,26363,489
20,8,12,5,14,395236,18486,39,19364,460
9,1,8,2,8,0,16958,222,4423,666
10,8,2,9,14,30623,28052,69,11245,426
38,5,33,3,27,10116,10116,81,6657,520
16,10,6,10,19,292044,205005,10,8357,453
20,6,14,1,7,46573,1080,2,23,542
6,4,2,1,7,56433,11898,15,11898,535
28,10,18,10,7,24584,26306,48,3243,404
7,4,3,2,20,28661,11568,3,743,466
10,6,4,7,16,228989,67325,253,30675,511
10,4,6,4,21,47564,47564,35,24414,473
15,8,7,6,15,62003,58673,32,51277,469
7,4,3,3,12,10092,6179,79,4698,520
20,13,7,8,12,210140,54651,199,23557,464
31,15,16,13,6,52952,15755,219,5572,408
12,2,10,1,20,38933,29203,18,31768,589
11,5,6,5,11,61666,61194,123,14029,529
12,7,5,3,9,60219,11805,10,6946,474
12,6,6,1,6,412983,2938,9,0,552
27,12,15,7,14,260294,56785,140,15542,461
8,5,3,4,7,331347,17399,88,1990,441
23,4,19,2,9,39287,18493,54,15418,443
40,6,34,1,15,28276,5150,24,5150,609
19,13,6,0,14,178280,0,28,0,571
13,7,6,3,16,928715,278164,53,44075,505
5,3,2,3,8,31925,40485,56,21104,506
12,2,10,0,8,11839,0,27,6837,512
8,5,3,2,7,29756,14472,12,9301,543
24,8,16,0,14,21414,0,20,1839,522
5,3,2,2,11,428944,37552,29,25071,483
4,2,2,4,6,75360,68439,107,51406,417
13,6,7,2,14,94367,68839,39,219163,485
34,11,23,4,14,33761,3321,379,4661,516
25,17,8,1,30,2601853,20634,21,1971,393
17,9,8,2,5,1457884,22751,4,22238,490
14,4,10,6,9,132571,110121,67,595,453
13,6,7,3,5,56884,3279,26,0,551
6,4,2,1,3,20683,440,13,0,484
7,0,7,0,15,0,0,0,0,515
40,12,28,5,18,177865,83553,94,30846,487
4,1,3,1,8,6807,3771,5,0,620
7,5,2,3,15,21395,9813,43,7296,487
14,8,6,1,12,586012,16428,99,24356,498
44,10,34,3,6,90754,7264,32,4395,464
26,12,14,0,14,77953,0,21,0,604
10,3,7,2,23,8047,3931,21,3664,661
47,9,38,2,14,418202,5616,17,5266,556
15,7,8,10,10,350766,120958,15,10567,482
35,6,29,1,10,41947,3290,27,6235,569
9,2,7,1,12,2820,1820,32,1820,510
12,3,9,2,18,65929,64393,69,2589,454
57,12,45,1,23,60786,10567,51,1933,689
7,5,2,0,16,0,0,0,3526,680
33,14,19,0,7,643093,0,50,3734,575
8,4,4,4,5,14998,14998,53,5000,427
22,12,10,7,18,512835,67234,87,735,494
6,4,2,0,28,961995,0,4,5112,558
11,6,5,5,8,21614,9204,60,4887,514
18,6,12,5,10,64420,53309,76,18817,466
22,5,17,4,12,366563,158503,90,0,494
40,5,35,0,32,637521,0,3,0,643
8,3,5,3,5,63951,21114,50,5394,483
16,9,7,0,18,159400,0,2,379,735
12,1,11,1,12,3527,3527,164,10373,531
44,15,29,16,19,185930,167018,430,14383,439
29,12,17,5,11,288662,62550,43,10917,418
8,2,6,2,7,5229,5123,30,2893,659
13,10,3,3,25,35515,35515,43,20873,451
6,4,2,4,19,51325,51325,72,20861,541
29,5,24,8,15,58711,58116,98,21650,436
7,3,4,1,6,16331,16331,25,162,471
10,8,2,7,7,364231,102270,148,1950,460
47,16,31,20,14,140235,184511,96,37474,415
20,11,9,5,15,527116,55754,125,16574,509
4,2,2,1,10,373025,31390,24,5422,465
12,7,5,6,8,76132,21306,100,5897,396
19,2,17,0,7,7043,0,15,1934,576
39,4,35,0,14,29222,0,4,992,731
25,10,15,0,12,558226,0,122,11266,596
7,3,4,1,9,16708,410,12,410,508
8,1,7,1,8,5018,5018,18,5018,443
27,9,18,2,8,484542,133927,25,61434,440
10,6,4,4,16,19405,19405,77,0,485
20,8,12,6,6,29954,14726,96,6681,497
11,6,5,1,7,11916,512,17,2260,549
10,7,3,1,5,244919,23391,8,0,606
36,12,24,0,13,1057670,0,2,0,591
3,1,2,0,6,527,0,1,0,644
25,13,12,9,13,1573841,364767,159,2497,528
10,5,5,6,6,68455,54257,135,4295,463
11,4,7,1,12,217990,1118,0,450,429
6,4,2,2,12,14276,6135,45,4785,548
8,5,3,2,8,42018,5486,66,9805,552
17,8,9,4,14,75332,10583,55,8701,438
18,9,9,1,15,168895,6773,17,56171,555
41,8,33,7,11,122301,55330,129,22167,448
12,7,5,6,8,17888,10037,85,5083,444
15,10,5,4,9,44082,5650,16,4691,542
46,14,32,9,39,190954,41084,134,16947,475
54,6,48,3,19,221841,92342,77,20400,433
13,4,9,2,8,12883,825,72,1559,538
14,6,8,0,9,1099669,0,0,0,685
41,8,33,6,18,23507,23497,398,19119,465
18,4,14,2,15,53948,5920,35,1185,548
5,1,4,0,12,0,0,0,0,756
48,8,40,0,9,227786,0,132,3103,547
15,9,6,0,18,1149728,0,13,0,615
9,4,5,3,8,25998,12302,164,3082,531
3,1,2,1,6,15287,7190,56,7190,502
38,11,27,6,8,335488,42450,0,0,451
9,3,6,2,17,4083,2391,36,6696,540
9,2,7,3,14,43241,34465,39,2454,452
4,0,4,1,9,0,6181,22,10929,478
12,10,2,1,7,570816,860,1,0,553
6,3,3,1,6,1861,475,5,539,530
12,4,8,0,13,18346,0,1,5792,557
5,3,2,1,12,488831,3852,2,3852,526
17,9,8,6,17,361006,36770,80,12668,478
51,5,46,1,13,42786,2701,91,5056,559
9,3,6,3,18,13768,16490,30,9652,556
11,7,4,4,11,335064,111608,94,39071,431
20,2,18,3,15,72282,65749,143,6159,637
16,4,12,3,15,382744,38146,65,3434,479
24,9,15,5,7,456862,92150,59,72470,472
17,8,9,8,15,45990,12827,52,4054,505
13,9,4,7,8,44071,11578,143,5055,419
8,1,7,4,8,80385,83453,25,0,612
9,5,4,3,14,190812,190812,131,154878,588
23,7,16,5,16,68482,70258,40,30348,558
8,5,3,5,8,161718,161718,52,109405,451
30,7,23,7,14,175626,97296,289,10034,477
39,5,34,1,9,54719,5870,1,5978,504
4,2,2,1,15,82850,6776,20,6776,652
21,6,15,7,15,33863,27573,75,8133,481
34,7,27,3,12,107817,44567,288,10909,501
9,0,9,2,7,29539,64366,41,29539,494
11,1,10,1,7,876,876,214,876,527
5,2,3,2,5,62792,57642,50,0,537
6,2,4,0,19,0,0,24,0,648
6,2,4,2,8,16556,9368,23,367,614
19,7,12,11,9,223836,235627,175,44903,437
26,2,24,2,13,408864,62962,20,45859,458
4,1,3,1,5,1515,1515,12,1882,576
16,8,8,0,6,433718,0,23,6692,565
9,2,7,1,8,266,266,76,2649,512
21,11,10,5,15,488618,24271,72,1311,454
14,11,3,2,18,451964,13663,55,6859,421
17,3,14,1,18,77671,3219,1,3219,716
18,7,11,3,7,58893,17853,103,13762,524
14,10,4,10,3,292109,220900,106,749,438
6,4,2,4,7,32418,32418,10,11814,487
36,11,25,0,15,124618,0,12,35955,609
123,5,118,2,11,57866,22329,31,0,472
5,3,2,1,24,298367,32507,16,0,543
59,10,49,2,20,322854,67067,13,6891,490
12,4,8,5,8,78704,147661,47,1234,478
7,4,3,0,3,30025,0,0,0,642
17,5,12,3,9,177237,113823,81,11960,491
3,1,2,0,3,71753,0,29,0,553
14,4,10,2,18,88989,47247,50,134,552
7,5,2,2,13,4314,4314,5,1473,527
10,8,2,0,21,134042,0,0,0,588
7,2,5,0,14,13044,0,0,1714,684
10,6,4,3,7,164166,24570,95,18338,455
6,2,4,2,5,32510,32510,26,22420,519
8,5,3,5,16,107732,161391,0,0,501
6,1,5,2,11,10428,5171,50,0,533
18,10,8,2,18,2641511,190780,59,9554,487
18,6,12,1,17,11589,238,0,3974,557
22,13,9,4,15,521286,26657,51,8484,367
7,4,3,1,7,66752,57010,18,0,574
8,2,6,2,6,0,21275,58,235,583
4,2,2,2,9,26932,17262,52,2725,513
7,4,3,2,10,75998,75378,29,1755,484
8,6,2,5,16,33426,22232,98,3127,408
10,5,5,1,14,353759,22154,0,1015,519
10,3,7,2,12,8069,8069,32,1834,520
7,3,4,4,10,403890,14434,36,136,538
16,11,5,8,8,1068076,391154,86,0,516
19,9,10,9,5,148991,105663,160,13675,437
38,5,33,2,16,11353,7160,32,3902,494
38,17,21,13,12,1581954,431422,396,125482,446
7,5,2,7,4,26287,25448,88,8934,586
21,5,16,1,10,61619,3680,30,9970,604
11,3,8,3,9,35811,8685,32,7297,462
20,7,13,5,14,27487,35233,67,11464,527
6,3,3,2,18,13887,19092,48,13289,553
6,4,2,3,6,47976,24669,75,0,542
50,5,45,3,18,149027,118894,52,59264,463
17,9,8,3,15,313695,7907,37,3322,504
15,9,6,10,8,45760,63045,170,2327,413
17,8,9,11,13,178404,243684,81,51874,363
12,4,8,3,9,17878,25578,41,9550,444
13,7,6,3,4,103107,6830,0,0,486
30,10,20,9,7,94487,72239,178,36805,406
11,5,6,1,14,435639,5573,19,5573,506
3,0,3,2,6,3880,3655,57,2717,511
21,5,16,5,8,17161,4361,183,1818,501
3,1,2,0,5,0,0,2,0,503
14,7,7,2,15,9420,16101,62,0,553
7,4,3,3,69,279363,18305,58,3113,492
4,0,4,0,5,0,0,1,264,614
5,2,3,2,7,13021,15587,124,13021,660
16,5,11,1,16,25875,8042,2,236,548
8,6,2,1,6,14312,154,8,154,452
12,8,4,0,9,75337,0,0,0,650
6,2,4,1,11,340,340,6,0,563
8,6,2,4,8,30651,36618,67,1280,425
13,11,2,1,8,1559873,447905,2,447905,588
9,4,5,1,6,28110,5413,33,5413,527
50,10,40,8,15,351754,53839,0,0,486
11,5,6,3,3,22467,13436,8,11403,506
19,3,16,1,13,5065,338,89,8297,539
8,5,3,4,8,14528,19244,66,2136,548
14,8,6,4,25,710751,83432,0,0,480
20,4,16,5,12,7810,12966,83,1385,536
19,3,16,3,10,102679,103407,60,725,490
55,5,50,3,14,34889,21958,71,21142,443
5,3,2,3,9,5969,5969,62,3899,469
12,6,6,4,11,300683,117134,145,3073,451
14,7,7,9,13,32498,62052,101,10153,485
10,8,2,4,13,393709,4105,43,1596,489
4,0,4,0,5,0,0,0,0,681
13,10,3,9,8,20368,22939,294,5615,445
11,8,3,1,7,90833,1514,16,1564,524
33,7,26,8,14,107455,111418,125,15826,416
17,9,8,0,11,706871,0,23,10780,600
7,4,3,1,9,4785,2044,2,2044,561
12,7,5,8,10,603186,111248,85,40155,484
31,16,15,0,17,3565661,0,0,0,633
21,4,17,5,14,43700,42807,58,19799,495
35,18,17,0,11,1231424,0,34,0,526
12,9,3,2,7,33222,940,9,1998,585
23,12,11,10,9,83871,77026,131,5522,444
9,5,4,0,5,63270,0,24,0,574
5,3,2,1,5,25366,1403,4,1403,481
13,7,6,4,10,375058,23405,87,480,452
8,3,5,2,19,13763,3894,45,69482,431
15,13,2,13,7,47313,56149,220,9573,538
7,4,3,0,12,476516,0,0,0,665
28,3,25,0,4,1860,0,11,1062,490
20,6,14,10,10,26337,52041,415,15866,443
6,4,2,3,6,33040,33025,103,23722,449
10,5,5,5,12,19990,19990,0,0,513
8,3,5,3,21,380156,11026,36,0,553
30,11,19,4,10,36101,11607,78,3477,419
6,1,5,0,2,1200,0,40,1847,490
2,0,2,0,2,0,0,0,0,596
4,2,2,1,7,23447,1047,17,1047,593
17,3,14,4,8,124497,118908,9,84456,501
4,2,2,0,3,5733,0,2,600,604
19,8,11,1,19,366459,1331,0,533,550
6,3,3,3,4,23211,13606,43,0,483
21,10,11,2,8,95426,1227,20,1402,474
24,7,17,4,12,56871,41751,18,27281,478
13,2,11,2,9,8258,4431,37,4895,536
6,0,6,0,11,0,0,13,0,560
13,3,10,4,8,45340,12760,12,0,569
11,6,5,7,18,69500,70503,83,38250,440
7,4,3,0,6,4328,0,2,0,654
32,6,26,4,17,665053,15572,74,3415,397
12,3,9,3,9,16914,6709,3,3040,458
14,2,12,7,5,23313,22836,271,7166,425
5,3,2,4,6,22131,45882,0,0,590
24,8,16,2,7,37497,9085,54,3318,407
13,5,8,1,14,210797,433,0,849,511
4,2,2,0,8,93420,0,0,0,650
12,5,7,4,11,113329,28148,57,11177,604
9,4,5,3,26,984146,996317,37,12170,519
20,8,12,0,14,268723,0,2,3645,588
10,6,4,1,8,108038,414,23,179,511
5,2,3,1,8,396927,49906,13,0,459
8,3,5,8,8,14376,36198,124,1665,501
25,13,12,4,14,1715007,382517,86,172801,468
14,10,4,2,16,993230,3661,22,3018,449
8,3,5,6,14,24233,28141,66,14433,486
18,8,10,0,11,151218,0,0,0,685
30,4,26,3,9,19674,14118,39,10597,458
13,4,9,3,16,122362,88056,69,0,534
7,5,2,1,2,43705,874,3,0,465
10,2,8,1,10,48647,14215,27,0,563
17,3,14,1,10,14326,1222,6,633,598
13,1,12,0,10,3200,0,0,0,606
22,7,15,5,10,330221,36701,108,5002,427
7,5,2,1,10,309376,44263,0,14481,502
8,6,2,2,5,6745,8813,42,2507,532
22,12,10,1,69,633315,989,6,0,561
8,5,3,1,5,13316,50,10,1176,465
20,3,17,2,16,22716,14009,60,11669,531
20,7,13,3,9,152947,43991,29,0,447
6,3,3,0,7,3944,0,14,1673,592
4,2,2,1,7,40419,39922,0,0,574
6,4,2,3,2,28573,2861,27,1740,408
8,4,4,2,15,396563,35568,32,6176,450
9,2,7,2,9,5999,5999,18,4718,423
23,13,10,12,14,231124,344612,237,0,446
17,8,9,5,18,45439,10531,173,28388,545
26,6,20,0,21,101858,0,63,1915,581
36,9,27,0,14,999219,0,24,3707,664
22,7,15,8,14,485297,294780,17,91923,517
8,5,3,3,15,561305,150358,0,0,480
22,11,11,0,5,190245,0,51,20805,522
8,5,3,1,11,77402,38351,38,38351,562
12,5,7,1,8,55683,414,33,1030,488
12,8,4,6,15,53113,2636,50,1126,410
7,2,5,0,13,0,0,0,20,729
17,8,9,5,14,251061,197008,76,15497,434
13,9,4,0,9,1096892,0,12,0,523
13,2,11,1,8,112302,34418,33,34418,450
7,5,2,0,8,179888,0,15,824,540
5,1,4,2,14,10348,16681,14,10348,575
27,11,16,9,8,99391,89417,206,26756,474
8,6,2,4,7,19104,21435,18,7691,547
16,7,9,9,14,33902,45259,41,15120,475
7,4,3,1,14,262083,8737,24,8737,491
23,10,13,1,19,133139,952,6,104,534
4,2,2,3,7,18837,24878,15,12670,505
15,7,8,5,17,156402,145932,91,109923,473
4,2,2,3,10,12086,27607,0,0,516
8,1,7,1,21,11322,10692,16,10692,584
18,13,5,3,13,912093,14367,65,0,472
9,6,3,5,6,238528,5809,71,2856,408
42,13,29,2,13,249351,6265,44,3451,497
17,12,5,1,2,73107,8793,20,265,527
21,11,10,10,11,199303,198945,194,34492,403
24,8,16,1,12,369724,2434,15,2434,612
10,7,3,4,10,17477,9720,121,3155,506
25,10,15,11,15,519030,612054,90,182980,418
5,3,2,0,2,20244,0,0,0,553
58,5,53,3,11,8860,2204,51,2708,648
10,6,4,4,8,66209,95684,76,41080,465
36,2,34,0,16,5612,0,5,2391,658
7,3,4,7,7,44319,74925,17,18181,444
13,3,10,0,8,10808,0,66,1614,609
15,4,11,2,7,182123,979,29,3020,558
39,13,26,8,28,501508,70313,264,50745,461
10,8,2,7,4,248180,36436,25,100,467
24,12,12,1,10,287262,1054,66,571,515
21,10,11,3,9,326114,2241,31,15293,492
8,5,3,6,6,47060,55767,104,23165,411
4,2,2,0,2,2410,0,0,0,637
5,3,2,1,3,107056,413,1,413,556
6,1,5,1,6,1580,1406,25,1406,529
4,2,2,2,6,29595,29595,5,17462,441
20,8,12,2,14,68738,11499,34,7520,505
25,11,14,1,11,703816,3118,37,5383,489
7,5,2,1,3,139751,2666,6,2813,482
32,16,16,17,10,45757,56836,185,23766,404
20,12,8,8,17,663219,1256785,0,0,521
52,19,33,20,13,592574,387282,474,49166,395
9,7,2,2,10,15889,5098,14,3136,402
7,3,4,2,6,44660,8330,10,4382,463
7,3,4,0,4,19575,0,1,208,717
7,3,4,1,17,9994,9994,0,136,557
13,3,10,2,13,12949,12949,22,6531,566
5,0,5,0,10,0,0,0,548,589
9,5,4,7,7,28624,41892,88,3092,508
6,1,5,1,12,1052,1452,9,0,555
12,1,11,0,7,11373,0,18,0,634
36,13,23,5,18,503025,41703,67,3762,492
52,20,32,14,20,370412,308202,208,19345,424
51,8,43,6,14,67340,20810,129,7386,455
8,6,2,4,17,771609,97686,202,8392,535
33,12,21,2,16,73723,7376,101,61659,482
17,8,9,7,14,274734,74472,64,0,481
4,2,2,2,4,8170,6410,27,350,586
166,11,155,11,8,278483,250824,198,13319,457
33,11,22,4,26,165767,24573,66,1402,475
19,13,6,6,9,356050,50525,75,13625,425
39,6,33,0,13,235648,0,0,0,521
8,4,4,2,7,24216,8554,52,7039,490
10,8,2,0,10,56856,0,0,2260,670
16,13,3,10,9,138877,133028,0,0,481
30,12,18,2,7,104681,4055,3,3190,492
41,4,37,2,12,23481,1343,85,970,500
12,4,8,5,15,44041,44041,73,11492,553
13,9,4,8,11,703835,57612,73,9613,464
14,3,11,0,8,13197,0,23,383,644
2,0,2,1,13,4500,4500,8,0,599
38,7,31,2,17,123898,338,117,7559,519
7,2,5,2,13,29669,39346,57,0,525
12,2,10,1,9,13,3880,15,0,533
72,17,55,12,10,167290,92645,213,31041,454
9,1,8,1,13,4836,4836,25,4836,499
19,7,12,4,18,58711,16097,117,11593,473
7,2,5,2,8,1180,2290,36,1180,528
42,7,35,2,12,351579,3632,189,3539,532
19,15,4,7,7,291399,145092,106,2062,477
22,3,19,1,16,21953,6597,99,6597,627
31,7,24,1,7,74625,2816,92,3636,570
41,18,23,0,21,1822137,0,6,18860,612
16,7,9,8,7,87210,82832,175,12344,493
7,5,2,3,7,25339,1393,31,1046,521
14,10,4,7,14,39121,34750,106,15964,432
13,5,8,5,9,64999,27031,36,14811,505
21,8,13,5,16,125907,63251,174,27668,453
5,3,2,0,3,237297,0,1,0,603
3,1,2,2,13,12352,18670,12,12352,470
6,3,3,2,8,21818,9940,26,489,560
8,6,2,3,11,37291,2536,9,1353,427
27,4,23,1,6,343275,13194,27,0,515
10,8,2,5,10,56024,45586,10,4508,466
7,3,4,3,9,156715,21223,59,10498,498
3,1,2,1,9,27789,27789,10,0,634
16,3,13,3,11,11452,9578,24,5162,532
12,4,8,0,10,30663,0,0,0,625
18,8,10,1,15,808589,1,0,0,583
7,2,5,0,11,4001,0,45,0,482
21,8,13,3,20,22973,18213,56,7896,633
23,12,11,0,19,164772,0,1,0,658
30,8,22,7,14,147832,111762,200,13567,446
42,6,36,3,16,43855,19782,158,13612,478
10,2,8,4,8,18763,318997,0,0,526
28,7,21,4,7,82543,26035,74,11567,496
7,4,3,1,5,28008,750,3,2285,602
8,4,4,4,8,15477,15477,54,6516,482
15,5,10,8,8,32315,30636,144,6511,427
15,6,9,5,11,230455,42438,76,143,459
19,5,14,2,11,122064,18219,31,16579,493
4,0,4,0,9,0,0,0,1544,622
9,4,5,1,9,146028,10621,35,0,540
47,10,37,4,12,79497,24368,63,9846,438
18,6,12,5,14,34273,22928,68,11873,537
19,8,11,0,13,129378,0,5,0,683
4,2,2,0,9,10728,0,19,234,686
3,1,2,0,2,6431,0,0,0,619
44,16,28,0,14,508110,0,36,1724,595
33,18,15,0,13,2760874,0,5,0,587
7,5,2,5,12,46648,46648,49,3579,439
13,6,7,4,10,55252,52229,223,40948,453
50,9,41,5,8,128216,23790,247,7718,425
8,4,4,0,9,54264,0,9,980,586
17,5,12,5,16,129917,121966,95,51534,501
13,5,8,0,11,615144,0,10,3914,572
16,4,12,0,10,136475,0,15,0,590
29,17,12,8,14,4346811,44858,72,5328,460
24,10,14,3,10,317179,25994,41,16165,454
4,1,3,1,8,17091,7878,0,0,644
13,5,8,1,10,46646,3074,0,0,543
35,7,28,4,6,193993,7186,41,3280,385
33,17,16,0,18,1625120,0,23,0,618
31,21,10,0,28,5384180,0,8,0,601
11,6,5,5,20,322302,14169,56,7682,465
9,6,3,0,14,24879,0,0,0,626
14,7,7,4,13,61181,56413,67,16130,402
26,8,18,6,16,416082,99626,101,17841,511
13,10,3,0,7,67847,0,7,1120,653
21,8,13,10,7,25891,31963,352,11319,484
21,15,6,12,13,670996,285367,199,25709,530
25,7,18,8,12,43264,34728,313,9030,475
10,6,4,2,15,11084,11084,39,9959,584
11,8,3,0,6,549456,0,21,50,531
10,6,4,5,3,28811,12683,101,7210,475
18,2,16,1,7,398,398,14,948,551
17,14,3,1,14,374134,17232,19,119764,550
21,12,9,1,14,195203,45810,18,0,601
26,5,21,4,10,22012,22971,73,8418,442
18,4,14,1,10,22203,751,35,886,568
28,5,23,0,13,16536,0,14,655,591
10,5,5,4,12,38370,36319,28,6223,531
16,5,11,1,13,169589,6679,22,1665,580
25,9,16,7,18,612866,236871,126,147696,457
2,0,2,0,8,0,0,0,12671,607
8,3,5,3,13,27080,27080,30,13143,464
10,5,5,4,10,20247,14793,82,4736,462
13,5,8,4,5,241463,87435,28,0,487
14,2,12,0,9,7185,0,0,0,666
4,2,2,0,9,62379,0,10,0,687
28,6,22,8,25,67519,75423,151,5981,436
16,7,9,1,8,49984,550,180,3659,559
20,7,13,1,19,142693,2490,65,9902,551
23,10,13,5,18,168871,85692,108,24754,574
15,9,6,0,8,626708,0,0,0,592
6,4,2,1,4,246564,166584,9,166584,545
27,20,7,8,18,1586806,248152,91,20000,433
7,4,3,4,17,11791,1391,120,1193,491
90,13,77,0,12,523047,0,64,1825,449
19,2,17,3,9,0,19003,40,0,631
23,14,9,0,19,3062006,0,11,7739,500
11,5,6,5,14,270501,332404,91,30729,456
15,10,5,0,17,544938,0,16,486584,538
8,6,2,1,6,170479,363,7,363,439
18,14,4,17,6,667953,241347,243,13013,425
8,6,2,4,8,12408,26049,68,8735,508
125,14,111,5,12,433301,30145,243,11978,455
8,5,3,5,6,11295,11295,62,4201,525
17,5,12,1,11,16857,14167,24,14167,488
11,4,7,5,6,51203,51203,174,6400,514
32,7,25,2,13,225967,7007,9,4352,528
38,8,30,3,9,20221,18154,158,10887,444
50,13,37,7,19,832274,325080,43,34424,408
37,16,21,1,11,2508143,99169,31,0,568
10,4,6,2,14,31679,22624,25,15360,563
3,1,2,2,17,3182,7872,49,0,647
11,8,3,0,5,522991,0,3,0,629
16,7,9,0,8,334981,0,90,0,451
9,7,2,2,6,3490,4529,24,2335,521
12,4,8,0,8,117668,0,1,199,647
7,4,3,0,10,36,0,11,0,677
15,10,5,2,20,343497,46608,54,32246,578
15,10,5,1,14,888994,948,3,57086,500
9,6,3,0,7,93116,0,5,0,675
8,5,3,2,5,39205,2644,59,2499,502
12,7,5,3,14,766623,134957,51,0,530
26,9,17,5,12,272002,72703,66,15743,548
8,3,5,0,2,5233,0,0,757,626
19,2,17,2,9,6932,3372,214,7072,566
8,6,2,3,17,469949,8275,14,4153,395
27,6,21,4,9,27142,24204,43,17169,438
15,10,5,8,14,65092,55232,174,9695,442
18,8,10,0,7,69534,0,34,2898,669
13,6,7,4,8,17774,4598,40,1835,478
4,1,3,0,15,222492,0,2,0,656
20,6,14,5,26,59769,88229,75,721,555
5,3,2,3,6,57539,51627,55,0,525
16,8,8,4,11,347916,24693,115,9500,383
16,4,12,4,10,86685,22643,0,1709,604
8,4,4,2,7,12161,1225,92,1166,546
13,5,8,6,9,14427,18958,86,5115,418
16,2,14,1,8,5933,1793,2,1793,487
52,9,43,6,11,75670,40295,132,10052,447
29,3,26,0,18,220480,0,0,1113,730
13,10,3,1,6,305703,3327,12,0,455
32,10,22,6,19,1434033,116645,20,15912,488
8,4,4,0,30,94000,0,18,0,650
9,6,3,6,5,12640,14015,50,4772,438
13,6,7,5,7,55394,23159,43,1250,546
7,4,3,0,5,122253,0,3,2672,569
26,4,22,4,9,24940,24940,193,16719,593
16,10,6,10,7,26713,35472,211,8767,445
18,9,9,6,10,50476,32008,98,2597,439
22,4,18,1,17,13602,116,200,914,586
17,11,6,8,14,131573,122493,129,29633,449
27,4,23,3,9,84957,18279,15,16743,478
9,5,4,0,3,161446,0,5,0,619
27,11,16,2,10,106686,12495,91,4633,391
10,7,3,8,7,65512,74846,233,8427,526
13,6,7,0,14,149516,0,2,0,658
49,12,37,1,17,622941,2980,112,414,635
3,1,2,0,9,1000,0,1,4880,641
11,8,3,0,5,396923,0,1,0,607
7,2,5,2,8,5138,21996,0,0,613
44,11,33,7,15,187298,56059,88,1771,450
3,1,2,1,24,9516,9516,17,0,646
17,10,7,5,23,340536,93617,51,17506,466
24,4,20,4,9,48326,50582,112,26199,498
2,0,2,0,8,0,0,0,0,641
11,3,8,2,11,30635,30635,120,17894,568
53,9,44,10,15,335923,119595,75,3377,448
8,1,7,1,9,1257,816,30,1250,588
10,4,6,1,15,149295,1288,7,14870,500
14,4,10,4,8,24219,24219,308,19731,471
21,13,8,0,5,95946,0,1,124,659
23,7,16,5,9,16357,18200,108,2172,440
14,3,11,0,11,24012,0,5,483,759
6,4,2,1,4,23817,2307,10,2307,640
22,4,18,2,29,444801,49093,59,461,622
43,6,37,2,7,37288,537,53,3253,504
15,8,7,5,13,75706,55664,115,20893,516
15,2,13,1,13,20067,20067,82,20067,609
11,5,6,2,11,40590,34447,72,0,454
29,12,17,7,14,392652,38850,73,11478,402
9,3,6,1,10,15090,1825,6,0,565
9,6,3,7,13,662133,190292,119,63605,424
6,4,2,0,3,27025,0,2,0,590
20,5,15,1,8,73516,3607,16,7729,617
43,11,32,5,10,62193,35448,66,15824,462
19,8,11,0,20,559449,0,0,0,506
7,5,2,3,8,18231,18081,306,17156,538
7,4,3,1,2,76201,2230,2,0,459
27,9,18,0,16,614131,0,5,363,672
14,9,5,8,7,1479407,373584,5,1415,471
12,8,4,5,9,81077,38125,90,794,409
3,1,2,0,3,0,0,0,0,653
44,9,35,0,13,35768,0,12,833,619
31,10,21,11,9,126276,142359,221,42189,457
12,7,5,4,8,52032,43744,100,7333,605
11,9,2,2,8,47501,2999,4,0,553
82,5,77,0,9,200583,0,40,5845,605
14,11,3,0,7,312733,0,30,558,569
7,5,2,0,8,93199,0,1,290,581
9,1,8,0,10,231,0,0,396,678
8,5,3,4,12,235468,51227,31,43197,422
8,4,4,5,6,12850,86140,0,0,554
8,5,3,5,6,42887,42887,118,27263,395
8,6,2,4,13,43771,19381,12,1484,460
9,5,4,2,8,48681,2411,40,3258,582
24,6,18,6,7,72779,93868,120,23711,437
7,2,5,2,9,41152,41152,74,3296,619
13,8,5,0,15,314049,0,8,3622,677
12,10,2,7,15,387950,53182,145,23370,334
10,6,4,3,17,106614,23211,61,12361,484
8,5,3,1,19,166659,1113,18,15203,608
43,8,35,2,25,366038,12539,60,5736,534
20,4,16,5,11,25727,22644,79,7060,562
7,5,2,2,10,296194,237825,40,3726,494
12,3,9,0,7,262004,0,10,5654,637
11,1,10,2,8,8486,8486,22,2292,647
24,13,11,11,13,615156,84919,225,28495,462
4,2,2,1,9,7387,7387,0,0,573
34,7,27,4,15,55254,40131,191,25888,492
22,9,13,1,18,185463,25829,19,6082,529
15,4,11,4,10,38327,28888,0,0,501
18,9,9,0,15,291465,0,40,839,632
12,7,5,5,19,493203,39287,24,21096,482
8,2,6,4,10,6438,11655,27,1452,495
25,3,22,3,10,38792,18703,52,18272,492
26,8,18,1,15,95621,4530,11,4530,532
9,6,3,2,3,40946,22404,11,3880,499
12,2,10,2,14,12463,5438,17,2511,559
5,0,5,0,21,0,0,0,372,620
13,9,4,1,19,288476,29145,27,29145,484
17,3,14,2,8,5900,5990,0,0,509
15,8,7,3,11,50117,12284,38,12926,459
38,7,31,2,15,31145,16992,39,14419,593
14,5,9,4,16,17043,14917,31,6337,398
9,6,3,3,10,502364,201593,66,139680,450
17,8,9,7,9,432071,51998,88,45518,432
18,7,11,6,7,23285,22433,100,1466,493
5,3,2,0,7,155571,0,0,0,584
6,3,3,3,7,7521,7521,128,4089,395
6,4,2,0,5,3995,0,10,0,593
67,10,57,4,11,121136,3489,113,3870,521
17,13,4,3,11,86094,35832,47,9495,502
12,6,6,0,10,427188,0,7,2589,553
90,11,79,0,13,753185,0,11,14153,661
20,14,6,6,5,473571,29397,44,5325,427
15,12,3,14,5,285559,310279,216,4461,414
29,15,14,9,69,1740920,344476,109,2043,440
29,12,17,1,14,170496,2647,0,0,533
12,10,2,6,9,142584,26295,106,10163,473
18,5,13,0,6,90082,0,0,0,658
13,3,10,1,8,14397,2962,19,2962,493
19,6,13,0,6,688241,0,18,0,599
38,2,36,2,12,6841,6436,25,1659,495
11,6,5,5,17,290500,91041,126,17063,488
23,11,12,0,10,189329,0,25,0,511
4,2,2,0,8,6401,0,2,0,663
17,6,11,5,9,44147,41917,85,9686,469
19,8,11,6,14,63416,56923,104,25871,402
8,3,5,3,14,29360,24280,10,4100,524
13,4,9,5,14,56849,101914,25,31796,455
21,11,10,5,17,152822,19726,62,7174,432
20,8,12,5,9,220885,18755,39,5168,425
14,6,8,3,11,35189,3049,24,1800,474
18,8,10,9,10,22937,25816,369,10412,464
19,14,5,13,9,76456,70016,312,12697,383
48,7,41,1,18,61513,31997,0,906,640
7,5,2,6,12,33813,40284,118,15071,475
8,1,7,0,7,0,0,122,4181,653
12,8,4,4,15,0,2051297,0,0,509
14,2,12,3,12,29367,21127,95,19349,476
12,6,6,5,15,106762,53077,47,7651,391
12,8,4,0,9,249668,0,5,0,591
6,4,2,4,10,15476,29968,8,3730,498
15,3,12,3,10,8102,17528,61,889,474
13,9,4,0,18,827534,0,1,11945,581
10,6,4,6,10,184846,185497,98,90244,473
7,5,2,5,3,144069,39530,31,10675,449
48,10,38,7,17,234796,103313,46,24484,559
12,6,6,6,33,49521,49521,18,7201,501
9,5,4,0,6,21443,0,0,0,479
21,7,14,2,69,404046,34796,15,26123,498
25,5,20,1,16,236511,12571,46,2945,506
18,3,15,4,16,140161,31530,88,11223,552
13,5,8,1,6,18788,4342,0,0,637
7,4,3,1,20,89069,26241,10,2032,699
6,2,4,2,9,53318,51676,35,0,490
26,16,10,1,14,613860,388,0,0,527
19,11,8,13,10,328374,377236,227,3168,508
3,1,2,1,18,159496,141911,22,314315,621
11,8,3,7,16,974384,137957,80,110630,411
33,14,19,0,12,207078,0,10,2629,678
5,3,2,2,17,502288,35104,17,33886,550
7,4,3,3,10,408549,18557,43,11401,435
6,4,2,0,7,19453,0,13,686,595
14,6,8,2,14,267333,10482,32,9865,492
18,4,14,3,16,251824,55120,58,20665,402
19,7,12,3,13,83926,34658,54,29478,555
8,6,2,4,4,154920,43557,127,13483,429
32,9,23,0,12,247566,0,0,0,625
43,4,39,0,13,358892,0,13,3313,540
17,10,7,3,19,459962,62236,87,0,577
17,4,13,0,4,52222,0,2,2700,602
9,6,3,1,10,130464,3554,15,3554,491
9,7,2,1,11,265417,16636,1,16636,535
33,1,32,1,7,22656,22656,37,22656,607
8,3,5,3,11,8962,27117,59,2862,514
25,8,17,2,11,78986,3259,248,11196,468
38,13,25,7,12,100926,47308,141,23617,424
13,4,9,1,9,231818,76968,26,0,569
10,4,6,4,8,16357,17941,112,6650,485
19,12,7,9,10,70926,91099,134,9748,395
18,5,13,4,23,584476,78096,61,43758,458
7,5,2,1,20,96371,86545,11,86545,488
15,10,5,7,22,1141314,260168,11,100326,455
15,7,8,0,8,446359,0,0,0,602
5,2,3,0,7,9245,0,4,0,586
5,1,4,2,8,21735,51203,27,0,505
21,7,14,0,17,197103,0,0,0,710
7,4,3,4,7,359357,20575,75,12045,494
9,7,2,3,10,492399,11337,53,0,489
9,4,5,1,12,26776,8273,95,8273,641
52,23,29,14,7,864902,307909,306,113647,432
3,1,2,0,12,0,0,0,0,686
12,5,7,1,14,378616,11989,18,11989,501
7,4,3,3,14,163612,141715,74,15645,471
12,9,3,5,8,1065190,41812,108,15039,425
40,11,29,10,10,83111,60068,391,12200,451
10,2,8,0,20,138047,0,28,853,621
13,6,7,2,22,84540,8859,12,8837,491
14,7,7,7,9,308243,5497017,180,146100,486
16,3,13,3,13,7699,7699,60,3891,490
8,6,2,7,7,28198,49997,87,21799,518
26,17,9,2,18,712690,8422,11,0,440
8,6,2,3,23,292910,171589,4,152661,470
8,6,2,4,9,40255,19248,67,5097,522
16,6,10,3,20,115525,9499,77,6600,528
27,11,16,12,6,69870,100675,133,22231,434
16,6,10,1,19,27027,2360,7,2360,570
25,12,13,0,12,389207,0,2,0,621
16,9,7,0,22,268011,0,0,1640,696
14,9,5,0,18,1282641,0,2,0,690
5,3,2,2,7,1594,1594,23,1365,561
12,8,4,2,24,346743,251280,50,6130,495
9,3,6,1,10,23793,2047,2,2047,547
14,7,7,4,6,109102,64130,32,10627,460
12,4,8,1,14,196586,1,18,415,545
6,2,4,2,5,1573,3259,40,2973,489
7,1,6,1,10,2650,2650,39,2650,570
16,10,6,10,9,432306,61221,83,9560,419
8,4,4,4,4,12523,11765,50,4999,433
13,7,6,0,6,556936,0,3,0,513
4,2,2,3,6,5263,8565,17,1920,472
12,7,5,6,10,21639,21639,133,4990,414
10,8,2,10,8,54989,67581,0,0,498
20,9,11,6,7,332984,105346,0,0,441
10,5,5,3,5,13998,12741,282,8432,506
6,4,2,3,9,20166,20166,46,1250,482
15,12,3,1,23,592162,2410,7,843,623
30,8,22,2,9,310562,1360,40,3965,506
26,8,18,7,11,361636,361636,30,25604,443
18,10,8,11,14,60434,90645,147,18657,414
6,3,3,3,9,9325,9325,41,7002,620
24,9,15,0,12,358980,0,13,0,690
6,4,2,5,6,3443,14167,49,10724,511
45,7,38,4,12,88882,36278,87,24798,441
16,12,4,0,15,3426143,0,12,0,479
7,2,5,2,8,30950,22486,31,13608,641
28,10,18,0,11,393729,0,18,0,528
30,3,27,0,10,1000,0,8,608,656
35,11,24,3,12,195074,7069,45,4801,440
8,5,3,4,7,25276,907,48,1102,540
4,2,2,2,7,8061,8061,28,6365,523
17,6,11,5,10,19646,16518,288,6726,445
11,8,3,8,7,714655,222942,166,3677,423
23,11,12,4,13,364771,22485,19,704,464
17,10,7,0,6,2068,0,1,1677,588
14,8,6,4,9,349652,4012,22,1645,515
8,5,3,5,11,4370,12103,80,207,524
22,17,5,1,7,209886,3280,7,3280,591
4,2,2,0,6,17596,0,1,9013,593
25,10,15,1,7,26775,443,48,2000,444
14,10,4,4,7,184298,54912,0,0,464
10,5,5,5,8,39433,39433,241,15517,414
58,11,47,4,12,414726,7330,290,2875,473
13,5,8,3,19,634040,90437,38,1216,501
39,13,26,0,12,1278763,0,8,937,572
10,7,3,6,3,424684,125546,65,5543,411
6,3,3,5,22,85756,61338,94,0,498
26,11,15,5,15,221939,42262,111,7109,446
11,4,7,0,17,50016,0,0,0,663
14,2,12,2,9,15937,26085,12,10148,561
4,2,2,2,13,3236,3236,18,2654,520
6,3,3,2,9,25785,25785,35,1200,470
12,8,4,5,7,329241,119036,66,1380,425
5,1,4,2,8,5910,15656,7,1190,490
14,6,8,5,18,13595,55709,123,7250,635
11,5,6,4,7,110619,32042,27,0,442
6,4,2,4,4,64360,9167,17,0,464
23,19,4,0,8,478416,0,3,0,631
6,2,4,2,18,12365,6798,26,0,549
8,5,3,2,9,70686,6092,29,4351,568
113,3,110,2,16,247588,37689,78,0,519
14,8,6,6,8,49308,41572,318,15001,438
14,6,8,7,14,176995,315367,112,4211,457
9,5,4,1,8,498,6979,77,129,480
18,6,12,4,8,59606,13794,48,7504,497
13,9,4,11,8,29603,43814,196,6178,461
15,10,5,8,21,262369,143405,136,31660,513
15,7,8,0,13,341349,0,0,0,684
51,16,35,7,17,341666,42037,96,11770,420
59,19,40,22,12,186736,220276,109,25196,444
29,11,18,3,7,71830,38316,39,19615,526
19,8,11,0,8,34973,0,4,493,612
24,8,16,2,30,61862,12362,195,13737,492
30,11,19,3,10,227462,67287,34,11365,519
8,4,4,0,9,389420,0,1,0,543
30,11,19,12,8,763683,724565,32,9804,454
13,9,4,1,17,565437,12492,39,1117,474
9,6,3,1,8,41383,26109,32,26109,530
31,5,26,5,12,52691,70145,92,41473,490
23,12,11,2,6,163761,23458,94,5000,499
42,11,31,0,14,153215,0,2,2442,617
4,2,2,2,11,10943,10943,38,7778,594
14,3,11,0,17,407840,0,29,0,625
4,2,2,1,10,8388,8068,28,8068,640
7,3,4,3,12,44800,44800,56,63251,470
5,3,2,3,11,73485,61658,37,32400,462
13,6,7,4,14,96663,85007,59,0,451
41,7,34,2,13,320015,1874,5,1127,437
24,9,15,0,13,760087,0,21,38615,430
32,15,17,11,12,77261,59986,117,8987,411
4,1,3,0,6,6072,0,0,0,712
10,4,6,0,25,652181,0,4,0,655
18,12,6,3,10,326976,44230,61,7361,472
18,10,8,0,10,924161,0,34,0,483
17,4,13,5,19,121759,129376,145,2223,514
6,4,2,4,6,52860,50535,81,3131,477
16,5,11,3,11,289608,19761,56,11254,621
12,6,6,0,25,282450,0,3,0,542
7,4,3,1,13,966,966,3,2898,531
10,6,4,3,8,44788,11570,57,7396,535
13,5,8,3,9,43741,11386,66,5447,612
11,5,6,1,19,453297,466,1,6155,655
12,7,5,1,17,491853,127272,26,127272,474
14,9,5,10,4,57000,35840,143,21427,392
7,2,5,2,14,34487,23133,24,6843,609
7,5,2,0,13,839030,0,0,0,697
14,7,7,2,17,73056,29105,38,0,484
13,5,8,4,9,39525,39525,171,28083,401
13,2,11,2,12,8055,8055,35,4701,627
31,13,18,2,69,199730,1418,13,1104,544
50,11,39,2,5,107061,6284,20,6853,392
6,2,4,1,5,93458,5252,4,5252,623
15,5,10,4,13,193089,261162,77,21,547
12,8,4,8,10,58753,64974,130,82778,414
7,3,4,4,8,109021,137414,95,67847,469
16,9,7,7,9,306053,20230,109,9036,468
25,3,22,1,6,192907,2218,6,0,548
10,5,5,3,8,29773,24408,61,4370,378
15,8,7,0,7,366875,0,19,0,550
4,1,3,0,5,4200,0,2,101,695
6,4,2,2,14,353829,4353,17,11661,555
10,7,3,6,4,402240,34314,94,609,413
9,7,2,4,9,369118,61334,72,6348,420
19,3,16,2,16,401387,68869,131,9194,475
13,4,9,1,9,42482,2597,30,2597,527
21,15,6,0,12,358039,0,0,366,665
4,2,2,3,9,529867,46998,39,35032,443
23,10,13,2,19,200170,44034,42,22017,469
9,5,4,4,20,29562,37825,109,0,573
14,7,7,0,13,39763,0,5,0,671
12,5,7,5,9,185961,140775,37,62634,431
19,5,14,0,7,168339,0,2,0,570
4,2,2,1,3,2553,1662,16,0,445
42,16,26,12,69,170086,106466,433,13621,421
41,19,22,10,16,192261,180636,55,12261,552
12,10,2,8,10,72097,16211,24,5734,462
8,3,5,4,7,27225,36998,105,19375,440
8,4,4,0,9,2852,0,17,2670,419
6,4,2,5,16,47169,63668,81,21431,444
51,11,40,8,16,189248,54858,143,21806,485
13,7,6,5,15,338177,50246,259,10208,492
56,13,43,9,15,118719,71616,354,57788,377
4,2,2,4,5,29956,50760,79,24604,452
7,5,2,2,19,484909,17863,112,23868,455
13,4,9,4,14,28129,36381,58,15153,471
48,11,37,2,5,530658,48378,45,41640,502
22,6,16,2,5,200347,15138,3,11625,512
19,7,12,2,13,174332,127235,41,96451,532
17,6,11,0,13,1496377,0,6,0,566
11,5,6,3,14,413329,24854,40,22508,485
14,3,11,4,19,70305,18803,100,4981,451
17,10,7,0,9,835681,0,3,0,676
29,20,9,10,10,300003,171002,397,105797,433
7,2,5,3,14,27287,24695,34,15595,538
9,7,2,4,69,63903,25738,77,9937,404
15,5,10,7,14,679935,682181,77,0,466
19,4,15,1,9,7383,4147,24,4147,511
18,5,13,0,18,174817,0,0,0,693
7,5,2,4,13,7878,18171,23,1529,439
5,2,3,1,6,7850,3146,21,3146,614
12,10,2,10,11,34428,37925,52,4954,411
10,4,6,0,10,384544,0,21,4722,581
8,4,4,1,13,95319,21540,51,112648,522
17,10,7,6,10,42059,23645,157,12160,480
46,8,38,8,9,60559,61930,435,108389,389
10,6,4,8,14,352476,105818,96,11944,475
9,0,9,1,6,2074,2074,15,2756,631
3,1,2,0,12,0,0,33,0,623
37,5,32,0,15,23945,0,12,758,579
8,4,4,2,7,208822,39794,9,0,466
31,14,17,12,18,1432136,102923,64,18860,459
11,4,7,1,7,25701,1368,179,4216,468
4,1,3,0,12,7135,0,0,315,652
25,10,15,11,14,494325,845603,206,335891,426
214,10,204,2,12,83049,22034,3,21599,504
6,3,3,3,9,27776,33927,40,7498,525
81,21,60,0,14,517956,0,14,1723,580
11,6,5,2,15,70928,44181,29,80923,512
13,6,7,3,3,105431,26327,22,9214,475
58,15,43,0,15,642012,0,51,695,603
17,5,12,0,6,51047,0,14,0,503
36,10,26,18,15,183345,261116,268,207200,471
38,19,19,1,17,284644,3680,35,3680,527
27,6,21,3,6,32093,4755,64,26513,440
17,9,8,9,10,27351,27351,113,7064,376
46,8,38,3,14,142328,4662,68,21743,499
2,0,2,0,5,0,0,112,2221,588
21,12,9,3,9,285506,118168,116,2400,523
28,17,11,1,16,1407892,1111,7,1111,509
52,10,42,3,7,659718,166723,73,0,490
7,3,4,0,13,124364,0,6,1812,743
6,3,3,0,5,0,0,7,0,507
37,6,31,3,17,27944,27698,49,5931,512
8,5,3,5,11,32102,92756,12,20501,426
4,2,2,1,5,419302,1200,27,0,557
73,18,55,10,12,1480372,269971,242,115958,412
20,10,10,13,12,58636,215914,242,7964,496
10,8,2,2,8,204009,2256,43,712,526
11,7,4,1,8,291766,2962,17,0,573
49,5,44,5,7,191359,182667,56,1386,497
6,4,2,3,8,237122,38074,45,0,498
58,7,51,0,14,237545,0,46,2520,606
6,2,4,4,5,21923,21923,41,8604,488
5,3,2,4,7,15090,21492,47,12974,412
34,4,30,1,9,20811,17708,174,5386,519
9,6,3,1,11,438597,10448,52,10448,475
19,9,10,7,12,319072,57502,74,33123,426
14,6,8,0,8,10485,0,6,458,607
4,2,2,3,14,13678,34876,59,0,580
37,7,30,1,8,34220,649,28,872,554
12,9,3,1,17,490448,12992,24,12992,538
11,9,2,2,5,62027,4747,4,344,500
14,3,11,0,6,93575,0,5,0,612
7,2,5,0,13,11961,0,8,770,666
13,6,7,5,6,48197,73973,99,38117,437
7,5,2,3,9,28636,479,23,4043,525
48,3,45,1,11,10852,9620,12,9620,593
25,8,17,6,16,324811,156795,72,5916,439
8,5,3,1,12,217869,454,10,814,551
19,3,16,1,18,13820,22583,19,9394,687
7,3,4,1,10,462585,13413,0,0,483
8,5,3,0,9,328653,0,2,11777,469
14,9,5,11,14,115058,91461,0,0,447
4,0,4,0,4,0,0,369,4729,625
4,1,3,2,6,397,14789,23,14392,596
7,5,2,4,14,23245,28530,87,0,584
52,14,38,9,12,36717,77681,210,4994,522
5,3,2,1,12,7323,5493,25,5493,647
23,11,12,9,14,208678,68165,262,7940,429
9,6,3,0,8,14888,0,7,0,593
9,4,5,4,5,15026,9564,61,206,472
23,4,19,7,84,40996,65540,0,0,518
5,3,2,0,8,34768,0,11,660,591
10,7,3,1,10,29831,720,4,8921,587
6,3,3,4,13,161653,189991,75,95215,447
5,3,2,1,5,43050,28295,31,28295,522
7,4,3,2,14,204849,1798,12,2168,645
18,11,7,2,10,407211,3659,0,0,520
33,12,21,4,41,1048612,87592,0,3800,591
24,7,17,4,11,19596,16270,0,0,489
5,1,4,5,16,282222,699271,62,282222,500
16,8,8,2,9,80067,23811,102,2174,484
8,3,5,2,13,26840,13426,25,10542,532
15,7,8,7,17,183535,78904,3,2478,482
7,3,4,2,7,157721,37520,42,16322,589
6,2,4,0,9,0,0,11,0,686
84,12,72,0,13,247370,0,4,2176,608
2,0,2,0,6,0,0,2,315,606
6,3,3,0,5,37144,0,0,0,644
12,4,8,4,10,38635,75212,110,105,570
44,7,37,0,11,0,0,176,301344,454
22,5,17,1,19,48615,46938,5,3775,678
27,5,22,3,8,270421,1686,243,1547,558
34,22,12,3,21,2161016,68178,58,0,507
10,4,6,1,16,38161,1096,174,1500,490
12,8,4,0,8,231745,0,12,168,678
12,7,5,3,7,222617,12432,48,10169,405
29,7,22,3,15,23540,18336,94,5916,509
15,2,13,2,10,23087,23087,65,7910,519
43,8,35,8,10,39139,17038,156,6276,410
37,14,23,6,8,26540,11474,89,1855,516
8,4,4,4,12,18543,494,12,222,553
33,4,29,0,6,20271,0,17,7829,565
26,16,10,18,9,95043,130300,55,8562,383
11,6,5,1,9,63788,15364,27,0,563
23,8,15,4,9,513936,43803,27,29809,536
5,2,3,3,12,3375,14196,0,0,501
10,6,4,6,18,67309,57016,34,6462,370
4,2,2,2,5,291182,20218,44,5909,549
6,2,4,2,12,139700,73920,27,71214,579
6,4,2,4,3,60622,60622,18,4980,438
20,9,11,6,11,46287,16529,50,9172,425
15,12,3,11,17,83741,72654,187,9998,446
24,10,14,2,20,39511,15853,121,5134,538
4,2,2,2,5,21263,6574,32,884,523
91,7,84,5,15,497069,197740,281,160238,432
45,22,23,8,16,1194849,53913,109,5665,446
12,4,8,0,9,368950,0,0,0,685
5,1,4,2,8,30874,30874,40,669,512
92,17,75,0,14,1018568,0,2,5910,415
11,4,7,5,13,517617,132178,94,14960,498
8,3,5,3,9,30921,30921,57,23640,561
6,3,3,0,20,4874,0,6,0,628
16,4,12,1,10,50672,2380,82,50396,536
22,5,17,3,10,44658,17020,34,8533,517
10,4,6,1,12,377896,781,24,17472,488
8,3,5,5,8,41619,43597,44,19743,454
23,3,20,0,16,9723,0,0,566,730
18,9,9,0,11,480294,0,25,15061,560
80,9,71,7,10,32915,40851,148,18323,421
17,2,15,0,9,35684,0,48,6162,640
5,2,3,1,5,4331,3700,7,3700,660
17,10,7,9,10,910065,885633,196,390931,442
34,1,33,3,10,20667,44657,63,20667,417
10,2,8,0,15,12505,0,5,1810,453
17,6,11,7,31,420184,47723,102,16405,489
34,6,28,5,19,105274,57116,55,16884,484
17,10,7,10,18,251246,373863,183,141705,408
15,7,8,12,13,1227804,2328619,220,769581,453
12,5,7,0,4,4918,0,2,799,566
6,4,2,2,7,58000,16100,41,15623,543
8,2,6,2,2,5459,5459,8,3203,528
6,4,2,3,4,235877,14666,18,9637,474
48,7,41,4,11,49226,5644,67,4404,548
9,5,4,2,16,191287,1607,9,2067,532
4,0,4,1,7,0,11052,14,11052,508
23,10,13,9,17,230821,186288,8,49468,459
25,22,3,12,8,633065,137136,71,4090,440
19,7,12,0,12,34991,0,7,3149,557
24,3,21,2,13,132218,98608,35,38896,480
12,8,4,0,12,227468,0,0,3663,637
13,3,10,1,9,979686,121247,44,0,492
25,5,20,1,10,13729,2062,66,2062,527
43,5,38,0,5,26325,0,1,6840,492
46,6,40,2,20,306472,1150,333,8230,390
10,5,5,3,11,16351,39902,71,7802,422
8,5,3,1,11,12045,8401,5,8401,477
3,1,2,1,15,35847,10750,5,369,486
11,8,3,8,6,153683,71628,454,8580,442
21,7,14,4,8,542025,77764,69,5685,461
23,7,16,4,22,371026,273683,60,2459,441
25,9,16,8,18,681243,480433,209,1095,453
11,8,3,6,25,225815,267559,110,64069,468
84,4,80,0,17,9974,0,41,2370,676
53,6,47,3,15,50547,10278,156,6936,490
11,4,7,3,10,139136,83636,76,1283,495
22,4,18,0,10,9527,0,24,659,590
19,10,9,6,26,138274,60036,234,32904,507
5,2,3,0,11,53011,0,0,0,531
17,7,10,3,15,798248,33290,0,0,492
17,5,12,7,11,101380,135797,128,530,473
15,9,6,5,8,70123,4302,31,315,486
5,2,3,2,8,11322,3338,24,2192,514
10,2,8,3,16,12459,10607,61,731,514
31,12,19,9,15,247995,104136,72,29203,443
9,4,5,2,8,287916,18559,164,17272,592
14,11,3,0,10,1908526,0,36,12240,475
8,6,2,0,8,11144,0,2,0,634
16,10,6,0,5,165108,0,0,0,609
15,8,7,5,7,41088,10172,30,3849,450
35,24,11,14,14,586170,245140,150,30001,391
23,8,15,10,17,130976,106941,1,9383,477
10,7,3,8,7,38380,46053,341,15346,513
15,11,4,8,10,24994,14297,56,8930,425
30,14,16,7,15,497076,75262,231,24039,418
17,8,9,8,29,27409,36313,47,12005,458
13,6,7,3,7,92686,7193,31,1046,514
5,3,2,1,7,29645,23802,34,23802,622
31,14,17,0,18,36313,0,1,3296,619
69,11,58,5,13,131106,34728,103,12744,604
6,3,3,2,5,90605,90605,9,0,468
28,7,21,6,18,852952,72942,118,74100,471
16,4,12,0,8,61812,0,4,449,676
29,9,20,1,21,723506,1320,15,0,689
9,3,6,2,12,7000,9257,44,7000,609
19,3,16,2,13,267867,6032,29,4243,522
13,5,8,6,9,171801,137142,47,53530,454
14,10,4,0,8,370236,0,6,0,608
7,4,3,5,11,181230,59333,117,18995,602
33,7,26,1,12,30556,2145,4,2145,654
25,8,17,2,12,168562,17200,20,11500,530
44,11,33,3,10,342136,4403,3,1000,481
21,8,13,5,13,48705,28894,174,11339,435
7,1,6,1,14,11924,11924,108,11924,515
12,2,10,0,6,0,0,0,0,761
16,4,12,3,12,9550,8293,71,7927,494
22,5,17,5,15,75901,86380,20,22547,510
20,15,5,3,6,225511,6616,64,3068,510
9,5,4,3,8,26894,8985,145,8685,586
11,9,2,10,10,391473,493410,56,162404,408
12,3,9,2,4,58841,11771,13,8311,479
11,4,7,2,6,6445,5056,198,3162,460
40,9,31,5,12,2662761,2068277,96,16701,466
19,9,10,7,11,212114,192164,224,54875,479
16,11,5,6,17,355269,28717,71,12422,488
12,10,2,3,7,274379,42035,39,20300,494
7,4,3,0,9,449258,0,15,0,589
21,9,12,4,23,52361,42470,97,5975,506
29,12,17,0,27,2362315,0,11,0,661
14,4,10,2,19,341768,2936,3,4853,495
10,4,6,2,69,634662,167572,33,150359,484
6,4,2,4,13,76625,65923,66,10644,475
28,9,19,7,8,525740,80119,139,0,490
3,1,2,0,14,970,0,0,2395,636
152,2,150,1,7,21168,18749,11,18749,634
13,3,10,4,7,6517,6517,97,2345,479
11,5,6,5,8,40218,28042,47,53396,439
9,6,3,4,13,34087,24988,13,16317,451
14,5,9,5,9,355523,174129,94,10743,514
12,9,3,10,10,703244,709864,215,48270,430
16,7,9,2,12,51639,5963,65,6974,505
5,3,2,4,11,15695,27988,74,12162,466
30,17,13,9,7,594098,92829,172,11523,437
7,4,3,3,10,445544,55146,42,18352,439
7,3,4,4,12,10941,33656,69,0,545
20,11,9,1,16,351406,12180,17,12180,439
12,6,6,4,10,45399,41906,135,31998,496
11,8,3,6,9,74715,23245,98,13917,474
15,5,10,2,16,23146,21430,29,12290,511
15,8,7,0,13,109493,0,0,1774,728
7,5,2,1,6,35181,454,29,4160,479
7,2,5,0,19,15194,0,1,0,623
40,25,15,8,16,898549,212508,187,67968,447
15,10,5,0,12,276436,0,0,0,630
13,6,7,7,7,164939,164939,129,7360,464
22,4,18,3,14,98123,94168,56,13282,497
4,2,2,3,9,1006561,992798,41,934033,630
15,4,11,0,7,43645,0,0,0,605
9,5,4,3,13,420679,51387,23,47450,628
14,2,12,1,7,79036,1337,26,13613,641
13,7,6,4,12,103229,46182,106,9172,408
9,5,4,2,8,251804,2632,52,1886,531
11,4,7,1,24,8203,5585,0,0,530
34,5,29,7,14,70381,108257,149,1292,461
6,3,3,1,4,18246,461,28,0,495
13,2,11,2,6,5625,5625,12,4550,549
16,10,6,1,16,269672,79,28,0,514
28,15,13,13,8,1121651,932379,191,0,487
4,2,2,3,7,11969,16673,108,17670,444
6,2,4,0,7,21140,0,145,3210,641
5,3,2,1,4,28917,8052,12,0,671
11,5,6,3,8,45832,6206,0,0,544
21,4,17,0,16,115607,0,6,404,732
4,0,4,1,4,0,5357,0,0,517
11,5,6,1,13,67632,31597,3,31597,558
13,5,8,4,6,21718,9962,33,3099,437
11,8,3,1,6,74164,18320,37,18320,466
5,2,3,1,7,15070,15070,32,0,544
19,10,9,5,10,146181,76793,53,48700,463
11,0,11,0,16,0,0,1,2529,542
5,3,2,1,3,431516,145,10,1620,637
14,9,5,7,11,46879,25263,20,9492,417
42,5,37,6,13,33087,33388,170,7486,435
44,14,30,21,11,414072,215769,327,26270,400
15,4,11,3,8,36985,36985,57,28199,485
23,7,16,9,15,234220,336307,10,199163,453
20,9,11,3,4,26168,3344,101,2298,499
24,7,17,8,14,163832,154911,138,2635622,481
17,10,7,4,8,181099,33081,57,7014,487
27,9,18,2,17,892264,3912,78,0,515
22,12,10,9,15,155230,137982,101,11072,513
6,4,2,4,6,13575,13575,75,8310,477
22,4,18,1,8,56910,666,0,0,557
18,5,13,2,7,119561,4598,7,1160,521
10,5,5,2,4,416108,44453,35,712,433
19,7,12,4,4,68405,27213,116,16994,471
15,7,8,5,13,28918,14695,47,4690,555
10,3,7,1,6,220499,6916,17,0,464
22,6,16,8,25,78108,73827,98,4766,552
14,4,10,0,11,372584,0,2,1995,650
31,17,14,11,15,172713,135294,146,10422,380
9,4,5,1,8,7488,3395,5,3395,650
25,7,18,2,8,52275,5854,43,0,501
10,3,7,4,7,28431,28431,157,6026,481
25,10,15,6,7,253339,63690,105,32814,426
6,2,4,1,9,12639,6872,18,6872,637
13,9,4,3,32,227868,3948,53,1250,475
17,6,11,7,12,33841,43147,128,15399,502
18,11,7,4,24,304929,56229,74,26353,461
6,4,2,0,3,46429,0,0,0,641
8,2,6,1,9,21935,19289,0,0,507
39,7,32,2,11,35003,16275,12,2094,478
13,7,6,7,15,1536243,1761883,24,583140,519
65,11,54,5,13,458957,61924,176,83399,450
7,2,5,2,10,139302,47327,25,0,473
29,8,21,3,15,159231,29210,53,11803,468
7,4,3,1,8,1871,1480,23,1023,572
8,4,4,2,14,61756,68925,40,61326,569
13,5,8,7,8,2985471,4713413,161,1626176,509
6,2,4,1,11,258981,23004,14,14,691
14,5,9,0,7,36945,0,25,2852,624
25,18,7,16,16,670725,234629,369,9819,375
12,7,5,5,4,673468,18821,14,0,551
85,2,83,1,8,39318,1940,31,1940,540
5,3,2,0,3,193677,0,3,0,594
9,1,8,3,11,26935,22115,0,0,629
5,2,3,3,7,326799,28837,26,9695,430
31,11,20,3,9,772098,737274,64,7813,484
12,7,5,5,11,468128,32480,42,15675,478
32,7,25,5,13,36480,32066,239,16726,445
7,5,2,3,12,23382,20557,99,12070,554
7,1,6,1,13,2484,2484,15,4600,553
33,13,20,3,21,586197,119135,54,8969,524
12,7,5,8,9,504210,526820,146,46865,495
9,2,7,1,16,7546,560,28,6796,495
7,3,4,1,11,165385,2492,13,0,555
21,12,9,1,11,1023861,15169,15,15169,604
7,5,2,0,7,93189,0,0,0,622
23,8,15,5,23,638024,39101,31,7340,456
12,2,10,0,9,127084,0,0,0,575
7,2,5,4,15,519106,72195,44,13489,495
65,14,51,4,19,619788,100338,14,2578,450
8,5,3,2,8,21585,5730,23,5146,471
5,2,3,1,12,54132,4767,25,0,644
5,3,2,1,25,105980,8256,17,8256,580
30,10,20,1,13,72231,1620,41,3402,600
6,2,4,2,13,190975,8525,46,0,586
11,3,8,0,19,30746,0,17,3068,586
18,9,9,1,30,127066,292,95,4321,620
8,5,3,2,13,14194,6815,38,6331,462
64,20,44,2,12,55570,2987,26,2369,561
18,5,13,4,16,32359,32359,149,25209,485
11,5,6,0,17,8553,0,0,584,618
23,14,9,1,11,1207467,1932,15,2898,487
7,4,3,0,19,74560,0,22,0,680
15,2,13,0,10,1702,0,249,297,644
57,9,48,4,17,158251,62357,73,43590,448
12,5,7,8,8,111392,220650,7,87562,439
7,4,3,0,12,28227,0,0,0,617
8,4,4,4,8,1364370,804562,76,476751,489
63,6,57,7,7,47316,52305,112,18587,424
7,3,4,2,15,49291,113690,7,1,603
38,4,34,2,14,18383,2899,235,16025,420
8,5,3,2,11,518275,8168,58,107766,538
6,3,3,1,6,982,982,215,1277,525
15,0,15,2,14,441,6071,22,1320,546
9,7,2,4,8,137311,36018,0,0,453
11,9,2,10,5,44909,52960,135,17170,506
58,10,48,12,13,260737,93522,462,48116,423
13,8,5,5,9,121385,146639,86,59100,392
18,9,9,3,19,342380,4890,52,4500,492
4,2,2,3,14,25297,51247,52,0,535
14,10,4,9,8,56609,35991,189,5636,454
34,8,26,0,11,41163,0,0,0,574
21,3,18,0,17,420311,0,34,4282,624
15,13,2,5,3,422188,2639,12,66076,374
31,10,21,1,19,944959,28824,19,9012,501
122,8,114,7,8,59571,57556,141,17712,461
11,7,4,6,7,64652,63114,150,1620,498
32,5,27,0,11,1262045,0,25,0,675
16,6,10,1,14,27762,13920,1,13920,408
17,4,13,3,4,17422,30812,26,12356,416
4,0,4,1,2,0,5920,7,5920,477
11,5,6,1,7,14337,6268,28,2509,508
13,6,7,2,13,290197,11959,7,7790,474
47,20,27,12,10,359284,167285,157,20451,437
11,3,8,4,26,493413,47792,50,0,498
9,5,4,5,16,317334,322411,43,7271,481
13,7,6,8,9,37118,26942,117,8738,458
137,13,124,10,9,57150,18775,118,3940,429
4,2,2,1,13,1200,1200,46,1200,687
12,8,4,7,18,143530,77670,56,31704,465
11,9,2,5,10,796639,36583,113,29840,460
19,4,15,2,14,5527,23707,52,337,519
15,2,13,1,5,2579,8294,15,1374,554
31,4,27,0,17,67028,0,17,0,555
19,4,15,3,14,20123,3824,22,17284,499
27,5,22,1,9,135401,957,60,3542,558
17,4,13,3,13,20593,18153,89,625,514
13,5,8,3,8,47869,12546,104,11593,432
3,0,3,0,15,0,0,2,8472,615
11,5,6,1,12,493494,2169,30,0,583
6,4,2,1,26,16505,1590,6,0,508
10,5,5,1,8,86420,1885,28,1000,631
8,4,4,4,8,346641,81565,160,26126,559
24,7,17,5,12,56832,32614,40,9165,460
19,6,13,6,14,44617,44135,107,18136,437
30,11,19,0,24,377915,0,1,955,585
14,6,8,5,7,34373,19246,99,3682,428
9,6,3,6,6,299568,56742,15,39583,432
19,5,14,3,18,322481,36009,22,2780,476
6,3,3,3,7,19698,19698,116,17831,482
27,12,15,13,9,147491,210620,214,33335,411
11,8,3,2,9,338013,6937,3,3706,396
9,6,3,6,7,13431,12373,169,9505,454
14,9,5,2,19,723040,86710,37,68879,538
8,2,6,1,14,121478,121018,35,121018,433
23,8,15,7,12,321912,42068,294,4131,461
15,11,4,10,7,59822,48283,118,11250,477
9,4,5,3,14,4898,2797,18,2637,488
33,17,16,12,19,588941,172758,185,37934,424
14,7,7,1,9,750630,4525,5,4525,605
32,6,26,3,11,58028,31138,129,5606,565
36,7,29,4,21,25462,10071,265,2129,522
7,4,3,4,9,151092,24482,25,2124,427
7,1,6,0,18,0,0,0,504,665
25,12,13,0,12,648770,0,10,0,572
28,5,23,2,13,46612,7719,38,2288,505
11,7,4,1,9,1467676,70495,2,70495,512
35,8,27,7,13,51940,58002,321,18173,469
4,2,2,2,4,18400,18400,29,0,517
14,7,7,1,16,212991,2270,22,1173,465
25,13,12,10,11,445910,226492,252,78109,596
11,7,4,8,8,84102,79102,113,0,466
10,7,3,7,18,333762,49483,50,23993,433
35,8,27,3,69,293427,11743,42,0,550
9,7,2,0,14,2020043,0,1,605,617
8,4,4,5,10,60777,99677,67,948,521
18,11,7,3,11,17794,1124,35,1620,482
33,6,27,6,19,244686,122995,40,8478,515
7,4,3,3,14,13951,5120,46,3278,483
11,5,6,0,19,42621,0,1,1488,545
10,8,2,0,13,41940,0,24,0,533
15,8,7,1,9,492441,1956,38,1956,486
25,18,7,0,13,685113,0,8,1210,592
6,3,3,1,6,28953,277,7,0,584
20,10,10,8,18,390021,132379,140,28483,448
16,3,13,2,13,9023,9195,17,8963,485
22,8,14,7,16,234786,30044,277,13992,454
11,4,7,0,17,211924,0,4,860,599
45,10,35,3,11,72070,16000,26,4368,442
25,19,6,3,23,594458,36378,31,19373,489
12,5,7,1,18,149371,32980,99,45365,513
9,4,5,3,10,37048,20161,15,0,536
10,7,3,5,10,29854,28947,117,20326,440
31,7,24,3,7,280387,10978,53,2582,486
12,8,4,3,11,314543,12581,79,6561,435
12,0,12,0,8,0,0,1,0,649
16,6,10,2,8,424605,31080,69,779,442
2,0,2,0,11,0,0,0,0,618
12,10,2,3,11,45364,702,3,3864,551
30,10,20,2,15,316157,1880,19,3828,527
17,11,6,13,14,779785,575769,264,86761,459
5,2,3,0,5,1570,0,16,0,544
12,7,5,2,5,49626,17313,56,17198,441
12,6,6,3,16,10085,1069,34,16404,533
8,1,7,0,11,79776,0,46,13816,505
12,8,4,1,23,85293,966,25,2898,559
12,10,2,1,17,835977,1685,3,2801,526
11,9,2,0,17,275085,0,2,0,674
6,4,2,0,5,119755,0,0,0,617
43,11,32,11,8,101485,116921,225,26581,423
6,4,2,2,13,37487,30741,42,0,525
15,6,9,5,11,43640,34093,144,14928,476
7,1,6,0,4,0,0,0,0,662
55,11,44,11,8,47154,42489,338,8440,411
6,3,3,0,9,125660,0,22,0,568
8,6,2,4,14,17890,15826,76,7205,572
7,1,6,1,9,5196,5196,107,5196,489
5,1,4,0,14,401988,0,0,0,630
31,6,25,5,19,244165,66171,71,2245,510
36,9,27,6,17,61078,51946,63,19031,465
15,5,10,2,11,401217,6570,114,6710,507
17,7,10,0,3,75137,0,0,0,653
19,10,9,3,13,888454,123217,52,4547,412
19,8,11,7,7,41510,49091,356,14617,413
10,4,6,3,13,62777,40891,16,11860,474
13,6,7,2,19,686189,60233,103,4382,498
15,4,11,0,13,50857,0,35,3885,442
25,11,14,0,22,563237,0,0,255,603
4,1,3,0,26,0,0,0,0,671
40,13,27,5,14,384071,30190,14,11324,441
18,8,10,5,15,522842,25105,61,9203,469
19,5,14,6,30,61808,51086,74,35973,407
20,9,11,1,2,53026,5209,4,5209,479
28,6,22,2,19,341244,55022,34,52010,497
22,11,11,1,9,477979,572,2,1215,620
5,3,2,1,6,666814,2388,3,0,650
6,3,3,4,11,46127,52546,11,30852,515
20,7,13,1,9,32420,4337,10,4337,510
49,14,35,1,7,312483,1047,62,294,489
6,1,5,1,10,18114,3757,13,0,648
11,5,6,2,12,948290,15319,26,8436,400
13,8,5,2,22,175166,38488,0,0,603
8,4,4,3,19,9708,8654,72,147448,457
33,17,16,0,14,449277,0,21,1185,603
10,5,5,3,9,566561,5522,84,7041,419
12,8,4,4,18,28881,25825,67,7980,446
7,4,3,3,6,36088,19392,34,11664,521
29,11,18,0,8,168802,0,2,0,662
20,6,14,6,10,45062,59975,362,18060,405
11,5,6,5,13,33392,52579,131,0,460
24,2,22,0,12,22558,0,0,0,649
24,9,15,8,7,38915,35610,48,7676,425
41,13,28,7,14,287711,165631,132,47309,464
13,3,10,4,8,63392,63390,24,7475,544
19,8,11,2,10,149511,4145,19,2406,513
7,2,5,1,9,10120,7920,29,7920,612
17,11,6,0,14,585003,0,1,0,646
18,8,10,1,14,1078956,74093,18,0,646
8,3,5,6,11,99537,198900,130,81948,529
16,11,5,1,7,522477,360,1,0,551
11,9,2,3,5,53649,5624,47,3813,396
5,0,5,0,7,0,0,120,1139,566
11,5,6,1,18,3268,231,1,231,537
9,5,4,3,9,219904,19879,52,12907,454
18,11,7,16,8,684965,272199,324,27797,413
5,1,4,1,6,9200,9200,46,11000,448
13,5,8,1,16,160818,129677,0,0,666
10,5,5,1,3,72689,1324,1,0,603
17,5,12,5,16,233079,56368,71,15427,501
4,1,3,1,8,1592,1592,0,2325,493
11,5,6,3,8,302865,10974,78,0,519
67,9,58,0,8,152706,0,8,0,608
10,3,7,4,13,35319,35319,83,13341,477
11,5,6,4,14,70712,116907,83,26488,501
13,11,2,8,21,227653,35600,120,7240,441
15,10,5,5,10,54523,34029,43,16671,449
10,3,7,3,9,10460,10460,287,9106,466
14,7,7,6,13,288407,28942,0,0,474
16,6,10,0,13,259139,0,0,1800,622
21,4,17,3,12,316275,33978,133,19931,459
7,5,2,3,16,176304,77940,70,0,557
17,9,8,4,12,430533,13036,5,4051,367
5,2,3,1,8,4250,4250,47,4250,596
17,15,2,3,7,396752,7687,0,0,501
15,1,14,4,14,4092,20589,31,4092,593
19,3,16,1,11,409459,11732,118,17585,577
7,4,3,0,7,409610,0,0,0,652
5,2,3,3,3,2431,1044,36,103,508
11,5,6,3,13,29555,23501,34,0,482
30,9,21,8,15,245225,188954,105,7261,367
22,9,13,0,21,345099,0,28,0,574
13,9,4,4,7,45440,31578,92,1824,478
9,6,3,3,17,471831,82512,60,44513,471
19,6,13,5,14,309606,255071,72,171740,504
3,1,2,0,11,6439,0,0,313,747
16,7,9,5,15,621273,271991,0,1468,545
19,11,8,6,14,865227,298371,88,175013,419
8,5,3,0,7,28361,0,6,1157,620
17,7,10,2,15,190208,54765,33,0,623
12,6,6,3,14,747329,8949,51,1521,524
7,5,2,3,8,10120,4340,33,3974,499
24,6,18,6,14,49817,51461,101,19939,424
49,7,42,2,14,918544,29854,370,3882,533
10,6,4,0,6,202014,0,14,0,618
12,7,5,7,12,439019,53031,0,0,478
24,8,16,5,9,81287,75318,55,13844,429
12,9,3,0,4,26785,0,4,0,519
12,5,7,6,13,48303,48303,79,31811,425
13,3,10,0,21,33928,0,1,600,733
21,6,15,4,20,48406,48406,238,38109,477
4,0,4,2,7,73576,35100,13,0,540
18,10,8,5,15,44087,27583,6,2069,494
36,9,27,0,9,51837,0,72,1173,646
17,3,14,2,7,39567,219,6,199,586
12,3,9,4,8,230220,128814,69,18860,495
67,11,56,7,30,384060,71058,116,30212,471
12,5,7,1,7,20053,391,2,391,542
34,6,28,4,11,259172,250384,60,2130,493
48,7,41,4,13,50745,16889,87,7000,525
16,11,5,6,8,245835,19038,56,11726,429
7,5,2,3,5,19411,701,53,393,518
17,8,9,11,8,1019842,978818,46,230453,423
11,7,4,0,5,391701,0,30,322,582
11,7,4,0,11,304457,0,19,0,649
14,6,8,2,9,80244,50049,78,0,561
57,7,50,9,16,109555,106810,188,32328,447
36,10,26,2,20,273899,12103,48,1943,495
28,18,10,2,26,161812,1630,11,930,403
5,2,3,1,10,2854,2131,22,81,670
7,1,6,2,14,18927,14493,79,2400,553
10,5,5,6,8,28662,29718,62,13256,526
8,3,5,3,12,10312,168925,52,10312,571
11,5,6,3,7,18128,10616,102,8814,535
19,9,10,3,10,1376505,49760,197,31181,402
16,8,8,7,9,60364,78835,178,41668,413
15,5,10,4,9,326590,54372,73,0,447
7,3,4,5,7,86148,100686,90,33415,519
8,5,3,0,10,113505,0,2,0,539
9,4,5,4,17,135319,52774,72,0,504
17,8,9,5,7,24494,6723,143,563,451
7,1,6,1,9,20337,7177,18,10950,616
13,8,5,4,8,14644,64210,77,2265,499
7,3,4,4,9,51217,75055,75,5541,598
10,5,5,4,19,56578,44774,0,0,494
11,7,4,2,4,47929,3069,83,2370,542
29,7,22,3,14,377031,17355,0,4322,538
11,7,4,5,13,114566,36770,67,22075,423
7,1,6,0,9,0,0,28,4650,557
12,7,5,5,14,237019,15180,32,6804,390
13,6,7,2,9,305591,12088,186,11487,636
41,6,35,11,18,372359,368305,161,11015,428
11,8,3,7,17,94058,87666,141,12373,512
17,6,11,0,11,225935,0,115,21574,484
18,9,9,4,16,82280,28309,26,3453,469
11,7,4,2,10,15302,4023,40,0,555
17,6,11,4,16,359174,19509,34,10531,411
31,8,23,9,8,39320,34796,285,19338,427
25,3,22,3,18,53577,17721,28,5928,608
9,7,2,2,7,56257,196,135,3953,467
42,23,19,4,10,258330,8264,10,2661,478
14,5,9,1,10,308623,19306,3,0,624
7,4,3,1,12,7211,5981,21,5981,509
9,3,6,1,14,40648,26778,24,0,601
9,3,6,0,8,163722,0,1,0,733
16,5,11,2,15,238981,189567,65,549,523
24,6,18,3,8,50210,15036,185,345,451
11,4,7,2,14,19676,12475,17,9497,500
65,10,55,0,13,882136,0,2,388,622
5,1,4,1,12,450,450,20,450,542
6,4,2,2,9,332171,3663,1,476,481
13,5,8,1,7,6901,247,3,247,546
9,3,6,2,15,216537,27736,27,19070,501
4,2,2,2,9,39609,39609,68,5402,519
13,7,6,5,9,117831,59555,113,434,490
11,5,6,3,10,380387,218514,30,4726,507
18,10,8,1,5,166279,361,30,2321,444
16,6,10,5,15,35105,35105,102,11718,468
10,4,6,0,8,119221,0,0,287,592
11,7,4,7,24,1287016,43806,58,13792,513
6,3,3,1,6,9178,1945,21,1945,660
12,6,6,6,9,42301,39094,27,30085,505
29,9,20,0,13,98416,0,6,393,511
18,8,10,6,10,103521,31291,117,31589,433
22,11,11,0,9,178097,0,8,0,653
5,3,2,1,4,46968,6194,4,0,519
21,11,10,7,69,40510,245336,117,12500,376
25,8,17,5,14,969047,106879,97,5754,411
24,9,15,3,24,93116,15680,95,0,549
13,7,6,2,12,355624,133523,67,131683,521
3,1,2,0,2,5094,0,2,0,561
144,9,135,5,9,142243,96625,253,46716,529
24,10,14,9,8,41277,14719,202,5383,458
10,5,5,3,7,384932,39428,33,0,599
24,6,18,4,12,76931,63786,81,3937,436
34,9,25,0,16,201546,0,2,0,677
12,6,6,5,12,45969,21096,68,6396,462
7,2,5,1,8,4285,4285,117,4285,536
18,9,9,2,9,79840,18259,51,4378,568
21,13,8,10,19,1096793,1230176,172,592262,504
11,1,10,1,5,7104,1000,27,0,641
11,1,10,0,12,0,0,0,715,750
4,2,2,2,7,7341,7341,47,5372,449
14,8,6,3,14,200983,3687,14,725,555
4,2,2,0,8,0,0,0,1117,648
11,4,7,5,9,368187,40181,62,3388,427
23,15,8,12,38,107668,35613,213,10813,476
7,5,2,7,4,24977,32440,20,9341,448
26,9,17,5,12,78423,73990,39,8675,423
44,28,16,0,37,3150822,0,7,0,523
54,14,40,10,14,1188485,37827,209,5210,405
17,9,8,5,26,482804,294034,68,0,550
79,11,68,7,16,128366,92928,258,53720,413
9,4,5,1,9,10832,13702,1,2768,634
14,7,7,1,5,30815,396,212,796,548
13,2,11,1,17,6669,2631,1,2163,513
16,0,16,0,7,0,0,27,1292,664
18,6,12,1,12,536719,1,33,195,451
20,8,12,4,25,761913,36385,58,27516,504
4,1,3,0,3,1029,0,0,0,701
6,4,2,3,6,12311,11306,107,8822,476
45,7,38,2,15,62804,2612,28,2898,510
12,3,9,1,18,53424,29320,21,29320,599
11,6,5,4,10,155208,39243,0,0,473
16,14,2,0,7,541771,0,31,420,567
8,6,2,0,3,10758,0,0,0,580
10,8,2,2,10,107183,27169,13,25266,386
27,3,24,3,9,17124,11107,227,17938,529
13,8,5,5,9,119059,121243,14,46653,447
25,4,21,2,15,129053,39799,42,25485,495
4,2,2,2,7,2283,9675,16,2248,624
13,4,9,4,20,17305,19370,37,12062,542
12,5,7,0,7,1540,0,46,995,547
23,4,19,1,8,143199,3645,7,437,640
15,10,5,2,8,937021,8383,5,5770,444
4,1,3,0,4,0,0,0,0,631
18,8,10,1,15,166347,24902,11,1464,460
41,9,32,7,13,125966,46969,103,11952,486
7,3,4,2,20,27306,27306,28,23906,575
14,5,9,2,6,8652,4907,40,3959,537
6,1,5,1,7,0,10986,55,20383,552
92,24,68,14,13,716616,204365,186,21017,414
17,6,11,2,4,36037,1617,22,1477,466
9,4,5,3,9,200709,13361,27,6403,436
17,7,10,6,9,51745,45942,88,42375,474
33,15,18,0,22,3277790,0,1,0,661
5,3,2,0,8,4160,0,17,0,599
40,9,31,7,16,143136,104099,163,22080,427
4,2,2,2,12,9215,9215,37,7707,649
8,5,3,5,9,31551,50798,62,0,446
15,3,12,0,10,61819,0,13,647,613
43,17,26,3,46,1103068,9813,126,7081,380
10,4,6,1,13,10273,9013,34,9013,463
9,6,3,7,4,73377,57799,0,0,425
13,6,7,5,8,18052,12166,121,2933,451
22,12,10,7,8,272247,30884,157,8772,474
4,1,3,1,12,13588,13588,36,13588,646
7,2,5,0,10,447,0,1,760,669
46,16,30,15,14,118764,108377,618,11469,405
21,7,14,4,11,348799,21955,225,13112,474
11,8,3,3,8,221016,22422,31,5299,453
13,6,7,1,16,171037,966,8,2898,472
15,9,6,10,10,78569,86942,405,19244,498
40,9,31,1,69,86803,15090,33,1839,548
17,9,8,2,17,184248,109052,56,108577,510
15,11,4,10,16,105119,69481,122,18925,438
14,6,8,7,14,92735,64561,95,15784,455
14,9,5,3,13,18047,2654,3,2561,482
10,7,3,7,9,43026,40314,273,8273,431
29,13,16,11,19,566769,63012,222,7163,480
4,2,2,1,3,6941,1756,0,0,507
35,14,21,12,20,601261,50147,78,3450,514
38,13,25,11,16,2042863,161840,79,8725,381
6,3,3,1,9,1899,1899,25,0,585
20,3,17,2,13,30500,30500,69,22741,505
15,13,2,0,11,47738,0,0,631,613
13,7,6,8,16,75993,37879,111,5831,455
25,3,22,4,10,61364,40579,31,148,542
9,4,5,2,8,37090,29641,46,0,524
11,4,7,5,44,76453,151457,80,0,528
3,1,2,0,5,4492,0,5,21,598
12,3,9,1,8,9719,17064,38,17064,512
21,11,10,11,16,863952,909180,201,0,453
12,5,7,5,8,527083,19447,97,8551,409
6,4,2,3,8,1828680,332126,61,274488,469
12,6,6,4,11,35526,34856,124,8963,558
7,4,3,0,11,281436,0,0,0,489
17,7,10,2,8,21168,2640,57,1731,462
10,5,5,3,5,36681,18413,68,327,453
17,4,13,2,11,87711,78030,85,6337,451
20,9,11,6,13,260638,53601,96,23344,418
7,5,2,4,6,211204,16424,43,0,467
10,6,4,7,9,55799,64098,168,35110,431
13,3,10,1,8,29228,2170,67,2170,610
19,11,8,7,7,20784,10568,188,4740,445
13,9,4,1,8,259310,248,2,0,648
18,6,12,4,14,43205,34305,95,12449,529
36,4,32,4,13,40018,39224,43,20291,519
11,7,4,2,10,17862,14908,23,7454,498
8,6,2,5,8,303515,31882,17,1047,452
20,5,15,3,11,25331,16566,53,19845,527
4,2,2,0,3,29649,0,3,0,579
6,3,3,1,12,13671,5572,23,8260,531
3,1,2,1,5,8736,8736,26,0,482
11,7,4,1,13,435309,461,9,0,640
11,7,4,0,15,212689,0,3,0,641
33,12,21,0,20,434086,0,36,1064,542
14,6,8,0,24,825110,0,24,0,434
11,3,8,4,10,41505,48135,35,24679,501
52,12,40,14,11,714000,104518,47,37611,407
12,3,9,1,14,8338,8338,13,9097,542
7,5,2,5,11,61191,59013,82,37995,486
23,7,16,3,9,125824,55996,132,12709,454
15,11,4,2,12,660106,11322,9,0,499
3,1,2,0,5,0,0,5,1728,672
12,7,5,1,8,224285,8672,19,0,474
13,7,6,0,6,191712,0,18,547,634
13,5,8,1,22,71306,9890,80,21924,503
11,4,7,0,13,231455,0,2,0,634
30,2,28,1,19,680,9229,14,9229,579
15,7,8,2,12,21189,907,32,1966,463
16,5,11,5,14,23671,24108,81,14130,448
6,4,2,1,5,106495,3862,12,0,483
12,7,5,6,6,678223,29357,46,16797,390
9,5,4,1,3,281114,5663,28,0,441
17,4,13,1,14,42371,27596,36,3312,572
16,1,15,1,7,5203,5203,23,5203,532
29,18,11,3,16,2364359,10728,20,9690,491
29,10,19,0,12,5679509,0,55,0,481
16,8,8,4,9,29387,13332,80,4811,494
94,11,83,10,8,124346,123596,58,8901,437
12,4,8,0,8,16586,0,10,1221,668
9,3,6,0,5,23678,0,0,0,582
7,3,4,1,9,433324,4131,0,0,628
369,7,362,4,7,47398,27996,305,15368,475
7,2,5,0,9,256785,0,13,22050,414
9,4,5,1,20,54976,4253,0,0,499
13,4,9,4,9,70843,9909,32,927,609
10,5,5,4,7,12401,26879,61,17478,478
24,7,17,6,14,334912,40176,43,9644,442
12,10,2,2,15,300794,34566,25,34281,628
13,6,7,0,18,133572,0,0,0,642
32,11,21,0,6,142170,0,0,0,659
28,2,26,2,8,4378,3978,23,3600,502
36,9,27,5,14,53452,47590,118,10685,382
9,2,7,0,7,28315,0,1,0,601
4,1,3,2,8,8790,8790,0,0,502
28,12,16,1,19,1060332,171,108,195515,426
8,6,2,5,7,20811,19738,62,2053,516
25,5,20,5,9,126695,117211,57,67793,458
31,11,20,12,10,92360,92124,682,16640,431
16,9,7,1,14,603492,10500,5,0,494
5,3,2,0,7,15979,0,0,0,645
10,4,6,3,3,27789,15429,17,9248,511
19,7,12,0,8,33543,0,0,0,670
27,11,16,1,20,180166,3475,5,3475,492
19,6,13,4,16,362393,17447,77,8084,468
4,2,2,1,10,84880,283,7,283,649
14,4,10,3,19,29562,58857,60,776,502
13,2,11,1,9,2057,2057,14,2057,569
6,3,3,4,6,169968,176021,107,4370,505
34,12,22,9,9,1608761,657125,234,117436,458
57,19,38,5,14,167648,27685,166,2598,439
38,18,20,14,13,954892,892836,240,158863,414
4,1,3,0,7,0,0,2,0,634
14,6,8,6,10,13842,21646,55,14909,523
16,7,9,3,10,28365,11886,65,8450,542
22,2,20,2,13,198050,188211,13,368,686
40,24,16,1,21,1934529,1364,16,0,492
8,6,2,3,8,118821,69054,38,2119,473
32,17,15,0,20,1156271,0,45,10498,504
24,7,17,5,11,40472,24862,262,13570,475
14,7,7,7,6,146701,200144,120,39005,462
42,7,35,1,15,260868,3803,42,0,551
5,2,3,0,12,527742,0,1,2523,612
4,2,2,3,11,22916,21238,43,4922,509
46,8,38,9,14,44115,43782,123,10180,475
14,7,7,0,21,723756,0,1,0,632
29,18,11,17,19,508257,402859,0,0,495
10,6,4,7,9,91571,122238,190,53730,481
4,2,2,2,4,10109,10109,208,7668,514
12,6,6,0,3,515016,0,7,898,480
37,25,12,4,13,176474,20540,4,8964,424
10,4,6,2,10,46759,1834,83,53249,576
7,5,2,3,3,23173,5338,66,3469,442
15,3,12,1,18,164090,31125,0,2615,561
28,13,15,0,11,669981,0,5,33,668
5,3,2,0,7,1355,0,3,0,565
12,7,5,6,10,51064,51064,34,6185,425
16,4,12,1,16,244039,9294,30,0,534
40,12,28,11,14,343880,292771,201,31003,421
33,13,20,11,10,343287,142307,292,57796,454
7,5,2,0,14,342154,0,7,0,581
21,14,7,7,7,617853,222230,178,2985,406
35,6,29,2,15,414076,74577,24,4363,609
8,6,2,3,9,266532,11544,47,770,510
22,5,17,3,14,362347,74699,0,0,511
11,5,6,6,8,1046581,43826,103,3610,452
19,3,16,1,11,259342,2603,19,2603,505
8,6,2,7,16,412832,617773,158,206697,538
36,15,21,0,14,431627,0,33,3798,514
13,3,10,2,17,1010,17923,25,778,471
6,4,2,3,5,60811,59228,0,0,546
6,2,4,2,9,264974,33617,58,4987,644
23,9,14,1,16,88876,3547,2,700,522
9,6,3,0,8,32897,0,0,0,714
19,4,15,3,9,11750,21622,297,2091,491
15,5,10,2,12,428830,476,75,444,491
24,12,12,3,13,508002,393100,1,1206,496
31,12,19,12,15,1395262,1305987,173,408488,428
15,8,7,9,9,76006,66188,314,14815,424
9,3,6,3,9,39272,49972,68,19277,491
8,5,3,4,35,29843,29527,38,1314,520
12,6,6,1,19,1089,11625,108,4944,457
15,9,6,2,8,447527,869,6,327,423
8,3,5,0,6,25690,0,22,410,671
8,4,4,2,8,16102,21115,17,5187,465
12,6,6,1,21,977,94679,21,29418,545
44,8,36,3,7,52867,12441,65,592,526
9,4,5,1,16,277655,2371,12,2371,511
15,5,10,1,12,129508,26450,0,665,578
17,7,10,3,7,148850,9931,68,2876,477
37,14,23,1,6,192660,5842,11,0,539
3,1,2,0,10,0,0,0,0,684
6,2,4,1,7,26183,12192,7,0,484
24,6,18,6,10,110079,82473,0,0,457
3,1,2,1,14,8666,8666,3,8666,655
13,8,5,0,3,317747,0,0,0,630
11,6,5,3,9,28176,9966,39,4779,465
5,1,4,2,9,5561,12226,59,866,559
11,7,4,4,6,67771,37130,42,19209,426
9,6,3,0,10,245929,0,2,0,660
20,10,10,10,7,336771,50254,361,16795,435
20,6,14,3,18,227755,44875,31,3970,532
12,8,4,0,11,166423,0,2,0,635
14,12,2,5,27,264327,259637,91,7310,386
9,7,2,1,6,11551,638,21,638,435
13,5,8,4,18,23234,22853,65,11141,468
10,6,4,3,8,51921,40654,67,19998,474
17,6,11,2,10,27971,8891,132,1557,504
13,8,5,11,4,762050,517692,148,174431,402
3,1,2,0,1,1877,0,4,0,636
9,6,3,2,69,2864706,2557165,52,2550159,462
11,8,3,2,26,476120,9941,25,9731,447
21,8,13,1,15,88992,1650,14,2370,522
22,9,13,8,7,58755,64518,162,21023,522
16,5,11,3,13,317145,9618,64,4366,436
7,4,3,3,9,15357,15351,110,5049,436
10,5,5,1,8,230842,3440,50,2531,560
7,4,3,4,8,48080,48499,57,11816,455
13,10,3,6,9,70125,30312,122,13094,504
35,12,23,6,17,131056,18525,112,14069,486
16,2,14,1,14,336165,6830,2,6830,539
5,3,2,4,7,13095,15621,198,8134,505
15,3,12,0,5,54826,0,2,2128,556
14,11,3,0,10,141641,0,24,18941,482
55,6,49,3,16,11649,5718,51,11389,480
7,3,4,3,13,10722,10722,75,1637,533
12,8,4,7,4,115891,84455,89,11090,463
8,6,2,0,14,31176,0,0,0,620
9,5,4,2,14,16371,1350,7,5235,350
43,18,25,3,18,517256,3560,22,0,542
25,10,15,4,12,18612,3412,141,7272,384
24,4,20,6,16,70299,61452,0,0,453
27,11,16,4,8,41327,6988,21,3977,465
11,3,8,5,18,86856,124078,80,52805,441
4,2,2,0,9,269891,0,0,0,636
16,6,10,3,13,508981,27762,76,20375,419
16,5,11,6,10,73735,115053,110,50383,424
33,7,26,6,15,52776,43008,482,13372,487
8,6,2,0,10,313147,0,3,0,624
11,2,9,1,10,17855,1294,25,0,534
11,5,6,2,12,148452,11995,28,11503,507
28,9,19,8,6,113953,81655,171,49116,400
66,11,55,4,16,203384,34567,300,3554,493
5,2,3,2,3,22648,8807,59,7722,505
36,16,20,0,14,659412,0,2,0,576
27,7,20,7,10,27607,27607,133,8353,408
4,1,3,0,14,0,0,0,0,568
10,1,9,0,15,1400,0,0,1211,675
17,12,5,0,4,517775,0,7,0,501
12,9,3,4,9,22107,4529,112,7436,440
10,5,5,2,11,387640,9672,12,6451,563
53,17,36,9,69,320712,39553,105,9430,446
18,9,9,0,5,680386,0,4,0,517
31,9,22,7,34,89783,76583,109,43044,459
11,4,7,1,16,2559,1527,23,377,511
7,5,2,4,5,43452,52194,65,15595,491
24,14,10,9,18,2170589,549333,165,6054,492
19,9,10,1,9,123047,971,2,5520,531
13,10,3,3,19,654901,10086,20,4162,477
16,11,5,11,9,28557,25640,121,5533,411
30,14,16,3,13,493273,18632,45,1476,503
13,2,11,0,7,80163,0,0,0,625
15,9,6,3,12,830653,30983,29,0,518
43,6,37,3,13,69141,1394,18,1428,574
4,2,2,1,11,707,707,20,7000,555
11,2,9,3,11,135238,126826,24,108679,468
3,0,3,0,11,0,0,0,0,572
15,7,8,10,11,72267,108221,198,11326,501
73,10,63,5,11,37642,17119,385,13194,431
5,3,2,2,8,25179,19944,56,0,541
19,14,5,0,7,504339,0,0,0,661
15,8,7,2,6,136429,19978,10,1925,487
17,5,12,3,17,79561,33651,72,16719,450
19,5,14,6,7,188818,179496,195,48284,479
10,5,5,7,7,32034,40514,145,12627,447
8,3,5,2,10,3609,3609,119,6250,547
20,6,14,0,6,156311,0,170,4804,605
23,5,18,0,14,639041,0,0,243,652
12,5,7,0,7,4936,0,0,0,654
9,6,3,3,7,33982,27290,0,0,482
6,3,3,2,14,136437,1390,31,0,489
17,3,14,4,20,15361,15361,0,0,486
25,9,16,4,18,90609,45995,89,29034,491
7,4,3,2,9,138939,43161,33,0,484
12,7,5,10,7,84339,95865,288,14405,490
26,8,18,6,37,115958,99169,269,13670,461
10,4,6,2,13,25601,29693,15,16814,402
28,8,20,6,8,45952,20906,235,6530,496
12,9,3,0,6,386204,0,17,34,581
8,4,4,2,9,42613,10640,18,0,545
19,13,6,1,27,473441,421,17,421,489
18,12,6,3,11,1035313,91822,14,818,454
11,4,7,2,20,6388,7710,70,2456,465
20,12,8,3,20,641928,12143,17,6238,538
26,13,13,11,10,333320,271836,171,13701,424
7,5,2,1,13,6713,6713,28,9241,565
25,10,15,10,9,355526,105186,219,45516,417
17,12,5,0,18,861876,0,0,0,709
9,2,7,2,9,19714,5915,36,0,636
27,10,17,0,13,466683,0,65,578,619
72,8,64,0,17,433799,0,24,1717,671
7,4,3,3,6,29632,21927,287,17320,539
10,2,8,4,9,40253,43116,53,14590,491
58,15,43,7,7,285625,29392,109,12894,493
10,6,4,2,69,491340,22626,48,10658,505
26,7,19,0,69,24003,0,32,17480,456
37,11,26,11,6,136924,77346,352,11866,465
8,5,3,1,15,15568,2901,0,876,539
11,2,9,0,12,0,0,0,0,630
20,6,14,4,8,41574,41194,219,45279,381
4,1,3,2,11,19684,44120,42,19684,646
45,4,41,2,10,12377,13979,0,0,517
3,1,2,1,13,602,602,23,0,540
15,7,8,0,11,152686,0,0,0,638
11,5,6,2,13,244407,17809,0,0,629
17,11,6,0,22,1300310,0,4,0,724
9,6,3,0,12,1754697,0,12,0,550
21,9,12,0,13,722211,0,10,0,660
16,2,14,2,7,27673,34706,26,22440,530
38,2,36,1,17,5185,4900,26,15400,562
28,11,17,2,13,430761,36425,78,415,494
11,7,4,1,7,153541,1507,0,0,466
24,7,17,6,18,13825,11576,66,5185,483
26,15,11,0,19,283838,0,26,2814,555
3,1,2,1,15,2147,2147,19,2147,589
6,3,3,1,8,1598,11601,0,0,551
12,10,2,7,9,23174,15145,121,6375,477
27,9,18,0,15,551278,0,0,505,680
24,9,15,0,12,229442,0,4,659,600
3,1,2,1,11,3410,3410,6,3410,461
8,4,4,8,7,25451,70597,176,13931,447
8,3,5,0,14,59882,0,10,7001,676
11,4,7,6,8,32837,60898,185,10105,494
6,1,5,2,18,7012,6978,28,0,512
21,13,8,8,13,1421472,221262,46,1071,430
19,10,9,0,12,1327926,0,1,0,609
93,11,82,4,10,39785,17522,32,10810,508
10,5,5,2,6,363635,3212,21,0,494
28,12,16,5,9,179093,112018,167,3161,528
13,5,8,5,19,497964,53204,77,23484,421
10,6,4,5,6,233595,170972,25,0,502
2,0,2,0,3,0,0,4,803,618
28,13,15,4,10,242223,12363,0,0,523
11,7,4,1,16,473586,10646,26,10646,524
17,5,12,2,13,18407,12416,27,900,474
7,5,2,4,4,17841,17076,14,5985,469
30,6,24,2,12,375607,8877,117,7368,398
8,4,4,0,3,12177,0,0,0,622
13,8,5,7,14,147161,56276,7,8548,470
10,6,4,1,9,20279,9853,23,9853,626
6,4,2,2,15,187676,19720,48,13256,584
29,9,20,4,14,393767,117776,112,90423,504
13,8,5,6,14,554909,118283,64,1248,439
43,6,37,4,13,49660,8447,341,10100,486
24,2,22,0,11,0,0,24,2703,629
18,7,11,1,8,41258,4928,12,0,661
14,4,10,1,11,52120,1563,3,23364,571
16,7,9,4,13,67284,63876,36,22994,454
5,2,3,3,7,19666,26066,42,19036,540
11,7,4,4,12,81132,79970,29,56047,501
11,9,2,7,15,31694,19664,58,5194,512
6,3,3,2,3,65076,5367,40,4627,528
21,17,4,8,13,91367,85827,51,21409,482
14,9,5,7,8,110729,49298,23,2479,419
74,9,65,6,15,48249,40390,526,11706,535
48,14,34,9,15,21460366,126012,66,18790,427
5,2,3,0,10,17610,0,28,737,548
4,2,2,1,10,37773,632,0,0,629
6,3,3,2,7,11847,4396,29,5950,489
32,11,21,8,30,1348347,296066,98,2200,456
15,9,6,0,18,570965,0,1,0,607
28,6,22,0,10,43224,0,124,1222,529
25,17,8,5,20,671838,18492,39,7940,538
6,3,3,0,8,23838,0,16,1338,581
15,3,12,1,6,16743,3227,10,3227,602
7,5,2,2,18,88274,43656,39,0,536
9,6,3,3,6,23427,4780,22,572,465
8,3,5,1,10,63175,63175,14,63175,611
8,4,4,4,5,14475,6989,0,0,429
7,3,4,2,18,39871,39871,50,0,609
15,5,10,2,10,9578,1840,43,30642,458
24,12,12,0,8,641057,0,9,0,482
13,8,5,0,10,166058,0,6,80,579
10,3,7,1,9,15184,3311,32,3311,462
11,1,10,1,7,0,32103,41,0,664
4,2,2,1,15,28865,5932,15,5932,632
6,4,2,2,8,18579,786,9,1892,481
13,6,7,7,12,934356,356013,18,5596,455
19,3,16,2,10,19576,32989,89,6165,500
14,8,6,4,13,218024,39555,40,16277,451
6,2,4,1,16,6935,6935,30,6935,601
20,5,15,3,15,6144,6144,67,10597,443
7,5,2,0,9,40444,0,0,0,680
32,12,20,4,14,289842,9406,65,25980,414
30,5,25,2,5,22186,2015,31,0,446
6,3,3,2,9,23350,5716,2,4024,475
34,7,27,3,14,61048,12496,38,646,539
5,2,3,1,5,56587,8627,7,0,635
12,3,9,1,8,20943,4029,3,4029,540
31,14,17,0,10,411736,0,93,1076,462
18,13,5,1,7,162177,498,30,691,579
10,7,3,0,13,294593,0,9,0,691
14,5,9,3,11,60304,39114,41,885,514
7,4,3,1,12,327949,5930,13,0,618
15,4,11,4,12,33313,50165,0,0,537
14,2,12,2,9,50376,33166,34,20175,629
10,4,6,1,7,4143,939,106,15027,611
15,5,10,0,15,953450,0,10,2954,605
53,17,36,4,69,514811,12612,104,2010,441
21,10,11,1,13,414604,833,6,0,503
5,3,2,0,26,125866,0,21,6800,633
15,7,8,5,33,151811,26499,3,5123,450
13,4,9,2,18,37330,37330,27,35849,496
10,8,2,3,7,272108,2326,43,1041,520
12,5,7,1,6,67310,4847,77,5541,560
17,6,11,4,14,261212,3920,50,1860,492
9,4,5,3,14,23255,17864,122,14429,511
7,4,3,2,18,900073,17336,28,22135,548
7,3,4,2,18,43284,43284,36,36737,518
9,4,5,2,8,8723,6139,21,5542,432
12,6,6,2,18,269553,12815,148,14103,518
18,15,3,1,6,214702,1324,18,1324,595
3,1,2,2,8,5646,4702,8,0,636
20,4,16,4,14,18528,21736,50,12112,466
15,1,14,4,10,16238,63498,116,16238,595
21,6,15,5,11,56228,54659,98,10352,459
6,2,4,3,5,68855,68855,35,5240,611
11,6,5,4,7,66411,6152,275,3829,498
45,12,33,3,35,263994,48726,22,36350,513
14,11,3,0,23,1131051,0,4,0,663
6,3,3,2,12,54612,49851,18,43773,437
45,16,29,2,10,90261,76188,171,13025,522
14,8,6,5,9,1497834,25206,26,0,527
4,2,2,0,7,110987,0,1,0,706
26,5,21,2,25,569031,16326,47,11759,455
6,3,3,4,11,133117,77778,34,59708,466
8,6,2,4,8,12785,12785,138,8550,431
32,4,28,1,8,254424,4650,15,4650,478
68,21,47,1,9,761223,1,208,28283,442
7,4,3,0,5,180830,0,4,1023,618
7,5,2,3,9,68660,68443,45,66195,442
11,3,8,3,17,172569,56046,43,47795,378
19,10,9,0,11,187425,0,9,0,641
32,12,20,0,13,566579,0,4,0,638
10,1,9,1,17,13616,948,6,4936,698
26,19,7,7,16,404213,31388,153,8837,472
32,11,21,3,16,623987,13506,185,2952,490
6,3,3,3,9,16134,16134,119,9013,476
17,6,11,8,11,316941,107712,93,8990,398
36,7,29,8,9,55732,54511,167,16640,423
13,4,9,2,9,28959,14351,79,1310,537
35,5,30,1,14,282295,5772,40,5772,640
55,12,43,6,21,384561,68590,210,25749,446
14,5,9,5,14,153309,134216,39,59409,529
29,12,17,9,34,852888,867880,115,286434,517
46,10,36,0,13,242153,0,36,208,485
7,3,4,0,12,75614,0,14,0,633
29,11,18,1,7,118241,2394,27,783,485
18,15,3,2,14,339265,2012,3,1945,470
8,4,4,3,6,21734,11980,24,8784,571
5,2,3,0,4,0,0,35,6361,465
18,7,11,7,11,140880,134084,134,9155,430
19,4,15,2,12,42817,20906,16,14267,534
11,9,2,0,9,27468,0,4,971,604
19,4,15,1,14,48587,1996,48,5500,529
7,2,5,0,3,8823,0,0,0,640
7,5,2,5,5,22055,33747,44,0,519
51,3,48,1,14,26681,4498,109,4498,565
15,5,10,2,10,101230,7725,176,7345,502
15,5,10,8,17,422746,185266,52,38819,442
18,4,14,1,15,32236,19493,130,19617,450
21,6,15,3,27,384169,4335,22,5974,450
4,2,2,2,14,13216,13216,28,11858,497
11,6,5,6,8,172966,144154,168,22667,465
11,8,3,0,18,1904932,0,7,0,648
22,11,11,7,22,557380,37389,19,0,468
11,0,11,0,3,0,0,8,3390,594
32,11,21,0,6,245216,0,2,5049,600
6,3,3,1,3,988,1810,15,0,623
21,5,16,5,14,32131,22622,110,7835,469
6,3,3,2,4,9056,8886,39,0,448
10,2,8,2,17,4429,4429,22,1063,510
12,6,6,0,14,311747,0,29,717,531
9,4,5,1,12,216201,9647,18,9647,539
7,1,6,1,17,19716,19716,22,19716,547
5,1,4,1,4,52042,52042,17,0,504
20,9,11,4,13,142478,60253,52,26915,457
11,5,6,3,9,25023,21925,26,21184,501
21,7,14,5,9,336480,30892,121,12874,424
16,8,8,9,7,56897,56173,123,13654,384
12,4,8,2,16,36313,9284,15,9309,515
37,10,27,7,8,417237,161746,382,72676,376
24,8,16,0,19,578312,0,3,0,570
16,8,8,7,7,16886,16886,385,9200,433
7,3,4,2,7,12526,7452,50,1058,633
26,9,17,5,12,551196,226439,114,35359,504
10,4,6,3,17,343948,64740,58,27004,558
4,1,3,0,7,0,0,0,0,738
7,5,2,4,5,15156,15155,40,6940,419
35,3,32,0,9,8661,0,1,0,637
28,11,17,2,6,403530,1355,376,2064,453
7,4,3,4,7,820173,42746,36,0,537
7,3,4,2,8,46291,45475,48,45177,526
12,5,7,5,15,118414,99629,75,89497,455
42,14,28,9,18,195070,64783,307,1650,453
38,9,29,0,13,147051,0,3,287,688
11,8,3,5,12,231237,15643,325,6113,444
61,11,50,1,14,70931,1620,18,4860,486
12,4,8,0,8,51883,0,2,1877,675
6,2,4,0,11,250102,0,9,5568,643
110,17,93,1,18,301717,712,81,1506,573
19,7,12,3,15,261517,8650,189,8025,529
45,15,30,0,31,1583771,0,55,2486,508
7,3,4,2,11,4575,4575,81,3518,556
12,5,7,0,4,105206,0,0,1103,629
14,6,8,4,9,35440,14376,103,7407,477
27,13,14,0,13,404593,0,5,1117,543
37,2,35,1,13,429643,136601,15,0,601
7,4,3,2,3,6999,1787,16,1159,475
37,8,29,4,17,109177,100877,29,49224,418
22,8,14,2,7,122350,15317,57,8640,497
29,10,19,7,5,151578,57548,22,17662,437
11,3,8,4,10,24743,35487,77,10744,443
7,4,3,2,12,390565,20617,45,0,463
17,11,6,4,7,102176,91856,95,14432,444
16,12,4,5,7,317090,9122,63,5068,505
4,2,2,2,10,15146,15146,29,14000,509
40,9,31,4,11,276466,56819,88,0,545
23,4,19,8,7,34693,65417,469,20446,458
6,3,3,4,10,34150,59200,24,3120,520
4,2,2,1,20,0,1303,22,0,621
12,3,9,6,7,25373,45038,187,40854,551
23,10,13,7,15,259918,148506,87,0,495
12,7,5,4,8,57319,21993,111,14356,508
9,7,2,6,15,262581,262581,68,41264,459
6,2,4,2,9,64349,31577,40,5755,485
8,2,6,0,14,87124,0,10,68995,616
14,6,8,0,10,297689,0,30,0,529
8,1,7,2,10,110435,97128,33,6300,619
30,14,16,9,13,147843,57879,106,21142,461
15,5,10,7,10,28222,48396,88,7806,433
19,12,7,5,7,18718,13396,71,4637,452
12,4,8,0,29,216466,0,2,3709,632
28,11,17,3,13,297754,15733,30,7883,539
6,4,2,2,4,502016,134538,27,134055,456
9,3,6,4,7,132117,175814,84,108821,469
5,3,2,3,10,20585,16641,111,9108,458
13,10,3,3,8,219881,19538,68,10762,461
29,6,23,4,18,20600,6050,216,4487,465
33,30,3,4,14,349211,29061,0,0,527
5,3,2,3,7,28503,27708,61,0,511
25,17,8,7,12,590305,45082,148,15826,440
15,9,6,5,14,115216,17844,101,12078,532
58,21,37,23,12,518260,465839,556,83951,425
9,6,3,4,9,106340,10626,65,0,469
30,9,21,3,19,199525,44782,1,1850,455
14,7,7,5,4,32847,13591,125,4636,479
25,17,8,3,14,1240153,71014,105,25599,427
35,9,26,0,4,182590,0,0,4002,579
20,7,13,0,12,51914,0,1,249,686
22,5,17,3,13,43283,22879,44,11267,458
20,8,12,3,16,243994,34857,75,8056,510
39,12,27,6,14,1045146,123002,67,11073,450
6,3,3,3,8,180000,152759,52,0,446
13,5,8,4,20,47700,67965,90,0,497
26,14,12,0,13,53725,0,14,0,481
9,6,3,7,8,34443,27291,37,6696,428
84,9,75,6,5,69093,42727,91,11318,469
18,12,6,0,16,872061,0,8,0,626
9,4,5,5,14,15543,41735,118,0,500
17,13,4,13,9,50828,58053,30,5989,422
7,5,2,4,9,9936,8820,50,1152,452
8,5,3,0,15,270678,0,0,0,690
9,6,3,7,12,339468,72516,190,5989,481
5,1,4,2,9,0,13133,24,1630,683
12,4,8,3,15,137739,48674,38,0,481
27,8,19,0,13,150467,0,16,20,664
13,6,7,0,20,510824,0,0,0,694
52,5,47,5,9,33581,27608,105,0,486
12,6,6,2,13,1660755,12216,44,0,482
34,10,24,5,25,265748,12018,57,16328,404
12,3,9,3,6,44301,43333,45,3730,469
16,6,10,1,13,144603,939,10,0,640
7,2,5,2,8,8924,8924,24,5507,477
38,2,36,3,9,18375,41787,62,0,447
3,1,2,0,7,16766,0,0,0,652
10,4,6,2,11,13896,72001,54,0,526
6,1,5,0,4,13735,0,3,0,614
28,8,20,1,10,911022,8814,0,324603,574
12,6,6,4,13,87005,26649,46,18343,502
19,4,15,2,8,19791,11082,16,4602,486
12,5,7,1,15,40722,185,0,2844,571
44,19,25,11,18,174817,47809,262,13981,425
90,2,88,0,6,0,0,0,203,657
3,0,3,2,6,15701,15701,13,0,578
11,5,6,0,14,331552,0,0,0,688
42,6,36,4,8,15878,11756,256,5979,492
9,3,6,3,8,35154,18908,60,4016,466
8,3,5,0,16,28835,0,0,0,639
12,6,6,2,7,197764,52068,38,35,484
8,6,2,4,10,11224,13362,28,3286,448
6,0,6,2,4,0,26043,19,22173,556
7,1,6,1,8,0,4517,20,2200,632
11,5,6,1,5,158906,752,30,9377,464
12,6,6,5,6,64059,64059,47,19531,518
14,4,10,5,15,116753,83895,63,35349,449
40,7,33,4,7,72408,38588,170,11250,611
25,11,14,7,8,561342,41206,17,12812,451
12,5,7,3,12,22026,22026,16,11052,425
4,2,2,2,7,3958,3958,9,2239,468
53,10,43,9,9,94368,50857,296,47226,399
18,3,15,3,11,15776,19909,50,8434,520
7,4,3,2,7,73968,4704,37,3808,591
25,3,22,0,18,26040,0,1,1684,648
7,2,5,1,13,14994,3249,28,0,531
23,11,12,0,12,1301102,0,4,589,520
40,16,24,4,17,601881,27624,65,1851,480
4,2,2,0,4,10030,0,6,3160,597
7,5,2,4,6,385056,39468,20,21381,405
19,17,2,1,25,321614,100535,34,1347,538
31,11,20,7,12,269162,28001,282,2155,482
5,2,3,3,12,23703,23703,120,12194,505
41,15,26,5,17,398142,18134,141,22463,448
18,10,8,11,8,197088,300752,91,66288,416
16,13,3,13,7,1051888,370361,70,61165,392
24,8,16,2,15,638298,22828,34,6304,474
15,7,8,1,20,529040,4466,0,0,480
18,7,11,0,9,203924,0,7,0,572
21,8,13,4,15,593378,57759,23,10924,526
14,4,10,4,19,348626,83052,42,1044,465
7,4,3,2,7,24016,315,38,2015,486
27,18,9,10,13,961866,189554,107,320,501
16,7,9,4,10,491803,27041,69,8347,458
32,8,24,5,15,13485,14154,409,5036,479
10,8,2,10,6,54015,60053,153,20384,411
3,1,2,0,13,0,0,5,0,707
25,6,19,0,14,27675,0,44,7200,544
21,10,11,12,11,247469,254793,181,50072,394
12,3,9,0,7,2222,0,105,2204,688
17,10,7,4,4,310788,2849,47,1614,491
29,8,21,4,9,368748,16996,245,7741,457
17,6,11,6,10,650986,460074,44,2991,481
10,2,8,0,9,168728,0,113,3618,629
14,12,2,2,15,2872070,434,41,48,522
34,12,22,1,19,410232,111,4,697,612
21,3,18,3,9,23361,21777,47,8020,534
15,8,7,7,12,59563,49665,203,13640,439
16,6,10,4,19,94657,48248,30,65033,480
21,6,15,1,6,128540,5155,41,0,524
20,12,8,0,28,872714,0,17,0,512
28,10,18,6,11,42617,30008,50,9526,443
14,6,8,3,25,2779,108002,72,4350,534
77,5,72,3,18,40321,26447,72,12066,425
11,3,8,1,6,770,770,49,770,546
32,10,22,8,7,65802,63618,279,22004,404
27,8,19,7,15,208863,273434,112,60383,394
8,5,3,6,8,203635,302080,132,131150,443
12,4,8,6,8,25015,43623,90,15734,588
11,8,3,7,13,293387,65513,37,15262,467
6,3,3,2,8,7525,7525,222,7095,506
13,5,8,0,16,355931,0,0,0,592
10,7,3,0,4,224950,0,0,0,652
18,8,10,1,10,187102,398,13,2050,592
16,2,14,1,14,16822,16821,33,16821,528
7,5,2,0,20,350583,0,6,0,484
9,5,4,2,10,103197,48150,29,0,466
8,3,5,5,9,302347,588541,97,142997,613
21,6,15,3,9,365768,20117,145,6837,533
8,1,7,0,14,1899,0,0,0,648
28,10,18,0,14,469163,0,2,185,615
17,10,7,4,9,60459,30804,110,4882,420
16,3,13,4,8,8633,14419,73,4087,476
20,11,9,5,10,271083,10771,178,1928,460
40,16,24,1,9,1519688,5850,43,162,517
15,9,6,2,4,3222597,10309,11,152,464
7,4,3,0,7,48846,0,0,0,615
15,6,9,5,22,677459,120916,56,8144,461
7,5,2,1,18,63067,4279,43,8248,453
4,1,3,1,5,7812,2228,24,2228,548
12,8,4,8,15,116642,99239,41,51787,423
10,4,6,0,8,214738,0,23,4640,525
15,13,2,11,7,125152,74190,167,5273,488
10,6,4,5,16,28923,28923,81,10343,462
18,8,10,2,22,223522,166255,64,14813,553
8,6,2,5,6,30336,33358,0,0,484
24,8,16,7,26,246459,32744,82,8817,464
11,4,7,0,15,38592,0,4,0,607
23,5,18,7,13,280937,208291,153,176,521
9,4,5,2,16,40037,2290,3,962,592
12,8,4,5,5,26207,14400,45,6121,440
28,17,11,1,36,1178510,2455,25,0,611
16,9,7,5,22,345440,18846,56,9606,487
27,6,21,4,7,32783,8389,26,1390,469
8,5,3,2,18,272863,1496,41,2008,523
20,6,14,3,27,103269,14539,63,40457,491
8,4,4,2,13,359073,20152,16,12023,459
28,11,17,11,15,470505,428080,0,0,490
28,10,18,6,11,248971,53609,14,13758,380
4,2,2,1,3,8507,7334,25,0,517
10,2,8,2,10,6905,11367,44,6905,533
20,6,14,1,8,266140,385,13,666,559
5,3,2,1,9,4849,448,10,0,570
4,1,3,1,5,3181,2300,0,0,622
8,4,4,3,5,101213,35435,65,1291,528
7,4,3,3,8,23605,17970,63,12477,423
10,4,6,1,12,23495,9012,25,9012,460
8,4,4,3,6,77885,73798,102,6228,415
6,3,3,2,6,16415,16415,45,1921,546
20,7,13,5,7,50431,37559,90,6906,494
36,10,26,1,13,1572535,5756,128,13804,575
13,7,6,5,15,526454,463847,3,1955,451
4,2,2,1,9,319494,4425,25,0,522
13,9,4,10,5,80100,118774,269,17655,479
36,15,21,4,12,608046,27720,114,10082,436
25,3,22,2,4,551979,550904,47,331634,538
6,4,2,0,13,15705,0,2,2585,567
29,7,22,9,18,29398,29397,114,8922,450
12,9,3,2,9,224446,1930,30,8977,427
12,9,3,3,5,219977,333,146,580,535
27,6,21,3,13,55472,25110,62,13568,433
28,7,21,1,13,168265,394,24,932,561
14,9,5,8,14,58099,46269,175,5040,413
13,3,10,2,8,23244,35765,118,23244,460
15,5,10,3,25,1948865,10100,81,9309,507
10,6,4,0,9,74604,0,10,0,523
12,5,7,4,14,10600,12015,68,4124,474
24,9,15,0,6,970780,0,64,8450,526
17,15,2,4,7,96865,25426,28,3059,399
16,7,9,7,17,648911,132434,118,68540,487
6,4,2,4,13,34683,37160,0,0,530
43,21,22,7,12,2991123,39711,6,11730,475
24,12,12,1,9,776091,139,25,0,514
23,4,19,4,8,11905,10830,32,2964,439
19,7,12,7,17,138091,200311,383,107340,524
28,4,24,1,14,8832,7232,24,7232,575
5,3,2,1,8,32113,27164,25,370,576
26,14,12,9,12,1077924,765554,164,0,496
21,6,15,2,6,55448,10636,27,7620,543
5,1,4,1,7,7183,1053,0,0,652
14,9,5,1,14,239806,4881,10,233,504
7,3,4,2,15,12153,10986,29,9234,457
6,3,3,5,8,76771,90119,64,21748,561
15,8,7,4,5,353796,30726,40,3425,467
15,10,5,5,13,327411,34484,96,11830,398
28,10,18,4,13,461848,19812,74,11227,481
11,4,7,0,10,17847,0,26,0,669
10,7,3,1,8,230940,1250,69,2136,588
14,8,6,0,13,753939,0,3,561,580
6,4,2,0,11,313174,0,9,5478,500
24,3,21,2,7,22442,4531,62,1458,534
13,11,2,5,16,236182,73127,299,45214,447
5,3,2,1,7,43345,6892,12,0,583
21,16,5,0,8,335579,0,0,0,659
13,6,7,0,5,542311,0,1,0,544
13,11,2,4,8,59143,16492,10,0,472
16,6,10,4,14,129324,93658,70,36347,604
15,5,10,6,16,319280,65663,17,4350,466
33,14,19,5,30,924511,865862,27,0,607
2,0,2,1,3,0,5575,8,5575,492
20,0,20,0,11,0,0,0,0,539
9,5,4,1,9,25592,14188,25,0,545
49,12,37,3,16,523597,164075,30,25901,532
27,10,17,5,8,449777,86967,15,6659,419
12,7,5,2,25,213539,8063,14,0,493
8,6,2,1,17,38759,22484,16,22484,432
6,3,3,2,18,26830,19441,68,0,531
22,6,16,2,6,130347,3699,18,1966,531
37,19,18,4,17,3767666,111631,82,1561,548
18,10,8,9,11,403879,130944,47,4650,439
18,14,4,13,9,56194,50352,75,20946,455
22,11,11,7,11,830964,1027140,154,338493,498
9,6,3,3,7,69943,59269,112,15275,471
13,5,8,4,11,8927,8925,58,19515,390
9,4,5,3,10,731804,74378,59,378,556
18,16,2,2,5,63107,3457,19,2571,522
23,8,15,10,12,134209,128107,55,18746,422
6,1,5,1,8,19426,9570,0,0,625
12,7,5,0,7,79027,0,156,1918,537
13,6,7,0,16,156447,0,3,710,610
10,2,8,2,10,1631,1251,13,1758,593
45,10,35,0,18,641186,0,1,1080,608
20,9,11,1,8,60829,3287,6,2241,526
18,8,10,1,10,39548,3139,0,0,448
10,3,7,0,8,0,0,0,0,757
141,19,122,10,12,495324,165858,651,30312,449
16,9,7,9,16,33608,36015,56,5720,403
7,4,3,3,10,195933,13424,20,7009,526
17,12,5,0,7,45380,0,7,265,571
13,9,4,4,12,171497,12747,30,5376,452
19,4,15,4,7,11933,26490,72,2780,477
6,3,3,1,8,217910,980,39,3761,487
5,3,2,1,8,398147,812,3,0,669
23,16,7,0,8,974236,0,4,207,555
23,8,15,0,10,472315,0,9,0,604
13,9,4,10,8,62332,74098,108,26519,416
5,1,4,0,4,615,0,15,1425,582
11,5,6,0,7,97936,0,0,0,629
5,3,2,2,8,3524,3524,2,2684,621
31,15,16,12,9,410279,270657,180,39000,389
11,7,4,4,10,116650,5121,46,1840,427
30,13,17,0,20,802969,0,10,1034,595
3,1,2,1,5,8008,6182,43,0,621
40,8,32,7,11,154649,36150,120,11584,442
17,8,9,0,38,391179,0,11,0,580
26,19,7,1,20,603575,1262,8,1262,463
27,10,17,8,12,39985,33479,107,10013,447
10,7,3,6,14,171448,144101,128,0,502
27,12,15,1,29,1024040,18910,11,18910,596
11,5,6,0,12,26890,0,0,1491,545
3,1,2,1,6,82877,53092,25,0,519
4,1,3,2,24,2052,8183,38,6131,627
8,6,2,5,17,138171,26639,24,17614,438
19,9,10,0,29,458045,0,3,0,675
20,9,11,4,13,544479,81195,47,0,474
19,9,10,0,22,460724,0,0,0,661
8,6,2,0,6,28805,0,0,0,649
35,8,27,7,11,783002,1014844,97,5206,486
30,12,18,4,19,280526,39355,38,15504,526
20,6,14,8,7,278165,212118,116,9216,501
12,8,4,5,14,443078,60003,92,17107,426
16,5,11,0,24,6956,0,0,1583,565
42,12,30,1,8,658720,1548,14,12000,554
20,2,18,2,15,22184,520,81,6472,629
20,9,11,4,4,337263,52825,21,611,453
13,7,6,9,9,19864,20694,70,4343,421
25,11,14,0,3,530220,0,0,0,653
12,6,6,2,7,165459,7609,45,0,527
11,9,2,7,8,302869,36662,112,11720,420
9,2,7,1,14,11333,3490,67,2802,464
20,5,15,5,10,13458,29916,80,15069,477
42,4,38,1,14,300645,13961,5,258,588
10,7,3,7,9,613283,181219,85,43676,495
77,16,61,1,14,681603,24440,15,1768,522
6,3,3,2,6,2630,2630,9,1920,535
10,1,9,1,7,2000,9008,16,2000,474
28,7,21,3,18,601,72962,434,2395,654
6,2,4,0,2,105843,0,0,0,605
18,8,10,10,9,119439,155200,176,54048,372
19,16,3,9,10,116164,43598,22,8497,454
4,1,3,0,11,274028,0,1,126,692
4,1,3,1,7,23140,23140,18,23140,425
72,9,63,2,13,59096,8183,61,14390,545
18,8,10,5,14,130818,127937,117,55219,432
3,1,2,1,6,1618,1618,12,1618,467
18,9,9,0,8,1525849,0,0,0,671
7,5,2,6,9,57698,49377,94,20055,429
7,2,5,0,7,973,0,0,1501,633
11,8,3,7,14,351379,451912,5,105038,401
17,8,9,1,14,91710,5480,119,0,612
24,3,21,5,19,207534,15833,13,2336,510
38,22,16,0,8,152851,0,2,2308,612
9,7,2,4,11,27231,7781,107,9438,456
12,9,3,7,13,66934,79799,96,26477,423
24,13,11,4,14,524366,37011,59,14514,532
22,4,18,3,12,64795,32442,64,22967,539
27,15,12,0,9,143277,0,0,0,627
11,8,3,0,8,1226077,0,1,0,641
24,9,15,6,12,510018,16000,20,7765,434
22,11,11,14,7,338324,60989,404,11352,368
4,1,3,0,12,630,0,0,0,513
10,6,4,2,12,27322,27322,66,14494,432
9,6,3,4,21,54584,54584,112,0,512
31,11,20,0,13,284327,0,9,0,593
3,1,2,1,13,24262,10530,13,0,530
112,4,108,1,13,428624,17299,100,34598,504
16,3,13,1,17,81552,8997,7,3697,499
13,7,6,5,5,61258,60923,148,30226,470
13,6,7,5,14,116381,151183,107,4693,506
14,7,7,0,15,62694,0,3,959,649
28,14,14,16,11,1403929,932270,36,16766,360
11,6,5,2,6,124180,23189,34,0,503
37,15,22,13,7,477916,133479,174,4176,404
20,17,3,0,7,1074906,0,8,2632,578
25,6,19,4,8,78220,53483,82,1230,473
11,6,5,1,21,30788,798,137,2382,618
37,8,29,1,18,147120,6053,29,1629,492
5,2,3,1,3,35174,7200,8,7200,623
9,5,4,0,8,294199,0,0,751,620
72,14,58,7,27,464905,127400,181,18197,498
25,16,9,1,8,1019114,349,2,4324,673
22,7,15,6,14,87231,76754,74,37552,475
10,3,7,2,9,14977,2350,0,0,511
8,5,3,1,16,256053,58900,17,9750,592
21,18,3,5,6,134717,20255,9,8440,409
3,1,2,0,9,0,0,5,600,673
15,11,4,1,16,126498,7126,23,7126,651
8,3,5,4,6,21967,33083,68,0,552
7,4,3,5,4,108760,107619,89,0,464
28,9,19,5,21,229929,25676,131,20208,493
10,2,8,3,15,12368,12368,15,9244,419
6,4,2,3,9,18521,18521,26,8646,485
41,6,35,5,12,51916,84692,247,4917,636
12,7,5,4,20,2557643,2527691,101,2403256,534
21,7,14,4,11,153635,102408,2,744,508
69,11,58,5,9,112580,92039,88,74825,468
7,4,3,4,9,101718,35458,42,0,466
21,10,11,10,9,244592,233479,151,35952,437
5,2,3,0,6,4734,0,14,0,603
3,1,2,1,5,15323,5413,6,0,479
6,2,4,2,8,89971,106276,54,0,511
3,1,2,0,12,136,0,5,216,488
9,4,5,3,14,15754,15089,45,9784,466
10,2,8,2,11,352537,5198,30,2599,649
16,11,5,8,21,108578,102999,20,277,463
7,3,4,3,9,108749,108749,55,55101,524
10,8,2,0,10,20466,0,4,0,588
8,6,2,0,23,52128,0,1,0,675
6,3,3,2,16,191839,7734,29,1188,426
13,6,7,4,8,404190,175847,122,849,504
7,4,3,3,4,11478,8274,41,4980,479
30,7,23,7,8,37958,44499,71,10820,451
4,2,2,0,9,395175,0,12,0,569
18,5,13,4,9,12225,10502,65,2332,523
6,4,2,3,4,11703,11703,35,10092,475
12,9,3,1,6,243825,361,0,0,534
13,6,7,0,9,459523,0,3,318,618
24,9,15,1,19,88877,564,69,1207,578
8,3,5,0,46,14767,0,28,0,580
4,1,3,0,8,13831,0,15,0,519
32,7,25,8,22,87150,75917,72,4479,429
4,2,2,2,12,105832,103122,0,0,549
4,2,2,1,22,563888,54343,17,0,608
19,8,11,0,25,748565,0,3,5710,612
5,3,2,0,8,90895,0,0,0,597
8,5,3,1,15,0,18587,38,0,621
13,8,5,3,17,569086,25065,5,3168,521
12,9,3,0,3,252748,0,7,1402,542
29,15,14,0,6,1202850,0,0,0,647
9,5,4,0,15,192612,0,1,1363,551
3,1,2,1,4,12434,4328,17,0,593
9,6,3,3,8,138157,130578,33,62649,519
17,4,13,5,8,41049,41049,177,21258,407
27,12,15,13,17,238541,266695,98,15394,437
41,7,34,6,8,59147,48462,0,0,455
18,8,10,0,2,83710,0,5,7300,607
36,9,27,6,16,231407,87145,66,21166,514
10,8,2,2,11,473980,320034,41,0,643
21,5,16,8,13,100702,86604,86,26551,433
8,2,6,3,6,9762,38295,51,16569,515
11,8,3,8,12,100405,56259,50,13464,454
4,0,4,1,9,0,44553,33,0,589
3,1,2,0,5,5000,0,0,0,628
7,5,2,2,15,24105,5650,41,217214,467
38,14,24,7,11,544805,36308,51,4113,469
10,3,7,3,2,11574,25823,20,9541,489
27,7,20,7,20,75869,66044,54,19052,467
15,7,8,5,9,142936,160008,119,84751,499
10,4,6,3,8,26172,26172,263,23523,459
23,16,7,5,5,171326,2737,54,770,498
14,5,9,3,8,2869,13594,103,0,485
5,3,2,1,9,20962,872,6,3301,560
7,3,4,0,9,273635,0,0,124,620
14,7,7,4,11,144020,134985,83,123250,412
17,7,10,4,24,267835,77556,61,7024,505
12,9,3,3,27,93987,53370,22,39841,456
20,2,18,3,17,992482,623794,12,392,454
11,7,4,4,6,529340,13004,5,1436,444
17,2,15,1,69,0,300,27,2725,529
11,6,5,0,12,174206,0,0,0,661
9,5,4,2,8,48006,8405,21,5586,524
13,7,6,2,17,26875,50207,65,26712,451
8,6,2,4,3,25570,18803,294,5950,408
32,6,26,8,14,205282,198333,105,19570,431
12,5,7,6,15,70771,101324,99,18884,434
3,1,2,0,19,0,0,4,338,681
20,10,10,0,13,244777,0,55,783,651
11,4,7,2,11,309544,53092,0,0,511
10,6,4,9,10,195499,256620,163,23951,468
27,10,17,4,9,21987,2873,37,2091,477
7,2,5,0,8,5206,0,1,1538,641
29,11,18,3,14,58111,35483,0,0,522
10,6,4,1,6,399260,7172,29,137,496
12,4,8,4,14,45169,45169,59,31733,486
32,12,20,2,10,66735,10783,37,7308,508
7,5,2,5,13,38960,85632,76,15255,467
6,4,2,0,13,57963,0,0,0,553
8,2,6,2,8,19533,16516,66,10845,634
4,2,2,0,9,0,0,6,4046,653
4,1,3,1,12,5392,5392,15,5392,656
6,4,2,1,7,36408,18216,95,18216,670
14,7,7,4,5,140186,77204,156,24390,500
11,7,4,2,7,308048,858,49,8419,450
8,6,2,0,17,179392,0,43,0,554
15,4,11,4,12,35465,35465,108,19000,494
30,13,17,3,11,8080572,2511129,21,0,505
7,4,3,4,9,13075,9280,50,1234,497
3,1,2,0,9,680,0,1,0,640
17,5,12,6,11,65752,81642,35,21234,424
13,4,9,2,9,14179,10916,41,8626,608
17,10,7,6,17,310950,228647,280,29606,428
8,5,3,4,12,13630,13234,127,10998,467
17,4,13,6,9,30028,56629,55,19880,545
14,6,8,1,9,468055,6902,2,6902,514
10,5,5,0,12,5388,0,8,308,624
19,7,12,1,18,204381,36637,25,312,528
20,8,12,6,8,26618,22124,184,12250,542
6,3,3,2,8,20774,20774,0,0,507
26,10,16,4,15,26883,27656,105,20768,490
10,6,4,8,10,51350,70869,150,27303,404
12,10,2,0,9,242504,0,2,0,628
21,8,13,1,8,893547,2600,8,2600,655
10,4,6,5,10,33080,45470,83,12225,594
23,1,22,0,3,1669,0,0,0,690
36,8,28,0,12,799656,0,0,0,606
10,7,3,0,7,142955,0,1,0,669
9,6,3,3,14,15408,8828,16,4861,471
26,10,16,0,8,176153,0,5,364,646
5,3,2,1,5,3248,2368,18,2368,527
26,7,19,1,8,194425,390,171,4951,536
11,9,2,5,7,243924,117866,0,0,450
5,2,3,1,18,7221,6457,15,6457,476
6,4,2,0,5,11525,0,12,2326,498
20,7,13,5,19,325705,275219,105,34514,525
7,3,4,0,2,33220,0,0,0,632
10,6,4,3,18,292447,26318,49,21069,512
25,9,16,0,12,42666,0,5,0,627
25,4,21,2,10,63677,63232,49,7270,507
30,12,18,7,14,272982,26872,119,2703,457
5,3,2,3,11,215263,14689,70,1419,494
7,5,2,0,9,30173,0,0,0,557
3,1,2,0,9,1470,0,0,155,625
12,5,7,6,17,168824,181359,20,12395,499
11,6,5,0,9,12274,0,73,2608,666
45,6,39,4,8,16176,8182,32,7650,478
17,8,9,4,20,93510,19781,32,13744,465
18,10,8,8,19,146708,136091,78,9188,461
10,5,5,3,10,22671,22609,210,23218,464
26,12,14,8,18,484229,115013,113,19620,434
19,11,8,9,20,384390,186445,15,18097,453
23,5,18,4,9,16203,6655,4,1085,522
23,12,11,1,11,137670,3738,23,3738,673
21,7,14,3,9,14410,8372,24,7566,442
5,3,2,0,2,129270,0,1,0,625
25,12,13,12,13,428788,77956,45,10732,461
24,8,16,0,29,1052735,0,43,5247,477
9,7,2,8,4,287034,384752,141,86042,435
17,10,7,9,4,396295,147074,122,3010,491
36,8,28,0,15,245420,0,96,437,614
13,5,8,1,24,164578,14948,0,0,534
23,6,17,1,16,645638,114434,23,0,533
10,4,6,3,7,17360,16800,137,12750,487
10,5,5,7,7,25972,32234,78,568,463
34,17,17,19,19,1969122,855617,424,145549,499
2,0,2,0,6,0,0,0,0,617
13,6,7,5,20,36813,31911,97,13487,464
8,2,6,4,9,129793,105912,42,6228,494
19,10,9,1,13,254341,16557,99,21599,556
7,4,3,0,7,6237,0,3,44,621
14,8,6,6,14,464410,221834,123,0,497
11,7,4,7,15,131244,112581,305,11634,519
5,1,4,0,12,16717,0,0,0,684
7,4,3,3,5,15153,11353,50,0,493
25,16,9,0,7,146226,0,5,930,579
20,9,11,10,15,52294,58944,294,14085,439
6,3,3,1,6,3499,15622,26,1728,597
16,8,8,3,5,109242,5918,13,1058,391
14,3,11,1,7,447,447,8,1068,515
15,7,8,5,69,168875,165624,178,6659,499
33,13,20,1,9,165449,5277,26,1710,442
8,4,4,3,7,14506,12473,3,5733,472
25,6,19,0,12,121857,0,3,1109,570
6,4,2,1,5,17450,9239,13,9239,418
37,15,22,1,16,441259,916,28,2916,485
8,3,5,0,9,128907,0,12,9239,539
47,12,35,3,19,160250,1141,137,5447,456
10,3,7,3,6,29799,534,43,545,600
8,4,4,3,8,16896,12265,36,4307,416
12,2,10,3,9,30335,21745,0,0,498
12,2,10,1,12,16930,114,47,2168,692
9,6,3,3,13,8053,7688,44,5890,444
31,15,16,9,17,542162,401214,408,213208,424
27,20,7,1,8,654214,2041,20,18060,563
11,3,8,0,10,3585,0,27,1590,499
45,13,32,2,9,164335,689,1,3616,572
4,2,2,1,6,1044,1044,0,0,584
12,8,4,4,5,291683,21329,66,1766,471
10,6,4,0,14,553496,0,3,1329,641
4,2,2,2,12,43211,9584,9,0,441
8,3,5,2,10,139444,134144,31,628,442
12,9,3,1,18,622643,2446,22,6925,597
14,2,12,4,11,11917,10888,52,3321,628
9,4,5,1,17,212715,16090,6,3928,657
22,9,13,1,9,395060,1981,2,207,462
3,1,2,1,9,6818,6818,24,0,540
28,13,15,6,11,541693,331726,0,0,487
26,14,12,7,6,350635,70802,109,19610,495
6,4,2,2,9,343852,49597,37,0,477
11,9,2,10,6,27904,39059,393,9960,451
11,5,6,1,5,97189,1973,10,0,539
9,7,2,4,5,339819,10460,59,903,451
13,6,7,4,26,297903,192370,60,0,450
17,7,10,1,10,239707,4196,0,0,606
48,7,41,1,8,244386,2379,75,0,460
12,3,9,1,20,439455,54316,26,670,487
8,3,5,2,5,3495,3495,25,3159,411
8,6,2,0,8,82355,0,0,0,685
8,1,7,0,10,5734,0,15,438,500
10,3,7,5,7,145850,129443,67,0,482
21,9,12,2,14,281254,2662,24,1464,522
17,7,10,6,13,359092,70249,121,0,443
4,2,2,2,10,38660,38660,10,28674,462
26,9,17,6,14,92811,65841,55,1813943,421
18,6,12,0,12,586875,0,2,0,617
4,2,2,1,10,966,966,13,2415,450
18,5,13,2,3,79625,3221,60,4881,411
15,9,6,0,18,359439,0,6,0,619
17,9,8,6,69,102798,60048,62,17000,525
21,16,5,1,24,2036201,224,6,0,651
35,9,26,1,10,641382,342,32,4317,486
3,1,2,2,18,364946,39415,24,0,524
25,7,18,3,9,411658,11448,125,19649,363
15,9,6,0,3,63317,0,0,657,575
11,4,7,1,8,37584,10630,24,449,539
26,13,13,9,11,272533,57486,377,18040,459
25,7,18,6,14,84539,33575,223,11548,597
8,5,3,1,5,138627,5319,17,5319,599
9,6,3,0,4,21018,0,5,178,522
9,7,2,3,7,355614,11713,19,1923,450
28,14,14,12,13,520395,91668,244,20973,439
8,2,6,3,12,23614,33012,59,18505,456
7,3,4,2,4,8250,4689,14,3144,526
3,1,2,0,9,0,0,1,0,656
17,13,4,13,5,93967,86217,149,20346,467
7,2,5,2,9,16223,4334,12,12077,513
10,3,7,3,22,9131,16932,0,0,490
38,6,32,3,16,49416,7897,36,5236,494
7,4,3,4,12,290151,10976,4,4550,456
14,11,3,9,13,126851,44331,114,13600,394
8,3,5,0,10,392416,0,0,0,704
13,10,3,6,8,344755,18601,120,14371,465
13,6,7,6,8,16868,11248,154,6636,415
29,10,19,5,22,102816,96289,129,22000,444
53,9,44,9,16,30301,5641,119,2991,504
20,8,12,6,12,27531,11406,31,2973,424
19,15,4,4,7,951251,40368,18,5601,470
6,4,2,1,7,117229,54189,21,54189,612
4,2,2,3,11,8334,8334,41,1353,459
20,10,10,8,8,52658,53736,100,13964,486
17,5,12,5,21,36064,44064,104,19379,510
24,11,13,13,24,1266970,799074,277,59672,469
5,2,3,1,14,250496,26124,24,773,497
11,6,5,3,10,496866,23489,42,13171,533
21,12,9,1,16,167477,848,25,0,675
6,1,5,1,11,14162,146,3,297,543
13,2,11,0,14,10800,0,0,3125,661
6,4,2,1,8,37849,9514,25,0,640
19,6,13,4,14,379591,47075,52,20951,433
7,4,3,0,8,12977,0,11,11194,521
15,7,8,6,3,55370,29888,128,8393,418
15,4,11,6,15,275442,32302,21,5795,521
40,10,30,4,8,195515,68789,64,0,517
22,13,9,7,6,476231,46346,0,0,459
5,2,3,2,9,14017,1173,10,0,472
13,7,6,8,7,39025,41604,426,15506,458
8,5,3,0,4,320043,0,0,0,550
8,5,3,4,8,16393,24291,0,0,528
12,4,8,1,19,17653,11183,31,8848,532
60,5,55,1,8,26529,1477,119,4537,513
14,6,8,7,14,803580,918307,166,396112,419
44,10,34,6,9,56508,12807,89,6848,527
3,1,2,1,13,19174,19174,12,19174,557
11,3,8,1,17,34513,4121,28,238,498
8,5,3,6,8,30983,32514,71,9702,445
43,7,36,0,8,48368,0,20,2711,520
20,11,9,1,18,136744,23245,25,23245,565
15,7,8,7,17,41455,51082,146,15196,391
18,8,10,7,5,26362,19547,124,5651,495
19,10,9,3,8,189058,2063,221,1796,436
8,4,4,0,13,13264,0,0,14079,629
13,4,9,1,8,195357,31828,20,5912,620
23,10,13,4,13,417135,42435,12,484,433
24,6,18,4,10,62166,54932,32,27555,446
13,10,3,3,23,349328,29539,0,1315,488
22,1,21,1,18,2329,2329,0,2333,560
21,11,10,4,14,172326,20923,57,33420,427
24,17,7,0,19,759116,0,19,810,573
17,11,6,0,12,280775,0,0,0,622
76,13,63,1,19,233052,160,2,466,683
26,13,13,0,11,2981666,0,26,24456,463
4,2,2,2,5,7615,7615,0,0,432
11,3,8,4,13,1031347,432496,45,5195,447
7,3,4,2,5,42350,42350,19,0,480
5,2,3,2,12,5536,5536,180,2100,490
212,13,199,1,12,40627,865,58,7886,556
12,9,3,5,7,158616,11254,15,6566,431
114,12,102,1,15,387952,18253,20,0,583
5,2,3,2,14,13515,13512,72,3450,493
13,5,8,5,18,136407,101700,123,4323,514
42,24,18,0,16,777469,0,8,0,628
22,5,17,4,8,203136,16787,64,3159,587
29,4,25,0,20,105571,0,1,5546,546
11,8,3,6,9,311237,63008,54,38974,426
4,2,2,2,12,11202,7620,0,0,549
38,6,32,1,17,21394,21074,20,666,509
33,8,25,3,9,385012,6540,51,6395,565
30,10,20,8,12,67199,29406,366,8427,472
26,11,15,2,9,185714,32695,22,900,486
6,4,2,2,17,327924,34448,21,0,460
9,3,6,0,7,413647,0,0,0,605
14,6,8,4,4,127734,6309,19,4214,476
36,10,26,9,11,67373,47817,183,25310,424
8,3,5,2,11,15021,2904,46,41988,522
3,1,2,1,14,1780,1780,2,1780,504
17,10,7,5,13,245507,140726,75,0,513
16,8,8,4,19,781847,304616,97,0,507
24,4,20,2,16,308283,19836,95,25997,459
6,3,3,3,19,52470,52470,74,2638,507
10,1,9,0,8,34581,0,8,0,479
10,4,6,3,6,35246,30626,39,18216,459
4,2,2,0,13,2282,0,0,10383,678
50,5,45,4,13,20458,6997,526,8773,465
24,10,14,0,9,163921,0,13,2,554
23,15,8,11,12,75482,40857,44,25163,450
7,5,2,0,7,80277,0,13,0,598
16,6,10,4,12,63553,63553,90,3720,521
20,11,9,7,15,56372,33850,89,11730,484
23,9,14,7,18,455327,135016,121,40327,492
19,6,13,3,8,26895,5708,15,2156,440
10,5,5,1,10,374064,350,4,0,555
13,9,4,7,14,458800,394085,131,115201,459
34,9,25,6,14,70246,36094,223,8608,481
24,6,18,2,12,41232,3581,60,4502,436
4,2,2,0,3,8379,0,0,264,632
10,5,5,6,6,12764,19910,149,4249,598
25,10,15,6,10,124681,27624,152,14166,451
14,1,13,1,12,26015,26015,105,26015,593
19,8,11,4,9,297498,54763,50,3125,470
5,0,5,3,6,0,44484,61,600,582
21,6,15,4,11,27605,14456,110,6761,467
13,1,12,3,15,15048,49838,0,0,560
2,0,2,0,6,0,0,1,1303,708
6,4,2,3,8,339608,5215,0,0,472
11,2,9,0,9,161568,0,5,1315,520
10,5,5,4,13,18012,37750,45,10461,452
24,10,14,2,15,135485,19611,107,8268,466
7,2,5,3,14,27137,24695,34,15595,534
18,9,9,0,14,206718,0,17,1771,545
16,14,2,4,7,240967,36971,14,21989,443
4,2,2,0,14,1000,0,6,19952,691
2,0,2,0,6,0,0,0,0,647
22,7,15,0,13,570446,0,32,720,625
12,2,10,3,12,66680,81406,104,52136,527
9,7,2,8,4,41727,55635,55,22739,435
8,5,3,5,9,17116,17116,44,7300,454
32,8,24,3,6,27921,617,55,3660,480
21,4,17,2,12,451904,23743,45,4097,453
16,5,11,5,17,52814,52397,52,27248,457
12,6,6,6,22,82373,59891,0,0,466
50,22,28,6,20,1035520,2632,222,3720,480
29,18,11,9,16,879774,150463,46,1957,415
20,11,9,6,16,85065,77933,141,23114,381
20,11,9,14,8,94118,120128,196,27564,507
22,5,17,4,12,8167,3697,89,954,451
16,9,7,2,6,20203,532,9,0,653
10,5,5,0,7,297324,0,0,0,602
8,5,3,2,7,64707,28965,32,0,609
10,8,2,4,9,160408,15885,35,329,439
6,4,2,0,7,150696,0,0,0,664
15,8,7,4,11,571685,231887,40,32001,526
8,6,2,5,9,127328,127328,133,0,624
6,0,6,0,12,0,0,1,74,652
13,9,4,0,22,15830,0,2,3196,565
11,5,6,4,10,148773,226286,77,140508,494
5,2,3,1,7,4526,4526,120,4526,553
11,3,8,0,12,1082201,0,80,0,522
18,14,4,0,9,546818,0,18,0,530
12,8,4,4,16,6564,3324,11,1262,512
5,3,2,2,6,8618,8098,57,514,529
9,1,8,2,18,802719,3990,21,2900,564
9,6,3,7,19,128300,123614,129,1931,498
21,8,13,1,9,1521371,2160,18,0,543
7,2,5,3,8,38924,39800,39,9380,539
3,1,2,0,3,1000,0,2,416,600
25,8,17,0,13,486384,0,10,612,623
170,11,159,9,21,482431,37481,242,9337,421
9,6,3,6,11,43494,56228,119,17431,513
12,6,6,3,12,447291,47653,55,45279,513
12,4,8,3,12,11481,10261,30,5075,485
26,13,13,9,40,662882,593870,126,1337,474
8,5,3,3,12,831591,51581,36,8085,446
15,8,7,6,8,37451,39380,132,12430,411
9,7,2,2,5,288877,3741,16,2024,495
57,6,51,3,17,47368,30251,67,15158,467
10,8,2,1,8,26879,2745,13,0,660
18,9,9,1,10,644904,185,25,0,503
11,7,4,2,16,122455,7015,7,434,497
11,5,6,0,13,144449,0,31,3979,484
10,7,3,6,7,43798,43798,400,38282,455
24,5,19,2,14,423206,3193,38,428,469
20,10,10,7,9,56514,53003,106,8181,464
24,9,15,2,13,565158,52084,80,8330,520
29,6,23,0,6,85585,0,10,18988,560
22,7,15,0,15,386606,0,5,0,617
15,8,7,5,3,59608,38501,4,6497,437
21,9,12,1,13,405492,4699,43,0,687
6,4,2,6,19,488738,220218,77,96467,456
15,8,7,7,9,32397,37942,49,13793,520
14,6,8,6,16,515988,93349,16,590,462
19,7,12,5,9,10377,3958,91,1272,423
17,4,13,6,6,191798,207872,76,57723,444
23,11,12,5,8,49192,6555,53,4036,423
19,9,10,9,11,42093,37106,138,12166,546
13,7,6,6,9,27215,16636,0,0,481
5,3,2,0,14,800701,0,1,0,684
15,7,8,3,3,70503,10381,56,5962,499
75,8,67,0,10,67346,0,79,4688,585
43,11,32,0,23,116292,0,1,4486,635
31,6,25,1,13,45067,4850,58,5501,440
13,5,8,1,9,10822,2941,249,2941,509
8,5,3,4,3,385630,25700,9,0,456
23,12,11,1,15,94195,4199,24,4199,564
29,10,19,1,7,147844,11234,8,11234,612
7,5,2,3,8,15967,11424,64,4456,490
11,1,10,1,10,396143,7406,6,3593,493
8,5,3,3,7,5545,14099,39,8554,533
10,8,2,0,7,25281,0,2,0,584
18,8,10,6,9,507869,29897,74,3497,435
49,13,36,0,27,662208,0,19,2913,605
5,1,4,0,10,12455,0,0,0,625
7,4,3,1,15,34835,3954,9,3954,603
7,5,2,7,8,44819,56766,110,13161,544
19,5,14,5,19,9975,10339,89,4089,500
25,10,15,7,18,55792,76923,39,21856,425
29,4,25,1,11,31491,11016,22,11016,637
8,6,2,2,8,257954,10177,45,1335,506
9,2,7,2,10,15677,257,8,227,545
20,2,18,3,9,126843,126843,50,100680,486
8,2,6,1,5,38399,38399,10,592,433
13,10,3,2,22,71807,69585,56,1702,487
20,13,7,6,8,128776,27781,65,17394,588
28,13,15,4,9,193463,4309,38,1246,446
17,4,13,1,12,9911,685,178,5967,644
21,5,16,3,21,598067,30108,0,0,517
28,9,19,7,18,182300,132255,94,2480,507
25,6,19,4,18,1293261,149464,66,33551,494
27,9,18,1,14,434805,703,31,2760,609
14,6,8,1,18,164093,7400,38,1777,455
33,6,27,1,13,107155,1587,98,8146,490
33,15,18,12,8,222916,64953,315,22714,411
17,8,9,4,13,96355,16983,90,4474,449
4,2,2,2,4,626,6440,36,0,505
10,5,5,2,6,19338,5900,33,117,522
10,1,9,2,9,11644,40474,83,0,532
15,4,11,2,11,123071,11046,47,7322,458
13,3,10,0,10,301735,0,0,0,553
11,4,7,2,11,30768,20725,44,10792,476
12,4,8,2,9,9728,6807,208,36096,460
5,2,3,2,14,9869,5729,24,4558,597
14,7,7,0,10,276788,0,2,0,500
10,8,2,7,7,30360,28889,408,10834,438
5,3,2,0,2,13560,0,8,400,572
7,5,2,5,9,29344,57296,111,27952,450
14,4,10,1,16,1386,424,69,9150,530
11,6,5,3,13,429134,28302,67,11279,403
12,2,10,0,8,68501,0,0,0,666
8,4,4,2,8,5737,5588,35,3799,565
12,5,7,3,13,29885,4196,74,2387,525
35,14,21,12,20,601261,50147,78,3450,472
26,14,12,1,22,2613346,24035,6,3287,508
40,8,32,5,10,56253,31963,38,17272,481
17,6,11,5,8,39355,14304,68,7792,414
14,7,7,6,4,69620,50429,213,15838,440
7,5,2,0,8,246085,0,8,0,525
45,15,30,9,9,111701,73948,187,2742,474
5,1,4,1,11,409,409,17,409,642
24,9,15,3,15,197282,5505,7,2284,408
9,4,5,3,7,24761,4693,160,509,535
11,5,6,0,7,10002,0,0,0,555
21,7,14,4,8,25966,4549,196,4706,482
24,9,15,6,12,84633,31629,9,7664,432
8,2,6,2,16,12298,6971,11,4307,498
20,1,19,0,8,5543,0,4,0,682
7,5,2,2,8,8115,7288,33,648,433
6,4,2,1,11,10649,8932,0,760,520
13,9,4,4,25,33286,54884,72,5253,526
19,9,10,11,7,88261,109901,307,21422,479
27,7,20,10,6,1471840,1322404,57,9782,440
21,11,10,8,27,175804,193172,191,40725,491
7,3,4,0,21,198701,0,2,0,582
29,4,25,1,12,580519,572169,36,0,617
56,9,47,2,9,39461,8750,94,5949,510
5,1,4,0,6,18250,0,11,7810,566
12,7,5,0,6,84957,0,18,0,530
43,4,39,1,8,22350,7100,26,7100,494
10,5,5,0,4,56183,0,0,0,629
8,4,4,5,9,318303,108098,31,1308,489
3,0,3,0,11,0,0,2,4475,672
10,8,2,1,23,43743,2748,46,2748,515
4,2,2,1,14,295,295,20,0,552
9,4,5,4,5,56660,48188,39,30652,437
16,4,12,3,13,10495,7255,15,2833,532
23,11,12,10,14,440314,402482,8,9894,414
26,4,22,4,7,40742,17567,140,12694,477
9,7,2,4,14,300508,805,28,300,510
65,13,52,8,16,360362,207776,409,63388,427
8,5,3,6,7,18839,17859,80,5896,442
12,6,6,6,19,486339,23156,12,6481,381
16,9,7,0,22,228414,0,4,0,596
9,6,3,5,12,124568,96307,120,53714,486
15,6,9,2,8,516666,855,67,0,562
9,4,5,0,13,26473,0,3,14121,663
18,2,16,2,15,9012,9012,31,20000,455
9,6,3,0,10,23114,0,1,0,589
11,7,4,6,14,44348,44348,106,55608,517
73,14,59,12,10,109764,93207,171,26211,407
23,12,11,9,6,61835,21834,134,8038,397
7,5,2,4,5,22549,22112,237,6824,457
10,4,6,2,9,76082,28632,47,27062,526
8,3,5,1,13,18263,17534,24,17534,637
13,6,7,6,12,62608,54172,41,20339,436
15,8,7,6,9,41701,41449,95,5405,439
11,5,6,0,11,686101,0,10,0,489
52,5,47,3,15,229768,44830,63,5237,482
60,3,57,1,11,427593,23689,29,1250,496
9,6,3,5,7,173370,172460,76,15774,442
3,1,2,2,3,4238,1189,6,775,634
3,1,2,2,8,11548,11548,8,6855,550
3,0,3,0,6,0,0,13,0,605
31,6,25,5,11,43816,29275,182,8988,448
32,8,24,4,15,30794,4952,136,6111,509
20,13,7,6,13,679331,156100,159,53961,383
4,2,2,2,8,4902,4902,5,2756,483
5,0,5,0,11,0,0,0,4266,639
7,3,4,0,5,3333,0,31,0,497
23,3,20,2,8,289318,76524,19,0,540
5,3,2,2,14,41861,21429,24,18729,544
23,11,12,6,69,744426,12225,139,2521,446
12,5,7,5,8,57445,57445,272,12625,503
11,3,8,3,8,43914,43914,65,12794,472
16,6,10,2,11,15092,13939,177,8273,424
8,6,2,6,11,54729,55404,33,12497,479
49,14,35,18,12,106445,165090,441,39409,410
14,4,10,4,7,8015,7815,53,7503,452
11,6,5,5,5,9730,25625,290,7063,525
25,7,18,3,8,69664,16416,76,775,459
9,4,5,3,5,25492,6208,23,2567,486
23,8,15,6,8,29126,24063,115,33846,477
16,9,7,9,13,106629,84843,139,27811,459
13,10,3,10,13,520662,517846,220,2898,494
8,5,3,6,7,25738,32255,213,7168,445
12,6,6,3,24,78660,1552,15,5451,458
20,12,8,2,14,1034845,5830,35,11500,592
20,5,15,2,15,93460,15054,42,12704,528
11,7,4,0,7,146640,0,1,0,596
47,14,33,6,15,751763,77265,96,27017,473
12,5,7,4,10,38020,25824,129,5713,519
62,21,41,6,16,332466,28641,27,12313,460
11,5,6,3,9,8135,8135,127,7201,509
23,2,21,4,11,3090,16251,0,0,473
19,11,8,9,14,463601,90702,140,27875,500
3,1,2,0,2,4571,0,0,0,646
33,10,23,4,19,60293,31526,70,17586,460
30,9,21,7,13,84949,73982,79,14356,446
18,8,10,3,8,355945,34685,51,1800,405
12,7,5,1,14,378232,43329,34,139574,546
11,8,3,5,8,541519,102013,56,73544,405
13,8,5,3,10,455879,7188,12,5111,520
20,11,9,1,18,1382360,435,9,0,515
16,7,9,0,8,143968,0,9,500,635
25,11,14,13,7,97166,97166,291,32004,430
18,9,9,3,12,331193,5490,55,1720,545
10,5,5,2,13,8488,8487,39,7438,473
17,2,15,2,6,19723,21425,26,10880,468
22,7,15,2,7,14215,8149,41,2625,581
10,5,5,1,8,15234,10764,11,10764,551
21,12,9,8,16,248343,166356,352,23033,445
12,10,2,0,17,94491,0,12,5122,528
28,14,14,0,15,3099631,0,20,13487,468
5,2,3,3,3,243735,99919,28,66484,451
13,5,8,2,13,158237,158237,38,95383,555
23,11,12,0,10,4693653,0,31,0,647
11,7,4,1,11,570481,3200,30,0,501
22,1,21,1,8,20155,7133,33,0,586
32,2,30,0,11,46888,0,0,589,646
12,9,3,0,12,367825,0,0,2164,651
17,5,12,1,6,22765,596,0,4553,593
28,6,22,2,13,87515,25479,46,18851,460
26,6,20,3,6,46794,20215,54,7040,630
13,6,7,2,8,7968,6396,2,4774,487
6,2,4,3,14,12653,17905,85,11403,522
10,8,2,0,6,799797,0,7,282,571
4,2,2,2,8,28531,1876,50,0,548
48,8,40,3,15,50119,18613,38,6241,424
13,7,6,6,7,1112920,851502,68,0,449
9,4,5,1,33,121191,2337,36,1660,643
8,5,3,3,9,40421,1356,82,1137,464
10,3,7,4,9,8636,14685,42,1480,454
28,2,26,1,9,36809,10920,30,10920,549
17,14,3,15,11,22309814,22352484,184,3813603,397
27,14,13,0,17,178124,0,3,1511,629
11,5,6,1,13,409353,12632,25,11240,626
6,3,3,2,11,12053,2623,39,5141,439
31,6,25,1,20,62032,3578,1,1225,556
26,5,21,3,11,105916,23239,71,14693,610
10,6,4,4,12,289138,15458,86,3875,439
29,15,14,0,10,1344595,0,0,0,641
26,12,14,3,6,399597,3453,25,3090,489
9,7,2,0,25,319456,0,8,0,713
14,7,7,1,7,331443,924,9,924,437
11,5,6,4,9,13924,19392,55,10591,440
19,12,7,2,16,992407,6574,16,2865,587
17,3,14,6,13,45927,61282,87,22079,491
10,6,4,3,19,370173,332623,59,1751,456
6,3,3,2,5,18573,4034,55,3931,477
45,23,22,25,7,196033,216314,331,46820,460
11,3,8,2,9,55507,3046,8,2108,461
54,7,47,5,9,75087,47308,37,37753,478
36,10,26,9,19,220357,442709,156,8801,429
16,5,11,3,15,14405,9498,108,4850,532
18,4,14,4,13,13052,13052,60,7180,476
4,1,3,2,8,20299,40598,23,20299,483
7,3,4,5,10,39063,45041,8,17220,506
7,3,4,2,18,416691,74251,29,45945,450
16,5,11,0,4,45326,0,3,5523,591
6,4,2,6,6,43426,30712,41,19953,465
30,18,12,5,20,1158183,37946,114,217,551
9,4,5,3,13,195562,57206,45,47217,550
26,12,14,3,10,179519,27799,67,8718,442
27,11,16,6,13,47597,20283,81,7035,473
12,2,10,0,7,10579,0,68,260,682
34,9,25,3,15,334773,17367,20,7457,536
11,7,4,6,8,484878,89952,96,2637,420
6,4,2,3,8,57014,53960,63,0,546
30,13,17,6,22,455544,149523,32,77392,454
9,4,5,2,9,101846,47585,70,44477,604
6,3,3,1,13,561180,713,0,0,564
29,8,21,5,8,79070,74377,103,25496,437
6,3,3,0,6,24186,0,25,0,576
4,2,2,2,8,628601,18547,32,17178,496
12,10,2,4,9,11016,10536,55,6330,394
5,1,4,2,13,49163,47728,0,0,638
9,5,4,1,12,455656,14885,13,14885,465
106,12,94,10,17,139981,107830,329,23040,374
19,9,10,6,7,341023,20867,196,2584,454
8,2,6,0,8,4816,0,0,0,597
7,5,2,4,8,21579,21579,291,8076,496
37,9,28,12,9,60574,60137,459,13511,427
8,5,3,0,3,71783,0,2,5063,598
23,7,16,2,13,70258,11781,21,4135,454
44,15,29,6,12,438681,198279,92,79963,496
26,15,11,1,11,419637,571,0,0,573
11,8,3,1,13,7580,877,5,877,503
3,1,2,0,3,1035,0,1,0,606
14,9,5,7,30,79594,58246,127,15140,420
2,0,2,1,7,0,28247,10,0,561
34,4,30,2,9,12870,12870,165,11307,567
18,13,5,1,15,662540,298,32,14180,486
17,11,6,8,11,575382,73472,177,20625,422
18,13,5,11,12,134856,78340,29,4580,502
17,11,6,4,12,96871,44867,88,5686,446
7,5,2,0,9,17922,0,9,2488,469
26,4,22,4,8,111956,3780683,143,551942,567
5,3,2,0,3,36669,0,0,0,584
5,2,3,2,8,444,3407,36,5051,557
14,8,6,2,7,541679,2528,25,329,491
16,6,10,5,22,543397,37729,40,15185,401
2,0,2,0,4,0,0,0,0,573
10,6,4,4,13,145467,145467,147,14542,484
9,3,6,3,7,20274,15445,14,10312,467
20,7,13,6,3,83534,56771,137,2992,496
7,4,3,1,12,310507,3373,26,1031,558
6,4,2,3,6,30690,30690,55,5944,456
19,10,9,7,10,35789,32864,62,8095,433
22,10,12,10,13,480693,496070,223,99837,382
10,7,3,0,7,182623,0,0,1147,523
3,1,2,1,14,174080,174080,6,1547,637
10,8,2,5,38,49221,44660,169,28676,442
16,2,14,2,9,8143,5497,49,2901,516
31,8,23,8,17,129972,84586,124,770807,455
45,11,34,8,11,110886,35540,31,14507,419
5,3,2,0,7,39850,0,0,0,578
9,3,6,2,13,2557,2557,64,10130,464
6,4,2,0,10,329801,0,1,0,601
24,6,18,0,12,231404,0,13,804,502
10,4,6,4,17,257575,112395,124,42595,488
13,5,8,0,14,59897,0,9,0,665
11,5,6,1,15,91193,543,25,1782,474
20,8,12,4,9,101613,18030,75,4236,487
5,2,3,0,18,257578,0,6,0,690
53,11,42,4,18,37658,41638,94,2419,593
63,19,44,25,18,927435,965241,416,86891,410
150,10,140,4,7,88121,34360,165,27464,460
28,5,23,0,11,31748,0,16,300,692
31,8,23,6,18,135637,377392,197,0,435
29,2,27,1,9,4691,1567,44,3173,525
9,3,6,0,10,98361,0,0,0,694
8,2,6,1,11,13573,4327,12,0,640
10,4,6,2,5,12761,7888,31,4619,475
8,5,3,5,7,122490,96432,71,37850,432
12,8,4,2,13,329422,657,95,512,436
6,3,3,0,7,64224,0,40,991,622
9,1,8,2,13,5130,10260,26,5884,632
8,4,4,2,5,17056,173,7,259,523
27,12,15,5,4,150065,24280,46,16503,534
30,7,23,7,6,13429,13429,561,16474,448
18,4,14,0,7,14708,0,59,290,570
13,6,7,4,9,87487,39762,83,444,523
17,10,7,2,15,477496,9325,29,19455,443
12,5,7,1,6,349926,2767,13,3075,543
28,16,12,11,33,113850,77012,194,28035,459
5,2,3,0,7,0,0,0,0,666
5,1,4,0,12,6524,0,2,1908,652
25,12,13,14,9,140712,194771,172,49748,425
8,2,6,0,6,18859,0,0,0,663
10,4,6,3,11,15730,15730,45,10427,500
17,7,10,1,13,928639,41497,0,0,484
11,8,3,4,4,217573,20401,22,751,503
14,10,4,0,13,377510,0,1,22076,517
12,3,9,3,14,720,942,51,1926,494
3,1,2,0,4,5493,0,0,0,617
16,3,13,3,18,2748,2748,57,1636,515
36,8,28,3,18,80877,6466,37,4178,453
4,1,3,1,4,12950,12950,24,12950,638
27,7,20,4,17,30859,30859,32,29582,519
14,11,3,5,11,1064056,5060,4,1010,438
31,11,20,6,13,551697,40106,47,14252,470
17,10,7,10,11,364301,115076,35,29873,455
19,1,18,1,10,9014,1273,64,1429,632
15,9,6,0,18,4745041,0,0,0,705
20,12,8,8,15,1193044,782786,183,3113,412
23,7,16,3,12,256850,4010,29,2412,482
11,8,3,7,11,469568,350150,91,128121,423
13,8,5,4,9,2026983,172762,73,0,443
27,13,14,0,6,535822,0,9,484,460
4,1,3,0,7,39397,0,0,0,634
21,6,15,5,11,112662,112662,51,96276,539
9,5,4,5,7,135998,175527,108,87431,465
10,8,2,3,4,54581,33663,174,3779,433
6,1,5,1,10,3909,620,4,1771,553
16,11,5,6,14,533216,177490,105,295,447
14,7,7,6,7,76960,78874,66,20291,442
71,6,65,2,8,35540,4070,146,7884,540
12,10,2,8,12,34269,34197,146,12554,529
24,17,7,3,15,688917,100085,79,8408,411
6,3,3,3,3,319958,12958,33,1801,464
3,1,2,0,4,0,0,14,512,468
8,4,4,2,5,9582,7391,26,5616,539
4,2,2,3,4,7325,15478,0,0,490
13,4,9,2,10,785889,26564,28,3332,624
16,8,8,2,7,137973,38136,30,5015,450
29,10,19,1,9,664825,1398,2,295,642
17,6,11,5,16,591652,69315,87,1582,434
19,8,11,7,15,307141,100634,164,46841,464
9,7,2,3,15,102568,48995,42,1390,520
9,5,4,5,10,25689,6187,85,2352,492
15,13,2,13,14,103433,102134,186,8946,412
19,15,4,8,6,315169,156899,67,95966,408
28,5,23,1,13,209030,4070,20,4070,601
10,7,3,5,4,13886,9256,84,0,457
11,5,6,5,10,387060,32578,26,11892,507
19,7,12,0,12,54836,0,37,4828,581
24,8,16,5,10,25919,16330,232,9360,475
7,5,2,1,9,214551,1084,0,0,607
7,5,2,3,13,363724,3441,18,1446,530
22,2,20,0,21,9248,0,14,1839,534
13,3,10,0,7,20489,0,4,20,686
44,4,40,2,7,38804,7819,4,6525,423
8,5,3,0,3,52323,0,0,0,637
7,3,4,1,6,26508,4710,34,4710,468
14,5,9,2,17,211074,11868,94,23531,525
31,17,14,11,17,1139856,241318,307,8665,411
7,1,6,3,7,10478,19103,46,1028,602
17,9,8,6,14,554824,28305,77,18860,446
85,23,62,11,24,1327191,83207,265,12388,422
11,7,4,5,19,2013718,1841275,114,1665237,512
18,15,3,0,7,44489,0,2,2790,529
3,1,2,1,4,47622,15498,13,0,422
17,10,7,8,11,491629,291208,148,215747,457
15,7,8,1,16,29633,32598,5,0,493
20,11,9,1,12,450341,750,17,4696,558
13,9,4,10,6,51150,47950,376,27235,434
13,4,9,5,8,27216,55848,0,0,541
10,6,4,4,20,336399,33078,80,4794,562
24,10,14,1,7,40107,28796,83,5447,500
31,5,26,3,14,396541,199682,59,19255,422
37,11,26,5,19,261571,112872,143,5400,431
22,15,7,0,13,266125,0,61,0,519
2,0,2,0,5,0,0,0,0,614
7,2,5,0,12,12941,0,0,0,707
9,6,3,2,8,328373,13796,136,7110,507
4,2,2,1,11,10761,10291,10,0,530
9,1,8,1,6,8179,8179,491,11880,510
9,3,6,1,7,108031,18391,18,0,539
76,15,61,4,9,155666,17437,278,206,446
57,12,45,5,14,295250,120217,382,39973,431
25,10,15,4,42,339089,642624,109,589,500
15,5,10,9,15,517782,378128,0,0,456
21,13,8,16,8,234187,298843,151,38787,484
18,9,9,8,27,321735,234945,85,6394,411
6,4,2,3,12,16737,16208,64,6075,426
16,6,10,7,11,23965,70230,164,13475,470
10,1,9,0,13,1155,0,0,0,642
23,5,18,1,12,637903,2765,103,2765,435
22,12,10,7,14,141962,36014,67,8812,467
9,3,6,0,9,0,0,0,0,652
10,8,2,7,6,33944,36270,48,12751,423
13,3,10,3,12,31438,31438,66,29592,543
11,5,6,1,4,83320,566,6,566,507
34,12,22,3,10,151252,2709,86,2295,494
16,9,7,2,6,247408,9575,8,7840,461
9,5,4,0,20,392884,0,13,0,665
14,8,6,8,10,813366,46661,115,11224,418
15,12,3,4,6,330423,9002,40,3759,432
8,2,6,1,10,4344,3927,8,3927,541
18,6,12,5,13,340629,83658,108,42495,499
19,3,16,2,16,26999,26999,35,14790,648
40,8,32,6,11,43791,20292,76,11967,486
21,10,11,6,11,143412,21333,59,7906,391
8,6,2,5,11,503110,117587,24,14216,446
9,7,2,4,18,174183,33163,75,6167,430
12,5,7,1,14,936262,30835,17,1499,522
3,1,2,2,11,5482,5482,9,0,563
7,4,3,2,7,24774,5183,26,4613,443
14,10,4,0,13,858380,0,3,0,622
22,9,13,10,8,168909,162653,183,5046,540
49,13,36,3,11,95701,2074,99,3225,415
28,11,17,7,9,37399,144395,139,0,454
35,14,21,13,14,96890,104108,457,22641,411
7,4,3,0,6,242675,0,0,0,634
21,12,9,12,7,203443,83017,75,30641,437
9,5,4,4,11,122607,19350,11,8692,494
9,7,2,0,9,320083,0,0,0,664
8,6,2,1,9,365550,643,12,643,520
14,5,9,1,32,340743,3000,16,0,547
13,3,10,2,10,240291,13792,45,318,507
11,9,2,0,8,78586,0,2,1239,576
15,7,8,0,7,117108,0,17,2049,513
5,3,2,1,14,293778,539,3,539,622
14,6,8,3,12,696276,8456,36,13358,447
11,6,5,3,14,134548,55488,73,26500,482
13,5,8,2,19,41477,24100,11,6669,605
6,1,5,2,4,5915,15498,14,0,590
11,7,4,2,23,17800,14251,4,7672,531
21,9,12,6,10,51585,40324,75,10452,418
9,7,2,0,8,1011399,0,43,0,613
42,14,28,3,13,525309,39583,99,3400,448
16,6,10,2,8,107043,10839,34,10299,501
14,2,12,1,14,9163,7356,1,7356,509
10,7,3,2,5,357118,8979,56,7076,497
17,5,12,3,8,20925,12789,49,6995,478
10,5,5,0,9,46039,0,38,5906,520
17,7,10,3,12,36814,28534,19,14920,486
9,1,8,1,18,44141,2310,29,1131,576
12,8,4,7,6,670848,49035,127,7693,449
6,2,4,1,21,376650,40730,6,40730,584
6,3,3,3,12,22699,22699,52,5133,470
17,5,12,5,14,39879,39879,117,13700,475
56,10,46,1,17,288659,19355,51,19355,654
5,1,4,0,8,4274,0,0,776,663
6,4,2,3,6,33518,43722,9,16255,445
5,2,3,3,16,156293,7052,18,2940,530
16,11,5,14,7,778637,970473,198,66871,423
20,6,14,5,13,52201,52200,300,27084,461
4,1,3,2,7,7235,11285,13,0,629
50,11,39,6,40,65940,64407,110,11581,433
22,16,6,0,10,838397,0,1,1049,661
19,11,8,10,11,87908,85151,175,19617,497
32,8,24,7,8,62547,55343,339,19776,522
23,7,16,4,10,209394,18103,35,10354,417
12,7,5,4,6,128383,21492,93,15644,428
20,6,14,4,13,34896,25468,155,10298,480
10,3,7,5,14,24406,29697,69,10524,482
9,4,5,1,7,71798,35566,6,132,563
8,6,2,2,28,81457,2797,2,0,698
10,8,2,4,6,50197,5586,2,2380,508
27,20,7,10,19,115320,18796,80,3477,425
22,9,13,1,7,325861,5916,52,5916,531
13,6,7,4,13,539158,57975,38,33459,452
14,5,9,3,5,46278,25574,35,5512,460
11,7,4,2,6,36551,13887,20,9614,500
19,10,9,8,13,53554,49071,77,14604,423
10,2,8,1,8,9296,9296,3,1241,554
10,1,9,2,17,3396,27511,31,10038,546
32,8,24,5,14,798337,51596,131,1310,493
8,4,4,2,7,26109,16772,149,11912,572
36,5,31,6,9,96010,161001,106,10312,422
22,9,13,7,21,102425,66861,418,26755,506
12,6,6,8,30,39102,64893,225,9373,461
24,4,20,1,13,26642,5925,193,11825,480
18,7,11,4,9,483020,52902,155,36371,478
32,13,19,9,13,176802,140153,194,13719,439
7,5,2,0,15,46998,0,4,0,603
5,2,3,2,11,50701,50701,50,320,524
10,2,8,4,9,17089,37536,86,0,509
6,4,2,3,8,345299,20736,135,15121,512
10,8,2,5,11,385095,26077,30,9953,502
6,3,3,4,8,189806,237416,50,3397,443
5,3,2,2,13,35679,31763,54,111941,544
26,5,21,2,8,25977,2943,36,1817,465
42,17,25,10,11,541810,90562,299,6504,442
16,4,12,2,12,20107,42364,16,5509,569
13,7,6,4,16,48272,5644,130,14595,499
15,10,5,13,10,526302,667008,249,221871,495
11,7,4,0,16,5402,0,0,2228,511
28,8,20,5,10,57708,16112,258,6566,454
8,3,5,0,3,4530,0,1,0,602
30,5,25,3,9,54644,24887,59,22064,538
9,4,5,1,15,18055,200,6,56,625
19,11,8,8,6,12963,10374,67,4585,497
8,4,4,2,9,9782,9782,66,0,533
22,9,13,6,16,127187,16342,40,5051,425
16,8,8,0,15,167556,0,11,8282,683
9,5,4,5,12,87566,46858,60,17156,446
17,11,6,2,18,340362,7727,108,1125,480
13,10,3,7,8,116636,349832,135,51981,457
24,8,16,1,13,33541,557,8,2200,659
23,8,15,3,13,278093,51997,52,39993,520
15,10,5,0,4,108231,0,8,171,614
8,3,5,0,6,6253,0,6,0,623
3,1,2,0,9,32669,0,3,1091,639
16,11,5,5,18,92998,96571,96,64748,477
44,19,25,7,10,195741,29509,72,10598,469
22,3,19,0,9,49722,0,13,917,672
52,13,39,0,6,311298,0,7,863,550
11,7,4,0,6,146580,0,32,0,541
8,4,4,1,18,310400,9384,28,9384,554
44,7,37,3,11,16826,8737,104,6040,506
23,10,13,6,15,68876,42032,82,19714,445
15,6,9,5,18,114802,82983,123,0,528
9,5,4,4,10,23179,22399,96,6829,394
11,6,5,4,14,406297,367534,57,262100,527
4,1,3,0,15,2134,0,9,2509,601
13,5,8,2,12,35820,18074,109,13750,633
10,8,2,2,6,374409,5131,142,2567,487
48,9,39,5,14,117278,22123,0,0,448
8,4,4,0,8,232816,0,7,625,591
21,6,15,3,14,303042,46048,24,33992,508
20,8,12,2,30,316264,23741,43,2108,503
21,6,15,4,11,64564,44199,0,0,442
10,5,5,5,11,189051,39160,66,4573,453
27,11,16,3,19,264384,13968,15,16300,554
42,14,28,7,14,577027,156120,112,111946,420
7,2,5,3,12,874,18885,72,437,508
15,7,8,7,18,29505,29103,93,12178,435
70,18,52,10,15,255980,169573,219,56211,426
6,2,4,2,6,15327,19302,31,0,531
45,11,34,0,6,136345,0,17,6335,561
6,3,3,2,6,10328,10328,40,0,640
3,1,2,0,14,0,0,0,2326,714
25,5,20,2,11,37016,19791,13,5320,474
11,9,2,9,11,194468,192511,114,54733,480
4,2,2,1,9,3750,3750,16,0,553
12,8,4,0,19,454074,0,0,0,635
10,5,5,6,19,951118,113131,33,50267,466
23,9,14,5,17,190789,152138,59,1689,571
12,6,6,3,14,359944,1492,119,6225,370
5,3,2,0,20,24423,0,10,0,603
11,5,6,4,8,17621,10757,20,4024,488
25,6,19,1,7,53392,1871,81,0,478
11,7,4,8,8,111550,51199,128,5371,415
35,5,30,2,9,34511,2210,169,18497,539
8,3,5,4,7,31950,23501,124,25180,458
5,1,4,0,9,0,0,17,0,648
158,8,150,3,6,61719,50344,0,0,520
13,5,8,2,3,134540,11461,19,12977,437
18,9,9,7,17,359172,124935,116,7355,487
13,6,7,6,10,286525,54226,116,0,451
20,5,15,1,5,15404,6585,97,6585,621
13,6,7,3,11,43612,18506,44,6359,436
6,2,4,2,7,3349,1368,0,0,532
10,8,2,1,20,541603,19965,8,19965,525
18,7,11,0,7,105414,0,0,0,663
4,1,3,1,14,9150,9150,28,9150,623
7,3,4,1,5,2052,50,63,1503,648
24,10,14,2,10,197123,2202,12,32329,562
15,5,10,1,11,71499,12260,105,12260,569
9,3,6,2,7,11593,232,158,1233,608
19,3,16,1,14,101104,1232,3,11250,526
65,12,53,4,16,85647,15195,129,7990,412
14,2,12,2,13,30122,30122,48,8930,663
6,2,4,2,8,8070,23240,57,8758,620
12,8,4,3,12,66437,36785,62,4211,462
46,8,38,7,16,53683,19398,139,5274,447
52,8,44,0,13,72305,0,4,612,619
16,4,12,1,11,27319,6052,17,6052,543
30,9,21,2,30,402683,12511,38,0,668
9,5,4,0,12,34916,0,7,0,505
8,6,2,1,15,830718,2282260,38,60069,525
42,8,34,5,30,84170,23058,227,8664,461
18,8,10,0,6,325052,0,0,0,642
10,3,7,2,8,133593,7594,27,0,545
14,5,9,4,9,28398,14400,320,5461,478
32,6,26,3,16,53007,13868,15,8954,455
4,2,2,1,14,4016,3722,25,6202,641
3,1,2,2,4,4146,12110,55,0,487
24,12,12,4,7,344392,8140,211,47885,531
79,7,72,3,9,289437,195728,37,1125,546
6,3,3,0,7,61766,0,10,0,555
8,4,4,2,28,25591,213584,0,0,502
7,2,5,1,13,31741,893,3,893,633
21,10,11,7,43,285527,51709,135,22782,498
10,5,5,5,8,12249,22504,9,6000,465
12,7,5,7,9,43729,46747,0,0,517
19,10,9,0,10,45546,0,0,0,629
5,3,2,0,69,5931,0,1,4164,596
8,6,2,4,6,354848,34427,78,12874,518
33,9,24,10,9,62208,61432,496,34563,460
6,4,2,3,6,18331,24742,52,9714,539
8,1,7,0,9,0,0,3,0,666
13,8,5,9,12,32852,41178,70,13131,436
48,15,33,9,18,88153,27576,160,6941,401
5,3,2,2,11,6955,6955,0,0,520
7,3,4,4,12,35817,53288,242,29053,494
11,9,2,1,11,565681,1085,7,1085,462
13,6,7,0,9,233931,0,7,2787,606
12,3,9,0,13,93079,0,15,3278,681
28,7,21,7,13,106906,59719,92,7952,449
7,3,4,1,9,339269,601,3,0,473
11,2,9,1,9,1697,531,60,0,501
6,3,3,3,9,450968,121929,38,1563,427
16,8,8,1,21,148101,12662,11,1630,453
16,10,6,8,7,239179,221380,0,0,464
42,6,36,2,9,206740,11673,18,6456,451
8,5,3,2,11,552987,20788,3,6284,479
9,7,2,2,11,37368,2936,30,241,470
28,14,14,3,27,1018332,11377,90,1017,582
8,3,5,1,18,11823,1747,20,1159,498
7,3,4,3,8,6758,6906,63,0,501
6,4,2,1,18,210468,1427,1,1427,627
3,1,2,0,3,3892,0,1,301,612
28,16,12,0,9,1065564,0,0,0,692
23,12,11,0,15,79783,0,0,1182,489
29,6,23,1,15,213292,1148,295,12298,522
12,8,4,7,8,126026,165964,75,0,439
11,6,5,1,8,15855,3610,100,2396,501
54,16,38,7,14,801548,53103,359,25983,438
15,3,12,3,11,18985,7975,89,5960,452
12,7,5,6,14,321018,33935,70,7577,470
9,4,5,4,9,12619,11891,27,4424,408
16,9,7,6,14,239310,39442,176,25008,436
26,11,15,0,21,32642,0,0,1262,683
6,1,5,1,7,3453,3453,8,3453,512
9,5,4,4,10,39180,20648,82,1061,534
10,8,2,6,7,445320,68106,102,27325,463
10,8,2,6,10,739908,85643,95,26742,482
16,3,13,3,9,15899,15899,106,8954,613
35,10,25,7,7,512353,272304,131,4101,424
13,2,11,1,4,5037,695,5,810,627
23,5,18,2,14,242022,9135,47,5554,545
12,7,5,2,19,62539,61821,181,4591,457
8,6,2,0,5,10439,0,1,0,509
13,6,7,2,14,1508985,276882,0,0,450
42,10,32,6,12,180829,168189,74,17040,443
58,6,52,3,12,69991,14968,19,2890,497
12,9,3,8,7,136704,103653,104,30152,442
10,2,8,1,9,206346,9139,18,0,636
12,10,2,4,8,349375,16977,28,14325,405
3,1,2,1,4,230,230,0,0,563
7,5,2,1,5,44972,6005,13,6005,406
22,7,15,5,9,63848,18726,58,2664,488
13,6,7,1,19,80002,218,19,0,621
11,6,5,0,12,54099,0,2,0,620
19,6,13,2,11,214026,4166,0,0,516
16,10,6,3,21,231427,146211,105,54063,497
14,2,12,0,8,25165,0,310,1533,576
12,4,8,0,26,79541,0,0,0,731
20,7,13,4,15,126205,26704,28,8363,436
15,4,11,0,12,44865,0,0,0,613
12,7,5,3,12,71141,11580,0,238,617
5,2,3,2,7,7180,19366,29,0,645
52,13,39,2,5,64549,1559,31,6920,469
28,4,24,1,13,115328,1139,4,4952,555
23,5,18,0,9,102964,0,33,0,518
13,10,3,8,20,448842,259838,182,12640,647
48,3,45,1,9,738,638,221,9852,551
53,16,37,8,8,65669,16416,136,4922,418
21,14,7,1,22,776975,1223,14,0,623
26,7,19,1,7,149419,6370,19,6370,462
10,4,6,1,12,586786,66728,23,0,526
10,4,6,4,17,17143,26793,51,9650,463
17,4,13,0,15,23031,0,20,0,407
26,10,16,11,4,54282,62727,217,18252,392
9,4,5,3,11,21316,18898,58,10377,445
14,5,9,6,12,1637185,329786,108,176360,446
3,0,3,0,3,0,0,0,802,641
20,9,11,10,16,30138,33570,44,7392,447
12,2,10,1,6,13359,13359,10,0,516
18,7,11,0,5,312968,0,1,0,510
8,2,6,1,8,6356,363,9,679,528
6,3,3,3,9,42019,38469,0,0,490
11,5,6,0,6,54131,0,4,0,601
15,6,9,4,16,66430,4609,21,7443,516
22,14,8,7,5,255049,26642,29,10761,421
29,9,20,5,12,119654,34536,86,15706,513
18,12,6,6,19,261700,183520,133,69634,454
7,1,6,0,18,20256,0,43,394,668
10,6,4,3,11,440848,37442,49,0,530
10,7,3,2,7,61169,3344,37,571,554
6,4,2,2,16,171928,79755,33,60923,561
9,4,5,0,7,62007,0,10,0,576
6,2,4,1,8,28604,278,8,278,614
41,9,32,0,13,72737,0,24,998,555
10,5,5,5,14,23796,38882,66,6918,546
92,7,85,1,9,102575,3259,22,11099,543
14,5,9,3,12,457629,19348,116,6588,478
9,2,7,2,16,6783,1882,43,1100,563
12,3,9,1,13,10792,5740,11,5740,526
32,22,10,0,12,3917069,0,0,0,645
34,8,26,9,15,1285231,1742656,153,657202,443
10,6,4,6,13,71550,54966,152,0,499
16,8,8,1,8,392564,4072,104,4072,586
4,1,3,1,6,4018,457,2,733,547
8,4,4,2,7,10097,10097,239,7712,543
18,10,8,5,19,273317,51892,80,24303,497
36,8,28,6,11,35264,24541,248,14520,451
9,4,5,1,15,167353,640,18,597,481
12,7,5,0,4,58504,0,7,5056,466
46,7,39,3,19,54330,20964,70,8383,454
8,4,4,4,6,80241,52962,55,0,569
75,17,58,6,15,222979,27557,149,7192,460
16,6,10,3,13,1302724,605947,40,576,575
8,4,4,6,14,228863,398032,143,122735,575
6,2,4,0,12,9524,0,0,0,647
7,3,4,1,10,8227,1272,2,5527,474
30,20,10,10,6,41913,24903,27,4815,423
109,14,95,5,14,185393,146760,57,24393,517
15,4,11,2,7,209411,1812,3,1028,531
51,9,42,2,12,52081,16980,36,67250,482
8,6,2,2,9,69368,3199,20,630,469
19,13,6,0,5,104225,0,4,50,470
102,13,89,9,11,303236,137578,229,20174,444
6,2,4,0,7,928,0,5,0,631
25,11,14,8,10,20321,20321,85,43330,473
4,2,2,0,4,328110,0,3,0,599
22,14,8,1,20,736139,248,22,291,512
25,8,17,7,9,107685,50627,141,1635,498
21,8,13,0,6,454388,0,21,0,536
16,5,11,5,6,38805,38805,203,15800,500
107,24,83,9,14,979611,65124,299,16480,378
9,6,3,3,4,87093,9281,33,0,514
10,3,7,0,6,0,0,16,0,582
6,2,4,2,6,5441,5441,190,4112,475
16,9,7,6,10,63603,56310,376,21602,417
44,10,34,8,13,386251,35467,260,6708,455
11,7,4,1,26,975177,17977,26,17977,662
14,6,8,0,9,40025,0,0,1623,562
4,1,3,1,9,6691,6691,23,4778,570
14,11,3,6,24,209075,121675,76,383,522
19,5,14,1,17,382227,22215,47,22215,523
48,9,39,6,13,95648,85954,202,46765,430
17,8,9,1,4,424304,5661,24,5661,464
11,7,4,3,7,30338,20797,15,8284,499
14,10,4,9,15,33227,33227,124,10196,486
3,1,2,1,7,0,11384,7,0,663
131,4,127,1,12,32803,11326,25,0,512
13,6,7,1,7,42592,31,6,497,579
13,6,7,0,8,1417002,0,16,1366,639
15,13,2,6,16,599374,176026,93,0,480
6,3,3,3,9,19732,18949,33,3306,508
6,4,2,1,20,1754,494,10,10326,539
28,6,22,1,18,82314,5150,42,7401,432
21,9,12,1,17,357432,117644,7,443,528
46,14,32,2,11,373109,12157,0,0,595
9,1,8,1,7,23354,4026,39,9008,558
3,1,2,1,11,5000,1250,5,3333,525
7,4,3,2,8,31864,17758,37,10184,493
37,15,22,4,15,191802,45927,113,16377,413
2,0,2,0,3,0,0,0,0,623
12,4,8,2,13,110310,148162,52,98775,509
16,2,14,0,10,194518,0,1,1265,671
16,8,8,1,28,131798,25542,85,1543,472
18,9,9,2,12,338540,5645,26,2844,532
7,5,2,6,9,10584,13392,26,3928,544
4,2,2,0,14,6980,0,10,0,649
9,5,4,4,13,8728,13291,52,736,527
10,8,2,2,11,185079,3365,2,265,604
5,2,3,2,7,122618,11953,37,11026,500
6,2,4,1,15,6492,1402,18,2795,641
19,11,8,12,5,130689,134685,139,18895,371
25,13,12,7,10,158192,52196,179,40890,423
12,4,8,4,17,21702,17542,66,13161,543
15,5,10,7,6,25680,41236,153,6045,457
14,9,5,2,14,456616,2977,29,0,528
24,12,12,5,8,340865,65678,24,14196,478
8,4,4,0,10,0,0,37,0,520
10,7,3,4,12,164275,8508,48,1617,474
18,13,5,13,12,503394,325209,90,196437,381
11,4,7,3,14,53008,53007,24,23238,514
17,5,12,6,15,321324,549041,18,299928,492
60,29,31,17,13,1182066,205238,286,23360,333
11,4,7,0,16,243,0,4,0,694
9,7,2,5,19,97264,70181,80,42219,452
9,2,7,2,17,23047,23047,47,17215,627
17,7,10,3,9,531399,91545,93,0,518
14,7,7,4,19,208138,81220,0,0,453
11,8,3,4,5,64929,29127,45,0,440
17,4,13,1,7,33758,5594,15,333,633
9,3,6,1,9,1547,10089,14,10089,675
12,6,6,4,10,275916,6476,29,0,491
10,8,2,6,7,55969,27550,162,9240,449
11,7,4,1,15,5532,1350,35,1350,636
19,5,14,1,7,12116,11456,24,11456,548
5,2,3,0,9,27604,0,7,1907,624
13,6,7,3,7,46324,10205,58,7002,557
32,14,18,9,6,74558,57494,100,42271,395
21,11,10,0,10,732770,0,1,348,595
11,9,2,6,5,54460,10394,35,4693,423
30,5,25,4,14,167149,8562,188,10651,481
17,9,8,8,7,39581,58780,306,16390,434
31,5,26,0,16,497415,0,4,3236,515
14,6,8,6,7,230811,60473,95,0,439
36,15,21,6,9,286210,56035,196,11686,424
8,4,4,2,15,30075,184,30,9128,531
4,2,2,1,6,3475,3475,145,3475,548
16,9,7,0,13,582949,0,4,4070,677
10,2,8,0,7,28046,0,26,0,516
20,6,14,6,5,54869,23257,111,8819,477
22,10,12,10,20,253206,349799,38,56209,453
9,6,3,6,12,172612,123639,112,1086,457
19,10,9,5,26,396342,259924,129,603359,558
17,4,13,2,9,4318,8856,18,8792,607
4,2,2,1,8,4649,4649,21,8410,431
19,7,12,5,13,163830,153561,91,15261,491
16,5,11,2,8,13153,3231,49,5744,533
11,2,9,2,13,9442,9442,95,7145,504
20,7,13,2,21,25770,104903,18,29418,437
35,7,28,5,6,36446,36446,372,22110,476
7,2,5,1,7,1828,1238,22,4295,575
10,7,3,1,16,256894,20771,11,21071,557
20,6,14,2,9,10554,3648,34,3175,581
30,9,21,5,17,444660,92405,34,17172,498
24,5,19,7,28,411712,318482,78,5955,510
9,5,4,4,12,90764,31747,38,19155,494
16,10,6,8,7,78819,22016,155,13590,406
12,4,8,4,5,16594,16295,66,11576,469
14,7,7,4,8,116568,60064,49,21975,450
5,2,3,0,17,4400,0,1,1500,495
4,2,2,3,11,58674,45241,24,17251,480
18,5,13,0,8,27739,0,129,2674,557
49,5,44,1,6,76441,30388,10,30388,511
14,10,4,8,8,38233,31629,65,7699,428
204,5,199,0,9,885878,0,16,0,675
24,8,16,1,3,172904,2114,14,5680,522
13,11,2,4,4,103193,16725,87,7607,440
27,7,20,1,13,183216,23911,50,13957,516
12,7,5,6,7,37983,12380,44,1224,503
8,5,3,6,7,74835,103978,92,7568,451
9,6,3,1,10,2653,1667,9,1716,470
13,5,8,0,26,908920,0,14,0,610
10,8,2,0,7,21229,0,0,0,626
20,12,8,0,8,82824,0,43,778,595
9,7,2,1,17,275479,674,0,0,568
25,13,12,7,17,1169075,316992,75,0,449
30,2,28,2,10,13056,13056,49,6800,513
13,5,8,5,13,60227,59618,180,47419,380
12,9,3,8,6,43275,45502,108,9163,442
9,5,4,7,12,21899,54421,92,9066,392
22,10,12,3,19,566005,22479,45,18733,488
9,1,8,0,5,18538,0,0,0,624
5,2,3,1,8,14666,5613,24,5613,552
50,15,35,9,12,449929,340695,527,25897,398
5,2,3,0,2,823807,0,1,0,643
34,4,30,2,19,573137,175454,29,3280,498
13,8,5,4,6,13908,6741,66,438,453
28,12,16,11,8,143500,83470,31,30321,471
16,11,5,2,5,99948,1369,38,473,447
15,5,10,4,12,31811,27625,9,1313163,472
24,8,16,8,21,250190,357741,134,0,470
9,2,7,0,13,0,0,7,0,653
12,2,10,1,11,4353,4353,27,4353,509
4,2,2,1,16,543889,28496,32,19208,570
9,7,2,5,12,272064,36697,62,17964,466
38,10,28,3,11,322072,22631,231,5638,447
5,2,3,0,13,335,0,0,1530,699
23,5,18,1,20,892,892,157,9920,462
7,3,4,6,5,73606,108847,99,0,530
32,5,27,2,9,23669,533,58,1888,607
10,4,6,7,8,48503,87975,167,0,528
43,9,34,8,15,86510,120491,254,36022,464
24,10,14,10,10,133619,57579,245,6245,420
7,5,2,6,5,10961,13756,77,10301,429
10,8,2,9,6,14521,19748,140,6972,538
8,6,2,5,6,45591,45591,216,17500,475
9,3,6,2,12,24819,12584,55,1250,549
42,11,31,5,12,230871,38827,56,5064,497
11,9,2,3,9,62640,6126,26,4856,489
29,14,15,8,16,114882,31507,204,5640,535
15,8,7,1,18,99118,267,23,873,470
7,2,5,3,12,301034,535822,21,277050,540
3,1,2,1,14,8082,5525,25,0,564
9,6,3,3,4,378743,34334,34,0,480
20,6,14,8,12,45367,45367,92,6737,469
7,4,3,5,5,41630,41630,85,28748,487
7,4,3,1,10,103817,2370,2,0,531
18,12,6,7,13,383331,83926,125,0,507
20,8,12,4,10,226760,124785,51,64836,481
48,16,32,14,10,151423,63116,188,7737,420
10,4,6,2,11,21988,10205,26,0,528
12,5,7,7,12,26434,52399,99,14635,415
34,18,16,3,9,701347,12431,0,700,552
7,4,3,2,20,423650,2082,33,2817,488
10,7,3,7,7,67787,67787,86,25992,449
20,11,9,4,17,130902,10594,62,4960,512
14,11,3,1,9,686852,1461,20,1461,606
21,6,15,3,14,30150,4407,170,1464,471
23,6,17,5,28,74016,4256816,200,45729,503
5,1,4,1,2,0,14370,11,1000,459
26,7,19,1,17,342229,5319,6,11456,519
9,6,3,2,5,124270,2172,70,1648,472
8,6,2,3,11,212717,24205,106,12108,559
6,3,3,0,8,41756,0,0,0,636
11,7,4,2,8,1000046,26319,47,0,509
17,6,11,4,14,261212,3920,50,1860,532
12,2,10,3,10,11741,20779,16,7479,440
17,8,9,0,9,441947,0,2,0,614
8,5,3,1,13,56468,3742,4,0,489
13,7,6,1,5,58060,12176,28,66721,499
16,5,11,3,8,167379,245622,56,129929,445
7,2,5,2,9,9389,26332,60,3583,491
22,8,14,9,9,78017,70913,144,18860,487
16,6,10,4,22,322599,74546,59,0,485
14,8,6,5,6,27617,34718,163,12944,620
7,5,2,1,20,7098,6783,0,0,496
15,12,3,0,5,130336,0,3,0,591
11,8,3,7,7,35686,16828,45,5400,414
77,4,73,2,5,26697,11943,26,6781,482
8,2,6,1,8,5510,2147,5,2146,556
4,1,3,2,14,5879,9334,16,6463,584
18,8,10,0,9,40470,0,4,0,633
25,10,15,4,17,320997,6665,12,1293,539
11,3,8,2,8,8785,8785,34,5774,530
14,4,10,1,2,96350,4241,14,0,543
6,3,3,1,12,18569,3480,6,240,607
11,2,9,1,7,4724,1708,121,2215,577
4,2,2,2,5,355040,14609,9,14295,553
14,10,4,0,14,49023,0,1,0,685
4,1,3,2,14,6753,3841,12,2915,620
15,6,9,5,11,46109,44276,197,25324,435
31,6,25,6,13,219390,42248,50,1206764,458
27,12,15,2,8,161943,200,52,1066,470
6,2,4,4,7,17898,32017,56,9127,535
12,5,7,6,7,82516,82516,37,20003,495
14,6,8,0,10,4964,0,29,7059,603
17,4,13,0,6,40683,0,0,409,683
17,8,9,6,4,44568,24150,221,11879,455
23,8,15,6,18,381827,52853,29,16557,453
5,2,3,0,4,182691,0,23,0,629
34,11,23,9,9,180661,158238,34,12661,536
9,6,3,4,8,211653,211653,97,161280,495
14,8,6,6,8,457532,23928,31,11530,411
3,1,2,1,7,0,3588,0,0,662
29,16,13,5,20,247968,38025,83,3353,480
6,2,4,0,8,27422,0,11,660,625
24,13,11,7,14,420991,13685,5,2882,498
18,7,11,1,11,120487,971,2,971,463
28,12,16,1,7,2377186,1889,5,0,614
23,13,10,1,17,711876,3963,21,3963,658
9,5,4,0,13,129426,0,0,0,626
14,6,8,1,7,363767,628,98,3550,493
20,10,10,6,10,469702,150187,101,108418,435
27,11,16,4,27,322100,950,53,611,493
7,4,3,4,9,37136,26053,53,6635,444
5,3,2,2,3,9638,2980,19,2705,468
16,4,12,2,15,63750,30658,92,11030,466
28,4,24,3,13,46586,46586,45,6999,481
32,15,17,0,19,1699254,0,0,0,628
29,9,20,2,9,80963,8122,119,1183,466
44,10,34,2,16,99556,17488,39,16458,428
7,3,4,1,14,32667,8009,24,8009,560
3,1,2,0,10,0,0,0,0,699
15,7,8,7,8,66707,66457,89,21084,369
7,1,6,1,12,130533,129746,21,0,547
8,3,5,1,9,22197,12326,34,484,445
23,4,19,3,21,24597,16874,21,13901,502
53,6,47,1,6,77058,1139,3,7026,576
5,3,2,3,6,11787,11787,61,4520,508
25,4,21,5,14,14746,17744,41,12300,448
11,7,4,4,6,17622,6655,45,4507,502
59,13,46,0,18,1196853,0,12,598,689
53,22,31,7,19,322611,13243,104,4245,480
23,8,15,3,12,162132,75039,90,50578,403
21,6,15,7,7,83553,70049,91,29472,430
80,4,76,2,10,14255,9948,26,5929,488
10,6,4,3,11,37156,28071,51,43887,492
11,6,5,5,7,6155,30424,75,2998,582
3,1,2,1,9,3142,3142,11,3142,581
6,3,3,1,8,10453,10453,104,10453,521
5,2,3,2,18,12365,6798,26,0,549
28,14,14,3,9,658290,25390,52,0,450
15,6,9,5,10,81168,34124,67,1092,472
9,7,2,2,4,27007,1332,2,227,455
22,8,14,2,7,33625,5359,51,5172,514
47,5,42,0,11,152729,0,7,0,603
9,5,4,0,16,342655,0,5,0,498
37,15,22,0,20,3595126,0,3,0,646
19,8,11,8,8,64607,85271,128,2650,461
11,7,4,5,12,30864,7805,86,2475,496
29,6,23,5,8,54504,54504,97,22114,428
4,2,2,2,8,12154,12154,16,3585,552
28,8,20,4,11,35423,18961,146,8440,502
3,1,2,0,6,0,0,13,0,638
14,9,5,11,8,81057,92169,57,14720,437
12,5,7,2,9,156702,1772,26,0,572
55,13,42,0,11,128190,0,156,9061,391
7,1,6,0,14,620650,0,0,0,626
26,11,15,2,16,191489,3098,3,1642,576
4,1,3,1,11,130509,75590,39,0,493
16,10,6,3,9,118320,12235,30,440,545
13,10,3,0,22,734184,0,7,0,689
35,11,24,0,6,108208,0,12,6316,565
14,6,8,2,7,330002,13125,192,12375,477
9,5,4,2,8,258703,5684,11,1113,502
52,17,35,8,15,314977,21826,134,10448,460
8,4,4,1,5,390493,1993,40,3591,496
11,6,5,0,16,222612,0,4,40,577
25,16,9,4,16,5754613,48176,0,381,512
3,1,2,0,15,9590,0,0,850,680
14,2,12,2,9,9529,24909,0,0,519
42,8,34,0,18,296190,0,302,10316,515
5,3,2,3,6,22277,9629,50,6110,502
8,6,2,5,7,71538,58070,52,0,486
30,8,22,9,7,34287,29376,134,9347,420
6,3,3,4,15,9460,9460,81,2826,644
9,3,6,1,18,19645,2980,24,9076,449
25,5,20,6,18,222057,57543,158,16605,469
50,19,31,0,20,488771,0,22,780,571
23,19,4,1,16,1340856,17337,29,17337,506
35,15,20,7,8,280378,37837,175,7650,483
48,13,35,10,14,118676,116516,202,29436,419
7,0,7,4,5,0,123428,84,0,494
10,6,4,2,11,163446,62489,29,118,485
6,3,3,1,8,138129,10354,11,10354,572
9,7,2,2,18,93247,3269,3,494,544
16,10,6,6,6,37493,29133,348,9735,418
29,1,28,1,6,3090,3090,56,3090,549
25,9,16,5,14,350875,290788,72,0,677
4,2,2,1,8,70798,66691,0,0,516
8,6,2,5,8,397089,42025,76,11117,437
10,5,5,0,6,1246,0,12,239,651
10,7,3,7,9,42715,42715,436,15526,466
22,4,18,2,7,228532,6148,19,9327,469
87,8,79,8,14,124494,125279,200,49136,439
23,7,16,2,21,210997,13031,73,11412,501
5,2,3,1,13,4216,2124,2,2124,643
21,10,11,0,11,972919,0,12,0,478
5,2,3,0,5,2074,0,18,4343,576
11,5,6,2,69,359132,80129,26,66080,488
5,3,2,0,10,22007,0,23,8502,588
22,9,13,8,8,89466,75628,304,17856,470
12,5,7,0,15,145239,0,7,0,687
7,3,4,2,7,418952,15041,101,13818,532
15,5,10,2,6,43083,481,139,584,527
16,10,6,5,9,138648,28377,22,15788,442
248,17,231,11,15,283565,107383,115,59380,401
11,5,6,3,9,309502,26238,212,22679,468
15,7,8,4,20,54530,6436,36,3237,429
17,11,6,5,6,39796,38875,91,15560,506
20,11,9,9,11,655928,364471,80,12037,431
13,7,6,2,8,89457,1727,7,953,421
6,4,2,3,6,6126,21843,42,730,485
20,9,11,11,10,80097,113808,123,52919,485
57,11,46,7,12,275266,52496,276,33366,427
14,5,9,6,8,39259,60431,167,32707,416
14,1,13,1,7,2895,3400,11,0,642
7,5,2,4,8,37337,15774,82,9217,452
17,5,12,3,11,121743,68049,52,21005,441
11,5,6,3,14,46675,43035,51,28620,463
12,7,5,0,13,299191,0,6,1060,673
15,11,4,1,6,307110,2048,23,0,541
6,4,2,2,7,17064,17257,0,0,514
36,3,33,0,16,51998,0,19,1698,581
12,4,8,1,13,21238,6873,32,6873,528
25,11,14,6,11,702795,60302,111,3992,455
9,7,2,1,25,235526,7917,6,1994,494
14,8,6,0,11,319645,0,4,4382,495
24,10,14,4,9,504505,15109,75,0,524
8,6,2,2,9,23024,10374,23,861,544
15,5,10,0,12,40170,0,36,700,589
26,8,18,2,7,43822,1607,82,1633,470
19,6,13,1,9,194348,9029,168,1125,486
6,4,2,5,8,9933,14021,63,1554,459
14,3,11,2,23,559610,26369,51,1932,498
14,2,12,2,10,6714,9312,38,13581,511
10,5,5,7,8,33222,20637,101,8559,486
6,4,2,3,11,237172,13770,35,9452,522
6,3,3,2,6,18880,10180,95,7358,478
16,12,4,1,31,249878,2422,24,3567,538
21,5,16,0,8,182018,0,3,0,637
12,9,3,5,9,354995,35434,5,200,517
10,2,8,3,9,24153,13355,55,34873,612
13,3,10,0,10,537573,0,1,0,558
6,3,3,1,17,554,554,2,554,572
37,9,28,3,12,46074,6929,98,3086,481
20,9,11,1,16,216542,6572,0,0,489
17,7,10,3,15,68487,7746,66,4974,568
12,5,7,9,10,96366,187751,183,65022,444
9,5,4,2,7,9506,9506,24,8486,477
39,16,23,20,20,727300,2015436,265,333083,367
5,3,2,1,5,2400,900,1,900,488
41,9,32,8,13,267346,197824,2,5087,470
8,5,3,5,6,24237,15600,18,5400,446
32,19,13,0,15,387675,0,8,12375,572
8,3,5,3,17,460087,460087,37,27992,501
28,9,19,1,13,131034,5072,4,2800,677
8,4,4,3,4,28750,7832,284,5025,518
8,6,2,0,4,33510,0,16,244,606
3,1,2,1,9,9666,9666,14,9666,569
8,6,2,0,7,256870,0,0,0,679
9,5,4,5,4,19808,7280,35,2724,456
9,5,4,1,7,216630,5863,4,0,634
21,14,7,0,22,579394,0,1,0,560
16,6,10,5,15,34066,23394,2,1750,521
15,5,10,2,14,189463,65524,68,1419,469
8,6,2,6,7,32842,32842,64,12020,494
5,3,2,1,6,15902,4317,22,4317,457
26,8,18,1,15,631565,16622,208,1473,474
19,8,11,7,15,27831,30488,217,1384,459
5,3,2,1,4,185947,3352,3,0,644
9,6,3,4,11,6803,8733,41,5037,497
20,10,10,0,12,717716,0,44,0,477
13,2,11,3,8,63352,17437,33,1290,525
10,7,3,8,18,82414,82414,148,10309,503
55,10,45,5,8,271646,31168,146,813,537
8,3,5,3,11,21246,20965,29,5295,487
60,29,31,19,22,289409,143553,292,10322,443
6,2,4,2,8,2497,1627,4,900,609
13,5,8,3,12,48340,23948,58,13890,525
9,7,2,8,6,34314,42368,134,5125,465
29,7,22,5,15,727199,65262,382,8326,481
25,8,17,0,14,126056,0,20,1190,673
9,7,2,4,9,116565,27704,31,217,448
57,13,44,3,14,3750767,368887,33,28778,469
27,5,22,3,9,352092,67843,7,1385,450
12,4,8,5,9,122774,122774,98,29420,411
15,9,6,4,13,234451,16120,62,6083,419
4,2,2,1,5,170769,14354,16,0,549
70,20,50,22,12,301062,284992,461,14280,381
34,9,25,5,6,682884,287109,127,109024,456
9,6,3,0,12,240353,0,6,211,519
11,3,8,4,11,18053,18038,205,5542,449
16,5,11,7,7,72015,68644,183,6593,535
24,6,18,3,9,55389,29699,87,6450,455
16,8,8,8,13,185472,149924,89,60083,425
7,4,3,3,9,5068,4329,36,5051,530
6,3,3,2,7,12702,12702,0,0,536
7,4,3,2,6,307913,25856,0,0,447
17,8,9,3,5,45867,15593,283,8046,506
14,4,10,0,13,444,0,18,1374,517
24,9,15,0,14,368087,0,1,0,589
26,7,19,5,18,594052,209955,116,34668,455
16,11,5,3,6,623614,93303,138,20821,414
53,14,39,8,14,108300,43073,131,16265,435
17,3,14,3,8,4804,8906,67,4397,478
35,18,17,7,25,475266,44173,66,3142,446
29,8,21,7,11,294517,47275,275,11210,458
20,13,7,0,7,56066,0,1,0,654
9,5,4,5,5,15477,15477,68,9701,392
14,10,4,0,69,439765,0,14,166,607
7,5,2,2,15,14445,8394,44,392,524
17,12,5,4,13,84603,2751,38,923,545
14,6,8,2,10,262977,10195,60,0,454
6,1,5,0,6,0,0,0,0,639
33,12,21,6,13,51358,14300,78,8874,577
15,5,10,1,9,115828,252,12,0,598
16,12,4,11,9,369066,81844,174,35647,426
9,4,5,0,24,26684,0,2,0,719
20,13,7,1,13,417339,7840,16,7840,555
9,4,5,1,14,17651,4442,12,9705,554
15,3,12,2,8,23650,23647,24,19337,510
5,2,3,1,6,15849,15849,25,15849,620
9,4,5,0,10,493007,0,0,0,727
19,4,15,3,19,262393,24224,128,13848,544
15,7,8,8,16,316085,133856,129,27780,495
191,6,185,1,6,335155,2166,137,2166,534
19,9,10,6,10,294767,91492,82,22390,465
42,20,22,18,13,175770,169654,219,33469,468
8,6,2,4,7,343410,38396,19,10792,396
24,9,15,6,19,261685,71123,120,24000,518
12,9,3,8,13,427780,60549,84,23667,346
22,14,8,8,17,545470,52062,114,1046,443
6,3,3,2,13,4123,4123,0,0,558
19,9,10,0,12,866222,0,1,0,613
17,3,14,1,9,29637,1401,52,3490,592
13,4,9,3,13,6513,6513,53,3290,509
10,6,4,0,15,159197,0,24,2610,503
8,5,3,2,6,7262,890,12,0,545
52,9,43,2,17,243227,58733,289,30237,473
21,4,17,3,13,301726,66576,58,867,526
20,9,11,1,22,115219,13518,58,13518,551
13,8,5,5,21,22552,12116,62,4934,476
13,8,5,0,4,108882,0,3,1667,622
14,6,8,1,12,561100,813,27,1216,443
14,11,3,0,10,2402595,0,0,0,510
8,2,6,0,15,9731,0,0,1125,658
5,3,2,3,7,17155,20923,129,7621,472
9,2,7,3,13,53512,49550,20,2754,427
14,10,4,7,6,594290,83139,126,14700,425
6,2,4,2,7,22763,11859,34,8671,478
7,4,3,0,6,8942,0,0,0,454
4,2,2,2,4,340377,15034,7,1428,511
6,3,3,1,2,17561,5136,2,5136,513
9,5,4,5,3,10449,7302,38,3020,425
12,5,7,2,10,38565,371,76,682,585
13,6,7,2,11,216584,5267,49,9096,547
11,5,6,6,5,438433,87498,68,6788,449
24,10,14,1,20,282686,9631,50,29842,474
7,2,5,2,3,3664,3664,26,3597,534
42,8,34,7,8,72420,53753,249,15163,540
10,6,4,0,19,53611,0,1,0,567
10,4,6,0,9,2229,0,6,531,604
23,11,12,7,6,76634,23217,56,5707,491
12,7,5,3,7,157314,37326,63,0,531
26,4,22,5,69,7471,9549,72,6845,469
57,8,49,3,11,154279,12199,115,12043,457
27,1,26,0,4,1000,0,11,0,639
4,1,3,2,8,0,24774,50,0,541
24,5,19,7,8,44665,48854,274,15190,469
7,1,6,1,10,0,10418,37,0,632
22,9,13,7,8,99789,83654,94,45951,382
192,17,175,0,17,251771,0,4,12427,611
14,8,6,13,7,17546,122515,170,2547,442
10,5,5,2,11,74344,21874,0,0,517
12,4,8,3,18,12844,7172,0,0,491
17,5,12,2,12,15196,13168,63,10084,489
43,6,37,5,16,114740,51317,453,11379,473
23,13,10,1,14,299544,3652,38,3652,463
13,5,8,5,14,58325,58324,107,75564,430
5,3,2,3,9,126155,76557,0,0,510
9,5,4,6,19,17946,21320,24,5887,472
14,5,9,2,15,43060,22544,32,4632,459
35,17,18,9,16,701270,65201,124,6030,430
10,6,4,2,17,15042,2275,13,1733,563
5,2,3,3,7,14166,14166,33,5344,548
12,8,4,8,6,306951,18617,435,8409,429
12,8,4,4,11,7075,7075,25,3705,524
11,8,3,0,10,294822,0,4,0,563
9,6,3,5,6,19116,19439,320,8568,504
5,2,3,3,6,11577,12831,94,11735,555
10,6,4,3,20,92753,20067,55,2053,469
42,3,39,2,9,20048,8323,25,6900,528
58,20,38,0,21,5435185,0,8,1659903,573
11,8,3,4,12,262225,5913,67,1071,474
10,6,4,5,16,109551,104243,73,53520,430
5,3,2,4,8,16510,22625,38,11886,478
10,2,8,3,4,8532,16035,81,7503,483
10,4,6,1,8,5404,2361,46,3352,441
7,3,4,2,16,286389,8398,47,6340,428
8,5,3,3,5,274481,5524,67,3690,562
4,2,2,2,10,7116,6925,16,5453,550
15,13,2,14,6,45306,52140,210,7201,476
27,9,18,0,11,988670,0,38,0,564
36,15,21,0,22,792057,0,67,360,577
13,5,8,2,8,61753,66337,37,0,617
13,9,4,7,5,39494,49488,440,11400,437
5,1,4,2,9,6117,5655,18,4732,454
3,0,3,0,7,0,0,0,0,617
47,6,41,4,11,15782,28289,139,4384,497
9,2,7,2,5,3898,3515,55,2822,549
61,13,48,7,22,305067,83941,100,2534,523
9,5,4,5,12,30711,31076,62,27729,608
6,3,3,1,6,19823,1719,7,2988,451
18,9,9,2,19,108436,8669,27,7230,492
21,10,11,2,8,128190,7280,26,5086,559
5,2,3,1,5,65672,693,12,0,632
11,2,9,2,9,531597,55306,46,11334,603
11,7,4,6,17,126599,40630,47,11146,438
13,9,4,2,11,121084,3369,51,4957,523
14,5,9,4,12,551592,15163,26,533,433
5,3,2,0,14,4553,0,2,0,688
11,6,5,0,23,348,0,1,64,590
11,5,6,3,13,843057,46604,59,38925,522
17,11,6,10,6,194640,194640,184,1384,490
35,9,26,5,7,35612,10061,52,5500,421
14,10,4,5,3,102641,95313,53,46875,478
35,11,24,4,12,67044,3374,13,5602,594
12,10,2,7,14,289487,77497,99,18070,434
14,6,8,6,16,334296,19022,74,13700,521
25,6,19,3,6,74976,48801,72,0,517
2,0,2,0,14,0,0,0,0,668
6,4,2,2,28,20309,13478,5,11756,519
27,9,18,1,21,676668,10396,41,10988,499
16,5,11,3,11,361365,19246,25,5682,405
30,17,13,12,22,195873,155917,126,903914,433
5,2,3,1,10,5480,1812,15,204,557
13,5,8,2,14,835473,27980,16,21630,471
22,11,11,11,10,420764,41863,198,4962,498
12,10,2,9,13,1061369,259334,60,43439,423
11,1,10,0,7,0,0,0,0,618
36,17,19,13,16,185011,104081,378,65966,333
8,4,4,0,13,50484,0,1,0,697
34,7,27,7,8,72402,70164,104,19784,462
12,8,4,2,10,8939,3870,55,388,463
14,3,11,1,6,5412,155,112,3820,591
24,9,15,7,15,45763,42174,85,21220,485
19,11,8,6,13,625340,103357,44,6517,494
42,12,30,6,9,117189,103551,181,381,462
24,9,15,2,9,63951,7438,0,0,460
7,3,4,3,9,29677,38067,3,19168,528
10,2,8,2,6,16759,16759,29,3530,467
18,6,12,4,12,1079320,544631,115,1460,463
65,4,61,1,15,503929,9077,12,2356,568
3,1,2,0,9,2170,0,0,0,656
30,3,27,1,8,11473,930,11,2529,572
8,2,6,0,5,10497,0,5,0,613
26,5,21,4,8,365949,6468,48,10881,505
6,2,4,1,9,13932,2133,3,2133,597
23,7,16,2,18,162552,988,15,947,626
7,5,2,6,13,88331,114947,0,0,502
15,7,8,2,12,305066,9473,30,812,450
9,3,6,0,15,2348,0,0,0,717
32,9,23,7,11,314059,28411,67,7080,438
18,7,11,1,18,567196,35906,25,12271,674
8,5,3,6,5,5785,14361,10,1509,426
6,3,3,3,9,13300,14724,36,6847,551
8,4,4,4,13,5463,5463,10,2109,405
23,10,13,0,14,128631,0,1,2505,649
18,7,11,4,9,24286,59311,95,2985,539
38,9,29,4,14,38554,23974,284,255300,433
11,2,9,0,11,813,0,4,1267,655
34,8,26,6,16,64756,71917,108,17141,524
39,10,29,3,11,224407,3834,5,91,544
36,13,23,0,19,814147,0,43,1167,599
21,6,15,2,10,311957,19439,96,8173,489
11,8,3,3,8,366970,1319,22,626,504
27,5,22,1,15,42367,8676,12,8982,407
19,4,15,5,10,17170,16370,121,12186,445
52,17,35,4,14,359818,13671,33,4532,477
92,7,85,4,22,1134833,1910640,91,33303,447
5,2,3,1,13,64708,64704,7,0,632
15,6,9,7,9,386682,93156,102,8753,434
11,4,7,5,10,85449,120135,90,52152,434
6,3,3,1,10,533599,287515,89,3990,641
23,6,17,3,9,9075,4055,18,2499,462
18,12,6,11,6,55159,48905,159,16345,449
16,8,8,6,17,63763,73180,48,31697,508
15,4,11,3,16,39315,29662,53,24814,591
16,7,9,0,16,195652,0,0,2097,616
8,6,2,6,14,449998,31615,86,12046,423
7,5,2,3,18,509066,40895,62,23993,476
7,5,2,2,8,810681,899940,35,599960,504
34,8,26,8,9,62280,34089,445,15059,455
24,6,18,1,12,13354,3226,34,3226,486
62,15,47,12,7,356283,61651,285,21927,454
13,2,11,2,13,7619,12147,17,7619,483
20,5,15,9,14,27123,125805,135,1312,474
18,6,12,0,17,1595,0,1,840,659
18,7,11,0,11,919766,0,0,0,592
34,12,22,14,19,4047745,1333437,15,606,531
40,9,31,6,14,1155094,203554,115,7963,454
16,9,7,8,13,197171,163402,322,96623,471
8,2,6,2,8,3945,3845,254,7500,455
59,11,48,8,11,107440,110320,235,11322,443
9,5,4,2,22,122343,34021,59,0,500
32,7,25,7,15,68798,91678,86,26240,459
17,2,15,1,10,401709,673,0,0,611
13,9,4,2,12,832741,9220,25,7799,477
38,13,25,5,14,59450,40367,179,9289,387
40,9,31,6,15,41665,41469,121,57753,444
24,11,13,4,8,342305,68542,84,34343,497
20,9,11,5,13,147446,31934,65,2171,449
18,4,14,2,6,28712,16898,140,13215,544
8,5,3,3,12,15503,13809,70,9626,482
16,5,11,3,13,13606,55164,40,3057,455
8,1,7,1,7,1110,1110,22,0,541
5,2,3,0,4,68965,0,7,40,615
35,8,27,8,18,64644,40092,130,4730,398
5,3,2,0,8,9713,0,0,0,650
7,5,2,5,17,73452,63681,102,9176,416
5,3,2,3,3,2680,2680,3,2294,450
17,7,10,5,13,245725,41754,50,21977,446
5,1,4,0,8,0,0,0,791,648
70,13,57,5,24,763209,474397,176,100,480
21,6,15,2,9,20566,29084,108,15986,670
16,6,10,2,9,42892,2050,9,1725,527
23,13,10,0,12,1224282,0,1,149,587
25,13,12,4,5,1163199,15480,199,4128,469
17,9,8,1,13,540575,4370,80,20161,510
4,1,3,1,9,42067,42466,25,0,545
15,4,11,0,11,257824,0,4,1861,556
6,4,2,4,4,51705,8356,0,0,457
4,2,2,0,8,0,0,18,6458,511
11,7,4,1,5,157381,8208,0,0,512
91,8,83,4,14,52223,39571,67,10012,469
10,5,5,0,3,46830,0,0,0,580
29,6,23,5,8,64228,69071,105,16021,497
31,9,22,0,13,730475,0,12,0,517
23,11,12,0,8,29819,0,16,310,651
8,1,7,0,7,1228,0,0,0,559
12,2,10,1,17,627919,4438,3,4438,538
7,4,3,1,13,2290,1800,17,1800,610
21,8,13,2,5,270642,20153,30,21544,422
10,7,3,5,14,402516,89557,33,27013,509
7,5,2,5,12,373192,25874,48,8842,487
37,6,31,4,12,185416,32299,86,1085,539
16,3,13,1,11,177809,142749,52,219,629
66,10,56,7,15,113338,110689,261,27128,439
12,8,4,6,18,49995,51278,60,5449,466
9,4,5,0,6,26975,0,2,0,635
3,1,2,1,5,500,500,1,0,617
5,3,2,2,6,11677,11098,197,20188,481
19,7,12,4,7,31076,23977,0,0,479
9,1,8,0,8,3605,0,11,4605,676
8,4,4,6,10,16426,24818,0,0,529
9,3,6,0,10,51284,0,0,10883,623
11,7,4,8,6,21740,28662,45,3755,441
4,2,2,0,10,16380,0,0,573,661
39,3,36,0,16,51326,0,1,2218,599
8,4,4,5,17,45444,44339,17,8058,466
19,12,7,4,14,3296181,68629,41,17247,446
4,1,3,0,13,293998,0,0,79742,653
7,5,2,5,11,317331,54635,46,4330,447
9,5,4,2,8,11008,832,56,1110,455
39,16,23,4,10,305672,27346,130,26127,456
3,1,2,1,7,0,2924,34,0,510
38,5,33,2,9,29975,10621,163,10023,526
19,8,11,4,12,116722,72456,61,17346,544
28,9,19,1,13,409751,1869,36,2767,486
12,5,7,0,8,14014,0,71,0,465
27,6,21,4,17,96257,80498,111,60915,356
15,5,10,5,19,12453,21454,33,13206,414
8,3,5,2,13,429075,36009,1,1901,520
4,2,2,3,3,3986,3986,22,2134,472
26,19,7,6,13,242548,65578,107,31010,429
6,4,2,0,20,204101,0,0,0,634
48,16,32,11,19,493560,87433,156,21836,422
70,12,58,6,9,247518,22429,236,14292,425
23,11,12,7,10,25336,16871,67,43330,496
15,1,14,2,11,19678,19678,24,3897,514
7,3,4,0,7,78903,0,0,0,584
26,10,16,2,16,563729,9327,93,19678,561
11,5,6,4,15,211963,22773,0,0,532
8,2,6,1,10,206314,9663,11,9663,597
45,12,33,8,14,871950,71599,132,2889,455
14,8,6,5,7,34900,21240,114,13041,473
5,3,2,1,7,983,982,15,3097,456
11,6,5,0,9,277352,0,3,0,660
10,4,6,4,7,21778,21579,301,10796,463
17,8,9,1,15,132486,15664,32,1014,508
23,5,18,4,7,423093,35105,246,4951,439
13,3,10,4,7,18518,25355,330,15028,490
3,1,2,0,7,447,0,7,0,535
18,5,13,2,12,64415,21133,41,12964,501
8,4,4,1,7,206259,43563,19,43563,628
11,8,3,1,11,59959,618,11,1677,499
28,6,22,5,18,302584,222327,60,12862,396
27,6,21,5,13,247058,37253,31,12581,389
13,9,4,0,8,16562,0,0,0,651
15,4,11,4,20,315362,42108,65,12066,465
17,14,3,9,13,118600,62501,308,7268,382
14,6,8,9,13,31342,55404,150,14079,472
8,3,5,3,17,72194,109672,58,62235,472
30,20,10,17,8,715625,225006,296,116387,382
10,3,7,3,7,5444,2773,17,568,504
20,3,17,4,9,10318,10318,38,6510,391
38,8,30,3,12,322948,32921,57,19145,593
12,7,5,3,11,19383,10854,50,1504,525
17,9,8,2,24,915350,1682,38,8355,424
16,1,15,0,3,8448,0,0,0,617
6,4,2,1,14,220828,357,0,0,682
20,4,16,1,8,44085,950,8,950,527
23,14,9,14,11,72630,39012,572,6574,412
45,13,32,7,7,84539,47321,147,23144,406
11,6,5,0,16,56234,0,3,15022,446
6,1,5,0,10,33233,0,0,0,653
10,8,2,4,13,22482,15383,124,13143,458
15,4,11,0,13,51208,0,0,0,630
5,1,4,2,15,1,92066,20,0,644
28,5,23,3,9,32804,34814,5,22596,601
8,3,5,4,7,5538,14668,36,3140,499
19,16,3,0,22,1654666,0,32,1168,466
6,2,4,2,6,181376,9371,38,484,524
23,16,7,6,8,327648,78221,38,5118,418
11,5,6,5,9,171945,123634,7,1029,466
34,4,30,0,6,1251448,0,7,282,638
9,7,2,3,9,10532,6671,55,4190,524
21,9,12,3,10,45263,3994,21,19022,457
9,6,3,5,12,66722,60958,104,10709,445
8,4,4,4,7,19207,8347,5,3158,412
8,6,2,2,11,89525,8116,23,6072,449
30,11,19,13,14,279260,185834,60,9462,407
5,3,2,3,9,426920,35702,71,3272,471
38,13,25,8,7,142106,37306,15,6006,434
9,2,7,0,4,3640,0,0,0,621
16,3,13,0,16,0,0,0,0,642
18,11,7,1,13,40934,288,0,0,520
17,9,8,5,8,141085,29877,103,8885,418
22,10,12,3,21,229656,11598,31,6890,466
10,8,2,8,6,68080,56496,138,10413,436
7,4,3,0,3,32304,0,9,373,598
6,3,3,1,5,29250,9650,16,0,489
57,43,14,2,7,175381,31170,27,531,494
4,0,4,1,9,0,3930,0,135,573
12,4,8,1,10,222971,2250,40,0,445
6,2,4,2,8,14859,4628,0,0,513
44,6,38,4,12,444984,89116,69,7524,389
20,4,16,3,20,20144,14708,79,10000,500
26,2,24,1,7,1111,1111,4,1111,500
17,8,9,2,18,204161,18270,30,11921,444
21,8,13,6,13,373461,34758,70,10148,425
30,17,13,1,20,804384,46600,9,46600,584
8,4,4,0,3,11701,0,0,0,569
8,3,5,1,13,966,966,12,2898,460
7,3,4,4,6,5861,27287,76,8722,427
26,6,20,4,15,224581,18609,93,5908,551
13,6,7,1,8,24511,325,18,6027,521
8,1,7,2,7,792,792,30,751,577
8,3,5,6,11,53722,86876,83,9295,449
23,6,17,1,9,52792,246,21,1290,527
31,11,20,10,13,688326,101164,258,11585,429
28,14,14,2,15,1448682,5363,27,835,475
14,8,6,6,8,24382,24382,41,8607,399
3,1,2,1,13,0,673,22,0,639
19,9,10,0,29,93015,0,3,0,670
20,7,13,2,13,35238,13834,0,1691,530
4,2,2,0,8,5378,0,3,0,603
20,8,12,2,7,24039,8548,37,8137,395
7,4,3,0,7,30754,0,28,500,635
10,5,5,4,7,201574,201574,65,0,465
12,5,7,1,10,447126,548,5,0,539
19,8,11,6,8,38096,30479,43,11951,563
16,12,4,8,21,421208,516754,151,39053,467
6,3,3,1,8,7242,2587,20,279,539
4,2,2,0,7,8211,0,7,3202,641
11,6,5,1,4,10093,388,65,684,509
76,13,63,10,15,713246,173309,121,19667,460
44,11,33,3,11,506116,7197,53,6938,491
8,5,3,3,7,17764,12685,79,0,455
13,7,6,0,9,194084,0,23,0,464
24,4,20,2,10,1459,1459,97,1074,547
3,0,3,0,17,0,0,2,0,557
9,4,5,2,12,220689,18666,23,2091,459
3,1,2,0,7,510,0,9,0,632
10,4,6,2,5,70467,5026,37,2087,519
10,5,5,0,3,201032,0,1,2500,529
9,4,5,1,5,36633,668,9,1750,482
5,2,3,0,9,27492,0,0,0,705
11,6,5,1,8,268276,1007,1,0,651
12,8,4,5,19,241007,46086,219,6597,445
6,3,3,1,7,1252499,27300,10,0,559
36,8,28,2,10,35619,1892,33,2741,480
16,6,10,5,14,108021,108021,154,3096132,419
26,10,16,3,7,457850,11789,44,739,488
5,3,2,1,12,3668,2681,26,3216,582
40,17,23,9,9,420339,26035,343,5154,451
32,5,27,2,15,7211,18873,23,4663,512
10,4,6,3,14,10504,21636,39,3191,504
28,6,22,4,7,59994,27391,201,10299,472
12,3,9,4,14,29799,28971,323,21624,489
3,1,2,0,7,0,0,7,188,699
6,4,2,2,8,98650,8129,6,0,403
28,17,11,11,27,475021,176524,120,4472,450
8,5,3,2,12,10323,42633,0,0,580
18,8,10,5,14,361865,35115,0,0,459
11,6,5,4,10,26046,24466,294,15831,495
6,4,2,0,9,7897,0,0,508,644
22,6,16,4,26,38909,38909,108,44656,455
7,4,3,3,21,31498,19703,51,10972,578
12,10,2,1,6,302824,340,4,0,469
5,2,3,2,13,30601,25742,44,1555,469
37,6,31,5,14,23467,22490,111,10558,461
17,6,11,1,13,135908,41,14,5625,532
12,2,10,2,12,50910,19474,68,3892,460
10,6,4,0,5,323680,0,21,0,560
82,12,70,0,16,288774,0,5,7386,627
87,19,68,5,18,2037863,97149,197,27588,442
53,10,43,0,14,270986,0,132,2349,497
19,8,11,3,19,442958,47944,111,3644308,472
22,9,13,6,13,138195,60803,113,16500,388
55,7,48,6,8,259152,47699,82,10132,443
6,2,4,0,6,21344,0,6,1885,596
12,8,4,6,10,217367,52195,132,6804,439
8,5,3,0,11,209563,0,0,0,683
11,4,7,0,7,42530,0,2,926,643
8,4,4,1,7,56881,15346,5,0,529
15,10,5,3,13,2514658,163903,0,0,567
5,3,2,2,5,51372,3999,52,2639,579
9,7,2,4,8,283898,29141,0,0,596
45,20,25,15,14,1213133,1174883,160,237322,414
8,6,2,4,4,29187,3969,121,1028,497
15,5,10,1,9,130936,15658,11,700,682
18,10,8,1,12,548727,2687,12,0,548
10,4,6,5,9,195505,195505,36,0,479
8,4,4,4,16,22544,30909,57,3978,480
19,7,12,5,15,35395,35395,31,16065,484
17,6,11,3,9,429625,388479,75,0,479
12,10,2,0,6,289129,0,1,1200,638
7,3,4,0,9,29911,0,0,0,694
10,4,6,3,8,50674,9126,46,3316,478
7,5,2,0,8,114315,0,0,0,661
35,8,27,1,6,71352,62762,17,62762,465
14,6,8,7,6,152469,127158,77,4977,464
32,13,19,0,19,419137,0,9,20483,538
9,7,2,5,7,15861,12359,86,4048,427
13,6,7,1,16,274547,2711,6,486,623
54,6,48,2,20,395869,3023,343,3536,515
37,16,21,10,14,107250,96431,79,11989,418
68,11,57,2,12,183120,79386,22,840,489
16,13,3,1,7,652980,638,15,638,480
18,6,12,5,20,245178,208283,71,3528,507
5,3,2,3,7,57991,49213,76,47023,494
15,7,8,5,69,331795,159849,118,205,457
36,3,33,6,19,181314,93807,190,53708,449
14,9,5,8,7,78582,30804,74,3720,475
17,8,9,4,15,1014281,91947,67,49733,440
18,12,6,2,12,1807857,12112,15,0,469
27,9,18,8,18,222593,213137,45,140927,477
14,3,11,4,9,60131,17786,65,7330,454
19,12,7,0,13,209652,0,8,0,609
52,5,47,0,13,1042106,0,0,169,555
5,2,3,2,8,17671,12407,28,0,493
26,9,17,0,17,433037,0,0,473,641
9,2,7,3,8,8843,15340,0,0,584
8,2,6,4,7,37072,32661,100,23426,477
9,6,3,3,6,43033,11251,54,5509,516
16,8,8,4,13,91914,66159,0,0,521
15,6,9,3,14,206291,2031,166,2373,477
5,2,3,1,12,10234,2306,9,2306,562
21,11,10,11,13,439375,434593,197,0,499
36,20,16,1,16,514075,2155,59,0,456
26,4,22,3,9,16238,1994,116,2910,524
18,8,10,0,8,294944,0,47,1050,565
6,4,2,4,9,67217,67217,73,46124,474
13,9,4,3,15,182879,11874,8,9451,368
38,9,29,6,9,177593,32425,57,10478,442
19,7,12,5,13,264685,15340,83,5522,493
22,6,16,6,21,75795,72675,115,44452,481
14,5,9,2,7,39550,25851,31,3838,536
25,13,12,3,29,904064,62011,41,55159,556
8,5,3,5,4,50606,41169,45,24503,436
90,16,74,5,25,425904,16768,114,3416,493
13,6,7,0,4,279193,0,0,0,652
7,5,2,4,15,12074,12074,36,387,603
61,21,40,4,14,1866368,16837,218,63098,534
14,3,11,0,4,14944,0,12,1890,514
6,1,5,2,8,7740,13329,21,7740,581
17,8,9,4,20,289113,170630,92,43698,453
10,6,4,1,7,61223,2166,17,2564,573
4,2,2,2,9,4381,3709,31,3416,477
12,5,7,5,7,90577,28148,115,9355,594
134,24,110,14,19,719427,384531,348,104838,460
18,9,9,8,18,56435,43577,71,11513,448
13,11,2,3,25,1689042,15338,7,326,584
20,8,12,4,13,50607,33079,59,9939,478
21,16,5,8,16,314077,54613,87,38278,407
15,6,9,3,11,163602,25310,30,0,568
46,30,16,1,3,39542,2193,30,8734,464
11,2,9,2,6,8206,8206,84,7813,497
51,9,42,6,7,190161,189057,70,168857,499
110,14,96,4,23,684917,29882,46,11443,409
6,3,3,3,13,6868,6868,51,5587,442
5,1,4,0,15,0,0,0,4565,673
35,11,24,2,18,423918,9661,36,2432,518
17,12,5,8,8,343149,47681,333,12558,461
8,4,4,1,18,351406,7914,127,28633,581
6,3,3,5,6,27938,33945,55,4307,468
15,3,12,0,7,126426,0,2,0,576
19,8,11,5,11,37656,5366,23,2743,443
15,5,10,4,14,35683,31966,380,17995,495
6,2,4,0,11,66822,0,0,49598,649
28,7,21,4,16,84995,42884,75,27489,423
5,3,2,3,3,17696,14776,23,10550,478
5,3,2,0,2,17906,0,0,0,629
5,3,2,5,8,27769,36008,0,0,506
13,8,5,5,7,61000,27325,67,8761,375
19,3,16,2,8,16535,413,77,744,599
30,13,17,5,12,61458,50335,117,15336,600
5,1,4,0,15,2994,0,0,158,604
23,13,10,1,17,318427,597,8,597,684
22,9,13,6,12,678303,196601,150,13853,468
7,4,3,1,9,244747,18567,5,0,620
22,6,16,5,12,354677,7852,0,0,439
11,3,8,1,11,30696,12977,23,12977,606
12,6,6,0,13,56548,0,0,2007,637
11,4,7,1,22,58808,12587,24,12587,616
7,2,5,3,5,19002,9674,32,2882,476
14,5,9,3,23,107659,105728,46,239,479
21,8,13,0,9,419994,0,0,0,637
13,6,7,5,9,49157,15079,49,7420,484
5,1,4,1,7,0,27858,39,342,488
5,2,3,2,4,17463,34839,30,751,614
8,4,4,2,13,315590,7957,50,0,519
13,4,9,4,5,5977,5977,38,1543,425
6,3,3,1,8,6718,6718,26,6718,671
16,7,9,5,9,381599,128392,91,2831,450
8,5,3,3,6,28507,33140,21,22493,418
10,3,7,5,8,274599,28317,0,0,505
26,10,16,9,69,107346,87042,187,13234,464
7,5,2,6,8,21759,23965,64,10793,597
19,12,7,3,13,99113,2602,8,1589,561
15,11,4,8,9,29787,7525,145,2485,519
21,11,10,4,10,77481,38728,70,19384,525
68,14,54,4,10,1387277,46543,19,20719,444
4,2,2,1,12,82804,82804,1,0,613
23,9,14,6,10,470857,58191,129,2554,451
6,3,3,4,11,15942,15942,45,9589,501
71,23,48,15,14,411420,61080,293,10156,431
7,5,2,1,10,52513,3516,46,858,447
17,9,8,1,8,47396,1410,19,1410,557
4,2,2,0,6,0,0,4,0,588
10,4,6,3,9,121144,113343,56,0,504
19,4,15,2,6,28742,12993,23,9092,603
36,9,27,0,6,435410,0,21,446,569
21,8,13,0,14,306961,0,0,1500,645
13,8,5,6,7,38700,10881,62,2083,413
20,4,16,7,14,173084,312937,55,0,532
20,8,12,7,8,45194,135411,176,12209,380
9,7,2,0,14,65659,0,3,0,533
7,4,3,1,14,40964,33757,5,14799,424
36,9,27,7,9,69447,106289,413,2529,578
7,3,4,2,10,4992,962,190,969,522
14,3,11,4,12,85560,72651,99,3386,493
13,7,6,5,4,28453,11438,40,1585,398
10,7,3,7,7,67787,67787,91,25992,449
9,6,3,4,6,6355,6355,174,2950,408
20,13,7,11,19,350828,199179,199,4305,507
17,8,9,8,18,49676,50572,96,10099,502
26,5,21,5,7,52644,52644,95,9990,440
27,2,25,1,12,126212,17984,89,2013,575
12,4,8,8,18,137639,250033,164,18493,457
9,6,3,4,20,644276,94832,63,16174,415
15,11,4,1,22,146036,2659,9,2659,489
6,3,3,1,14,324449,38640,31,0,542
6,4,2,6,4,19972,20078,46,8542,583
17,7,10,2,13,444961,14447,84,4802,449
33,18,15,0,9,3758841,0,37,0,586
26,8,18,1,11,114587,13531,3,31806,493
9,2,7,4,15,13045,39412,179,3708,483
88,30,58,13,21,853137,235822,623,48205,415
7,4,3,1,6,12559,6650,90,6650,549
5,2,3,0,13,0,0,0,3982,619
8,4,4,1,9,28062,21452,18,21452,447
5,3,2,0,8,30461,0,16,384,662
9,5,4,5,9,15437,16977,55,6453,597
8,6,2,5,9,10144,10144,21,11590,425
14,11,3,1,8,207566,23936,10,1476,480
6,2,4,2,11,14783,14783,61,13747,471
19,3,16,3,6,16520,16520,94,8802,466
10,5,5,4,10,300502,16579,18,12352,492
8,5,3,7,7,32157,41974,368,17518,507
19,6,13,3,14,25582,7450,126,2610,452
28,16,12,8,16,282486,26258,203,17947,459
15,11,4,7,9,1793923,214307,86,10610,423
9,6,3,0,4,26015,0,1,110,668
5,1,4,2,7,35433,35433,20,12640,534
11,5,6,6,15,348958,348958,183,164669,486
15,7,8,6,7,41947,39947,76,16685,433
21,8,13,0,17,458875,0,0,8339,565
9,7,2,1,11,186926,175,2,0,631
25,9,16,5,15,779423,265264,176,34462,473
18,10,8,4,12,264917,30969,71,3306,460
10,5,5,0,14,63372,0,38,15977,444
11,4,7,0,8,56120,0,0,1820,610
10,4,6,4,6,185429,33814,57,4636,437
25,11,14,0,14,1670723,0,0,0,683
5,0,5,0,15,0,0,31,2440,540
19,3,16,2,13,86288,11112,40,7152,449
17,4,13,3,16,9894,15328,67,8133,492
9,5,4,4,8,254455,16903,187,8151,512
10,4,6,0,7,163392,0,20,52,671
9,6,3,5,14,31024,40320,61,19078,598
7,4,3,1,11,605345,2174,18,2174,504
7,4,3,0,8,27096,0,0,0,686
7,4,3,0,12,240885,0,0,0,602
17,10,7,2,45,34779,10484,46,1256,590
15,7,8,2,6,92259,1143,22,1123,620
8,6,2,3,6,20916,18060,23,14732,530
17,5,12,0,12,118718,0,8,5466,654
15,10,5,7,9,420133,64478,79,21695,587
11,5,6,5,17,15004,18664,126,736,503
7,2,5,2,11,105585,29864,25,645,541
15,4,11,1,19,133176,1580,47,24386,507
39,13,26,4,13,230952,78115,70,11989,501
15,9,6,6,16,89819,45947,107,1430,477
13,8,5,0,7,212808,0,22,2358,583
6,2,4,0,5,1714,0,0,0,666
20,8,12,4,8,10907,33168,77,500,470
19,10,9,8,14,134339,77258,407,27163,450
14,6,8,6,12,34701,43326,125,19939,454
12,9,3,6,13,649625,143047,181,14629,420
6,4,2,4,7,7502,7207,39,3354,486
14,6,8,0,8,72839,0,108,16513,492
24,9,15,0,25,146830,0,2,0,698
8,5,3,4,7,8066,8066,80,4117,514
17,8,9,6,4,48776,25310,32,6209,432
28,9,19,9,6,63288,37779,105,10917,442
31,8,23,5,11,109711,57283,152,3392,416
11,5,6,0,69,383163,0,1,175,546
6,4,2,2,12,83849,37290,14,0,625
32,5,27,2,11,374378,75046,50,0,491
7,3,4,0,8,36747,0,0,0,702
16,3,13,2,14,28974,8970,103,6559,486
13,8,5,3,16,173721,36424,81,10095,432
8,5,3,4,6,44727,25001,80,775,520
12,10,2,0,17,388413,0,21,0,587
15,2,13,2,5,15333,15333,23,14716,448
11,7,4,3,9,12665,3740,36,4684,543
13,6,7,1,14,1653697,1807,14,1724,474
10,7,3,2,6,100304,13354,5,0,406
17,6,11,2,16,267326,4309,34,2742,532
7,2,5,1,24,1439,1426,7,262,498
5,3,2,2,7,36135,36017,33,25418,555
28,9,19,3,8,382291,10851,74,10469,522
40,20,20,0,10,871011,0,8,0,606
3,1,2,2,2,5899,20559,8,0,395
7,3,4,3,8,213011,36578,63,0,567
30,9,21,6,13,612652,266293,59,42816,372
8,5,3,0,8,37332,0,4,4250,603
13,11,2,0,9,3880647,0,1,0,548
15,7,8,3,19,18730,82179,65,474,598
10,6,4,0,5,16206,0,0,0,511
12,8,4,5,20,142394,91977,35,3848,466
8,1,7,1,13,11285,11285,5,11285,545
11,4,7,7,7,83287,110167,98,7300,537
17,7,10,9,14,85212,117306,243,27553,475
8,4,4,1,10,34344,30777,52,146,581
27,6,21,3,7,89917,3973,35,4407,454
8,3,5,1,6,513872,4009,28,11803,541
19,9,10,7,38,114514,138407,196,58801,429
8,5,3,6,7,18879,11392,62,2883,450
12,3,9,1,7,11621,702,30,702,558
38,16,22,12,16,135306,82547,80,25243,425
13,10,3,3,7,513980,9321,16,312,545
12,6,6,4,10,31370,128521,82,10162,505
8,4,4,4,7,27911,25321,134,11616,473
3,1,2,2,6,11154,21335,26,11154,605
7,2,5,1,6,4424,3454,23,3454,634
12,3,9,2,16,235359,35862,29,616,526
4,1,3,1,12,2794,2794,14,10168,480
8,5,3,2,7,36920,834,6,8340,552
18,6,12,4,14,11239,10758,42,8687,560
12,4,8,5,20,556443,115352,43,94694,516
11,4,7,5,6,50370,54730,68,16246,584
9,6,3,2,7,16897,2474,26,3230,488
11,7,4,5,11,138266,195572,47,2660,457
5,1,4,1,8,3349,4314,17,2317,613
14,11,3,0,17,424675,0,5,4859,575
10,7,3,1,9,281932,6066,15,6066,545
6,4,2,2,7,8712,8712,0,0,502
13,4,9,2,12,7178,7178,67,8632,521
36,13,23,3,14,308525,10199,180,2501,528
22,4,18,4,14,90310,107852,12,48847,490
5,3,2,2,6,3748,3748,38,2398,430
17,11,6,0,17,1599651,0,0,0,520
11,3,8,1,10,33000,28048,90,3030,500
17,7,10,5,8,12583,16894,50,7041,478
10,4,6,3,9,247997,50769,0,0,491
12,4,8,1,5,79648,3242,30,3242,538
23,14,9,8,21,317250,190801,125,235267,456
31,9,22,6,14,26036,10799,104,2992,419
17,5,12,4,6,160572,124365,72,0,479
9,6,3,0,12,164870,0,6,388,635
35,9,26,15,9,483143,689245,303,164927,435
42,11,31,8,14,233071,27018,226,11900,415
8,2,6,2,13,277096,18415,31,1544,544
47,7,40,2,7,44149,6306,56,18305,481
15,8,7,9,18,34690,37900,136,7225,501
17,12,5,5,10,469605,50820,27,8984,415
9,3,6,3,69,14980,14980,47,408,466
27,12,15,5,7,40344,31953,126,21750,600
7,5,2,4,10,18873,25191,74,10094,506
7,3,4,0,13,57092,0,0,0,622
20,10,10,0,8,217173,0,22,0,593
11,5,6,6,11,38687,29331,100,6796,444
10,5,5,2,35,56527,81475,15,5385,476
16,1,15,1,8,558,558,74,2972,557
18,8,10,3,16,271065,123906,39,2190,506
37,9,28,3,13,108854,12949,25,4522,474
40,15,25,3,8,23555,15902,125,27457,420
8,1,7,3,8,19873,19873,22,0,517
7,2,5,2,11,232469,17973,7,6799,511
16,4,12,5,12,40431,35920,200,21968,449
8,4,4,1,7,23181,22357,0,0,526
3,1,2,1,8,8845,8845,6,0,652
22,5,17,5,16,45278,45278,62,12604,481
30,12,18,5,10,452522,33478,299,10521,475
4,2,2,2,5,19701,19701,116,13042,457
22,7,15,1,8,23936,1136,365,1283,507
8,3,5,3,19,16948,16948,32,14954,412
22,12,10,11,22,587796,211208,11,18195,507
4,2,2,1,17,449542,3421,1,341,632
10,5,5,4,13,186462,18389,58,10423,511
8,5,3,6,8,19272,19272,51,4509,487
6,1,5,0,14,43750,0,0,2157,580
21,15,6,8,14,236975,89559,0,0,446
3,1,2,0,13,315348,0,6,0,710
30,5,25,7,19,422099,14364,113,3043,480
6,4,2,0,3,6700,0,1,0,595
16,8,8,9,20,52059,58986,92,8893,446
17,8,9,9,10,39149,56226,149,9997,347
28,8,20,3,14,49813,20670,44,7691,446
13,7,6,3,18,521127,8060,69,13354,433
9,4,5,0,13,346963,0,16,4897,501
9,6,3,0,7,219781,0,2,0,670
4,2,2,1,9,2273,2273,1,2273,427
8,2,6,4,16,120922,127746,56,0,474
12,4,8,0,10,28600,0,22,8011,467
2,0,2,0,3,0,0,2,0,591
15,6,9,2,4,115429,5203,7,4206,495
22,7,15,8,10,357884,752781,207,0,442
23,16,7,1,12,63714,1223,5,2826,543
58,9,49,1,9,358049,26405,40,2467,475
19,7,12,7,11,28693,32694,436,13216,439
8,5,3,5,6,58956,58956,7,1054,449
78,5,73,3,18,324274,8126,47,2179,459
23,16,7,18,8,989413,262972,287,23812,442
3,1,2,0,13,66020,0,0,0,544
10,8,2,4,6,47157,5502,68,1036,479
70,10,60,3,16,41841,5406,54,3869,466
8,2,6,0,8,44283,0,2,0,622
4,2,2,2,4,98525,1621,44,1665,451
7,5,2,0,8,28118,0,62,1241,519
25,12,13,3,10,219012,4731,56,9500,398
29,16,13,1,7,187880,9401,41,9401,475
6,4,2,4,8,23797,23797,52,10050,514
9,7,2,7,6,75454,50354,79,15274,409
20,11,9,10,14,170057,115872,154,54685,413
16,8,8,7,7,63244,54792,180,27201,411
8,4,4,0,9,164123,0,32,0,672
20,5,15,2,14,344653,13204,27,12233,547
11,6,5,3,9,89540,110750,41,35260,523
8,6,2,6,8,39028,17178,56,1437,405
10,6,4,5,7,48561,10240,182,5473,371
7,5,2,2,8,64859,16898,2,8694,556
7,3,4,1,6,35293,35293,141,704,562
14,6,8,1,10,387895,373432,0,0,604
17,5,12,5,11,260067,49538,115,34881,442
73,21,52,20,14,253003,138742,561,1179000,426
23,14,9,11,13,247569,214850,208,67870,449
281,3,278,0,11,23214,0,3,585,670
8,5,3,3,15,424738,87679,48,4008,537
10,3,7,0,9,176841,0,1,0,622
27,5,22,4,8,11533,11659,77,5250,474
22,14,8,5,9,272181,23290,16,2345,461
33,2,31,2,5,19046,9873,17,0,457
13,8,5,6,14,572670,57145,0,0,447
25,10,15,5,5,60655,33760,67,17829,515
68,11,57,3,19,63197,4566,96,5450,492
6,1,5,2,9,0,21298,51,977,586
6,3,3,3,6,6912,4376,50,302,521
49,7,42,1,9,25363,9060,113,9060,539
41,14,27,10,22,488539,158100,0,0,507
10,7,3,3,19,481331,11162,55,5180,625
5,3,2,4,7,21468,23462,50,15724,414
15,9,6,1,9,92518,4192,26,5480,523
6,2,4,4,9,25879,42087,63,337,431
10,7,3,2,17,345207,308465,35,219600,634
32,10,22,6,12,137880,72042,135,29719,430
16,9,7,2,7,22501,21725,38,219,517
16,9,7,9,13,317368,55263,133,15505,404
10,7,3,3,13,608124,6130,0,0,525
8,6,2,5,7,108299,95370,110,11396,535
14,5,9,0,7,115124,0,0,1228,603
9,2,7,0,15,2800,0,26,336,695
7,3,4,0,14,76083,0,13,0,596
21,13,8,1,30,4139265,2540,23,2995,659
25,11,14,7,18,555184,153040,0,0,512
7,5,2,3,7,81064,26841,40,3492,466
19,5,14,4,4,11972,3932,92,4871,425
8,6,2,3,7,25594,24165,95,6485,472
9,3,6,0,8,39111,0,0,0,668
66,22,44,12,37,1360429,104834,257,7792,484
16,7,9,1,4,41083,20742,10,0,625
16,4,12,6,7,24824,16798,51,5610,431
32,11,21,5,19,188143,43675,39,1963,455
51,9,42,5,14,103591,57625,98,9154,458
63,9,54,0,13,305694,0,81,0,472
35,21,14,17,9,806491,709807,378,95720,403
18,13,5,11,14,223414,222474,53,58186,378
10,6,4,0,6,222376,0,0,0,675
8,2,6,2,8,27528,27528,43,0,463
24,8,16,0,11,422488,0,6,0,522
10,5,5,6,9,52270,42108,95,2427,428
18,7,11,0,8,60739,0,37,3600,515
7,2,5,1,11,1341,1250,54,2461,622
12,9,3,1,6,64607,1685,3,1685,481
14,9,5,0,7,531174,0,0,0,614
10,3,7,1,30,1620,1620,6,4050,432
5,3,2,0,7,7675,0,0,0,606
9,2,7,1,3,3211,1750,19,1750,525
10,7,3,0,8,338691,0,6,626,607
12,6,6,5,6,42773,32582,57,11446,419
10,7,3,0,9,952378,0,1,0,606
13,6,7,1,14,394894,772,8,772,545
20,14,6,5,8,158294,96958,97,4418,500
18,8,10,11,6,137627,92758,198,12998,421
11,8,3,1,8,973728,1100000,3,406,439
15,12,3,7,11,333877,170028,110,6932,455
32,11,21,1,8,429681,150,7,150,587
16,4,12,2,10,33367,31449,20,29000,676
54,15,39,2,11,473382,24312,56,15569,470
2,0,2,1,4,0,2975,16,0,619
15,10,5,0,17,270836,0,16,0,535
9,1,8,0,11,0,0,10,1841,685
33,15,18,13,7,74168,57306,379,10972,416
5,3,2,1,9,24851,24851,6,7134,535
29,8,21,5,15,129510,20136,33,4274,427
3,1,2,1,5,4097,4097,11,4097,607
38,9,29,7,30,165467,95676,160,64796,416
11,9,2,4,12,445092,42774,109,19969,481
13,4,9,2,8,17143,9047,23,6323,445
22,14,8,1,5,122500,218,31,5140,569
27,17,10,1,8,497295,195,19,908,607
5,3,2,0,21,973,0,4,1081,654
15,7,8,5,8,37681,33542,58,32948,406
32,12,20,0,19,403170,0,60,769,512
8,5,3,4,9,53199,12199,68,5437,485
10,4,6,5,14,136715,110071,89,0,543
23,10,13,2,12,474244,7021,158,6507,461
13,3,10,4,8,30258,35814,65,13119,517
4,2,2,1,9,19690,19690,25,0,683
10,8,2,0,8,652295,0,2,0,528
32,6,26,3,9,26657,24959,122,26078,516
8,4,4,1,13,20610,20030,24,20030,503
20,4,16,4,7,23142,18125,8,1416,519
8,3,5,0,6,61638,0,15,1461,663
24,5,19,6,4,27712,15677,258,12453,413
25,11,14,9,18,55682,61965,162,17104,524
24,7,17,2,8,91630,661,311,4494,508
27,8,19,0,6,386117,0,117,3354,578
26,13,13,0,13,757285,0,0,0,622
52,6,46,1,13,46854,15338,22,15338,525
22,7,15,7,15,61036,66564,314,21706,512
4,2,2,1,7,33648,33648,29,33648,492
13,6,7,5,4,46259,19387,30,11573,472
18,9,9,2,13,585215,96946,52,24244,467
8,6,2,2,6,70700,5959,4,2914,467
34,8,26,5,6,36380,16819,59,12057,495
18,5,13,4,14,34616,34229,245,6596,505
18,12,6,11,6,78521,71325,193,6565,416
15,11,4,9,8,163697,38018,85,4987,394
47,8,39,6,12,112644,57035,148,6512,420
7,4,3,4,23,41563,21800,0,0,460
18,5,13,0,9,1025799,0,2,0,628
20,7,13,0,9,189973,0,28,188,662
39,4,35,3,14,12750,22515,39,1227,478
5,2,3,0,6,43482,0,24,0,519
12,5,7,0,19,806982,0,1,0,588
11,7,4,4,9,263743,27341,44,836,474
29,7,22,6,8,63908,72154,141,31286,451
34,15,19,21,7,802284,1838990,196,149286,381
13,10,3,0,9,294027,0,2,340,567
12,1,11,1,15,10222,10222,36,10222,586
17,14,3,1,12,556601,44676,34,19678,447
10,5,5,1,12,428357,2043,9,2043,480
13,5,8,6,22,534009,585552,101,4548,479
9,4,5,0,16,186420,0,0,0,683
65,2,63,0,69,30683,0,13,1899,517
9,5,4,4,6,213530,22769,235,10185,444
21,6,15,4,10,42742,55248,158,29205,476
27,12,15,9,23,145608,91657,222,24650,442
23,5,18,4,9,20414,49308,0,0,439
18,12,6,0,13,1011679,0,4,0,535
28,20,8,1,8,2078304,10180,0,30,591
7,1,6,0,17,324468,0,9,1505,655
13,8,5,2,18,196497,27546,1,249,499
13,2,11,1,11,25054,24554,214,4343,556
14,2,12,3,18,8463,17314,53,6398,517
5,3,2,3,3,11914,6186,19,3200,608
18,5,13,1,12,16889,275,16,2000,600
11,6,5,3,6,400205,20588,81,8938,433
27,9,18,1,8,295164,1789,170,27600,408
12,6,6,3,7,109329,6600,48,2200,548
11,8,3,4,5,234886,6459,0,0,435
17,2,15,3,13,17751,24420,49,9897,494
28,7,21,3,11,62334,20269,51,0,488
17,12,5,4,13,18691,13936,310,8969,495
56,8,48,5,30,253067,34846,79,30259,476
11,4,7,3,8,14653,14015,37,11960,510
10,4,6,4,16,402901,89502,78,0,518
13,4,9,0,9,44978,0,9,2504,693
15,2,13,1,11,244769,20264,12,0,584
6,4,2,3,8,18683,14327,23,5452,482
21,5,16,2,14,268208,15029,62,1057,494
11,7,4,4,15,53383,22100,42,8786,474
19,6,13,4,10,405383,14221,28,3551,480
28,7,21,2,11,56282,2892,8,174,617
20,12,8,2,11,561775,13360,48,6680,512
14,4,10,6,8,18560,32983,40,6942,519
12,4,8,4,15,437490,76391,22,18861,477
12,7,5,2,10,876583,22141,27,2157,514
73,12,61,2,11,270123,472,190,1182,588
19,3,16,1,3,20580,29,14,0,528
4,2,2,2,12,93040,93040,14,54399,523
9,5,4,3,10,11975,11975,345,15445,548
8,3,5,2,7,39867,36867,54,0,474
13,1,12,2,8,4390,3914,161,2708,564
35,14,21,10,12,278715,227913,273,111592,414
3,0,3,0,8,0,0,0,0,511
33,8,25,3,6,114284,6187,110,3473,451
4,2,2,2,5,11766,2477,9,1871,508
15,7,8,8,8,45465,82642,31,12576,486
16,10,6,2,18,566804,24729,0,4933,588
13,4,9,4,21,65617,58767,72,0,520
54,12,42,9,10,591559,62954,69,730,493
15,13,2,3,23,526064,292740,101,705,525
32,10,22,2,7,107420,7307,23,1403,537
10,7,3,7,13,462381,46912,60,18698,434
25,6,19,3,7,53406,556,34,4067,517
17,7,10,0,7,117332,0,0,0,617
16,4,12,0,14,13555,0,1,468,648
14,8,6,0,14,310802,0,32,42160,492
20,9,11,2,6,220574,121534,18,0,447
15,6,9,1,12,224779,8560,15,9059,424
5,2,3,2,8,34123,20643,0,0,646
17,10,7,1,16,255640,5558,42,10999,527
3,1,2,1,2,6267,63029,4,0,512
23,7,16,2,9,191422,924,46,474,509
17,4,13,0,17,387113,0,4,2570,606
16,9,7,10,11,110522,60859,102,11774,452
12,10,2,0,10,191130,0,16,254,554
6,4,2,4,9,60476,60476,76,46778,446
10,5,5,4,14,304150,14557,76,4930,502
15,3,12,2,10,23469,23392,80,1599,455
7,4,3,2,5,23679,4342,25,3940,471
25,16,9,17,14,140697,159699,687,35698,498
15,6,9,8,12,201363,232042,141,16606,516
57,10,47,3,19,684775,53522,34,2185,519
26,3,23,1,8,13573,953,0,0,583
9,6,3,4,10,41057,31246,116,1590,482
28,8,20,10,11,75693,61686,31,3605,431
26,10,16,6,12,270140,161087,25,114769,447
40,9,31,3,12,293590,76877,24,37900,445
19,8,11,7,9,76222,32175,47,7190,454
10,6,4,1,14,71546,8091,22,8091,677
8,2,6,0,14,12355,0,1,0,698
17,9,8,6,9,37387,22937,76,5551,457
8,2,6,3,9,16338,7720,47,0,532
16,10,6,6,15,304446,26297,24,9182,474
14,8,6,3,26,243414,50000,101,28704,468
12,7,5,4,8,11090,4664,72,291,481
12,6,6,1,16,39611,667,15,7695,405
14,8,6,1,8,314590,2690,1,1439,466
17,7,10,2,13,458637,66633,52,1339,549
12,6,6,8,8,187090,186645,115,5573,442
16,3,13,2,4,263991,7402,1,646,473
10,7,3,7,11,2191773,590518,30,206458,455
12,5,7,0,24,398430,0,3,7523,674
12,6,6,1,10,44947,760,1,2141,489
10,4,6,4,7,20863,16542,83,7055,433
9,4,5,0,9,263071,0,9,0,679
9,4,5,3,11,20830,9357,33,4024,534
5,1,4,1,11,11157,6512,5,443,658
12,4,8,5,12,21333,29626,83,12949,431
14,5,9,7,17,18089,23350,142,10896,428
8,5,3,2,12,140272,10588,50,0,542
13,1,12,1,8,1200,1200,38,1200,522
8,6,2,1,5,61378,10783,43,484,453
46,16,30,13,18,1128617,1098361,286,856250,445
14,8,6,6,9,450616,447002,130,3655,451
14,7,7,2,10,228861,130130,14,1001,660
2,0,2,0,22,0,0,23,0,633
12,3,9,6,10,107258,161010,89,48373,446
23,4,19,5,12,295201,89191,129,32558,507
9,6,3,3,12,317759,14679,54,11790,474
19,3,16,0,6,25587,0,11,749,602
8,6,2,6,12,559234,46714,54,31092,462
14,4,10,4,12,21651,21631,8,4561,470
12,4,8,2,19,79569,5831,30,4204,494
41,10,31,2,16,120661,5914,230,3893,580
7,5,2,5,10,17217,6723,68,1708,455
21,5,16,1,4,10166,1766,135,508,457
3,1,2,1,8,1956,1956,5,1956,539
15,8,7,6,8,131311,123921,144,13654,484
6,1,5,1,16,6207,6207,3,3864,509
11,5,6,2,7,68607,92117,46,67623,428
6,3,3,3,7,2631,4715,32,2084,485
17,2,15,2,15,2224,2224,91,4070,572
9,0,9,0,18,0,0,0,2128,658
8,5,3,3,5,201752,34761,26,0,520
9,0,9,0,14,0,0,0,2572,748
15,6,9,2,29,34363,28168,63,33574,506
15,10,5,7,7,139928,81605,105,52683,474
21,18,3,15,8,255218,46571,292,7407,401
38,7,31,7,11,28768,33028,155,10581,454
9,5,4,5,11,82426,28509,63,14341,462
6,2,4,0,3,17806,0,1,0,546
12,5,7,5,6,16110,16110,216,6184,474
8,3,5,4,8,57435,7965,47,2089,512
27,8,19,0,13,150467,0,16,20,664
29,9,20,0,14,451805,0,1,555,604
36,12,24,3,8,210548,49465,8,6587,520
20,6,14,3,18,905212,35116,28,237,538
18,7,11,4,13,545496,30413,65,14772,524
26,2,24,2,8,9721,9721,60,8870,436
7,1,6,0,13,0,0,0,2290,712
2,0,2,0,1,0,0,6,2402,379
10,5,5,2,7,57595,10300,77,2045,504
27,14,13,4,9,746564,22057,76,4786,427
20,11,9,1,10,1265027,43861,26,852,565
11,6,5,1,9,47900,5907,14,5907,605
14,6,8,2,12,885436,52982,40,52594,559
11,9,2,8,8,214310,308421,324,168658,549
6,3,3,3,9,28956,16493,72,7033,487
10,3,7,2,9,15178,1394,0,0,606
17,7,10,7,13,548587,317501,108,1947,502
4,2,2,1,4,12146,4600,0,0,599
6,3,3,3,18,301923,21106,36,257,527
11,6,5,0,11,159713,0,1,0,630
121,29,92,6,22,1276283,125341,69,7986,480
19,7,12,3,6,18961,9279,13,6934,514
26,15,11,11,14,78537,92633,243,34048,406
12,6,6,0,16,38075,0,7,0,621
20,7,13,6,18,122200,48273,37,5541,468
14,6,8,3,8,143195,29379,21,15709,450
16,4,12,2,8,51803,6184,145,8640,486
5,2,3,0,13,1140,0,0,0,548
23,9,14,3,13,401484,30518,58,0,497
27,10,17,9,11,378311,34732,208,8390,460
4,2,2,1,12,265,265,2,265,583
7,4,3,3,9,354387,36781,101,938,498
16,5,11,4,18,79477,200895,73,681,552
127,3,124,1,9,26869,11058,14,1182,649
33,12,21,4,12,79859,15738,62,4980,471
6,1,5,0,15,0,0,0,2560,568
5,2,3,0,4,30690,0,1,296,618
12,8,4,1,4,225442,163,6,0,654
10,3,7,0,9,18853,0,34,0,657
5,1,4,2,8,22375,36759,33,0,473
3,1,2,2,5,16001,23674,33,0,616
31,9,22,6,19,303633,31623,55,6630,452
3,1,2,1,18,5213,5213,13,5213,506
15,5,10,4,7,36125,33878,70,22577,424
30,7,23,4,8,166211,106415,172,33854,506
10,6,4,4,6,162776,111264,38,31283,425
13,10,3,5,21,562298,14272,55,4953,465
15,11,4,9,16,188678,248796,139,73421,460
32,12,20,4,11,638365,12563,65,4120,510
7,5,2,0,4,97299,0,0,0,546
9,2,7,4,8,64053,109163,0,0,517
6,3,3,3,6,7681,7681,9,2906,408
7,4,3,3,8,10805,10805,11,8658,441
5,3,2,0,9,19924,0,5,614,665
6,3,3,1,2,3457,1957,3,2094,412
11,4,7,1,12,67650,4043,39,611,577
14,5,9,2,16,229838,19223,43,2592,482
6,2,4,0,6,77327,0,3,0,677
21,15,6,12,18,68774,67648,222,12740,377
15,9,6,11,11,808277,216410,65,1250,503
21,10,11,9,8,24470,33881,372,9030,448
5,3,2,2,19,2311,1822,65,1334,577
9,7,2,4,6,16356,14756,33,5337,439
6,1,5,0,3,0,0,14,0,520
9,6,3,5,6,60884,38467,39,6742,427
9,5,4,5,10,23647,27537,18,990,438
8,5,3,2,7,27678,18222,191,15065,500
12,7,5,2,10,537414,66266,33,6159,523
257,14,243,1,11,90290,5300,67,5300,491
5,3,2,3,7,13217,31474,226,10764,518
96,9,87,1,24,141888,23,242,3082,579
15,3,12,2,17,359252,8611,69,0,489
5,3,2,0,19,49617,0,0,1313,647
13,5,8,3,5,45291,1555,63,1290,532
33,9,24,6,9,183167,51150,77,27171,429
26,18,8,8,12,568514,139441,47,3470,433
10,4,6,1,16,648871,10614,79,25000,452
15,4,11,1,8,62487,384,4,5008,465
6,1,5,1,12,63743,63743,0,63743,629
23,12,11,11,12,619162,306167,11,6349,519
12,4,8,3,6,19815,19815,214,11375,502
10,4,6,0,15,165732,0,0,0,636
15,5,10,3,18,32663,41091,236,25723,521
2,0,2,1,5,74749,74749,7,0,603
34,5,29,4,16,41911,36121,52,28606,482
19,1,18,0,15,0,0,154,7789,490
8,6,2,3,11,373810,20732,0,0,529
6,3,3,1,13,461641,14322,30,0,559
5,3,2,0,4,92030,0,0,0,563
7,3,4,5,13,37231,48163,77,2273,562
9,2,7,1,14,3861,3861,24,3861,608
13,5,8,0,13,31890,0,2,21775,625
71,4,67,4,3,34635,23905,19,9137,465
59,21,38,13,17,360031,100902,137,11070,380
48,21,27,19,8,481748,245168,367,43055,383
38,5,33,2,7,54791,13323,130,35396,455
10,7,3,3,12,391076,15821,43,2898,468
25,10,15,9,27,525553,244637,180,2100,433
22,11,11,5,9,2505635,56899,16,796,469
23,5,18,3,8,27675,13361,33,6563,438
10,7,3,3,17,13089,20195,116,3010,558
11,6,5,5,13,51700,476155,31,526174,468
6,4,2,0,9,95758,0,0,950,724
29,10,19,0,16,1013232,0,29,0,562
24,10,14,0,13,786162,0,1,349,585
11,5,6,4,7,17694,17694,331,13972,417
14,5,9,2,9,9443,6616,328,6052,509
12,3,9,2,7,216568,10046,66,0,576
16,3,13,0,11,4947,0,0,0,696
4,1,3,2,7,22932,22932,22,3294,533
12,6,6,2,10,432466,325489,42,251617,532
15,6,9,5,7,34925,26750,19,9737,439
19,13,6,1,18,298788,4101,25,15229,539
10,4,6,0,7,141044,0,0,0,653
28,7,21,3,21,476250,18423,67,9204,540
11,4,7,6,8,16503,17998,6,906,506
8,3,5,2,3,7768,4803,8,3493,511
14,8,6,5,8,103401,42695,26,551,518
10,8,2,0,7,112053,0,4,0,586
8,3,5,0,5,52130,0,2,0,616
7,2,5,0,11,14409,0,0,467,594
20,9,11,3,15,118811,57422,0,1235,459
22,9,13,3,13,81564,50578,46,23281,403
16,3,13,1,13,819819,2408,33,0,587
21,12,9,0,23,322311,0,17,344,518
23,11,12,7,7,60501,22237,86,6560,451
99,9,90,5,13,1214469,1031096,95,44268,501
20,9,11,1,8,1907152,5589,19,0,590
31,10,21,3,12,351497,21538,35,4250,455
23,5,18,2,9,34933,7097,125,10049,549
128,8,120,5,19,145453,82060,180,8600,561
27,6,21,2,11,1139417,309760,65,903,471
9,6,3,5,9,322571,26369,55,11387,397
10,5,5,1,12,257035,415,21,415,539
10,5,5,6,9,35026,41251,352,9715,521
15,10,5,0,20,194748,0,2,1,643
40,5,35,5,14,29576,18748,56,9069,471
23,11,12,3,17,288638,58939,123,5471,474
40,9,31,4,14,758749,21066,10,5967,502
18,8,10,7,16,592535,96485,134,0,591
85,13,72,12,11,207997,299938,504,96531,464
10,7,3,2,10,58085,26979,1,319,498
14,6,8,9,13,72293,76196,143,17811,466
6,4,2,3,8,55815,55157,0,0,582
33,3,30,1,14,238897,109,41,0,469
28,16,12,5,8,379326,15892,231,8281,458
8,5,3,1,9,367735,111,35,4727,467
28,8,20,1,20,313424,1005,58,142500,617
23,7,16,2,8,231414,6394,12,6393,573
18,13,5,1,4,2987043,494,13,494,490
34,13,21,11,8,162349,110610,472,15150,496
28,13,15,1,20,436836,6058,0,0,576
5,2,3,2,6,8617,8617,37,8039,549
12,7,5,5,12,10134,10084,55,2998,415
20,6,14,7,12,109085,109085,86,44433,537
61,14,47,14,16,407529,289576,491,102897,381
12,5,7,0,9,1293393,0,5,0,538
10,7,3,2,12,39952,2480,90,0,424
6,4,2,3,10,22507,21407,47,4875,398
12,7,5,3,7,403485,15719,19,1435,466
94,3,91,4,7,1593,16201,45,742,598
26,6,20,1,27,444643,98983,62,98983,625
9,4,5,5,17,38940,46751,76,20056,466
21,4,17,4,16,305829,26959,95,2280,435
13,9,4,1,8,140654,42600,30,1555,466
9,3,6,3,12,9362,9896,67,0,519
6,1,5,2,6,40945,40945,26,0,543
12,4,8,5,7,853719,279609,61,0,470
3,1,2,2,6,2783,9441,36,0,518
17,4,13,1,9,22617,967,9,0,617
8,2,6,1,12,12916,12916,98,17413,533
13,6,7,0,12,306833,0,36,3060,687
17,12,5,9,7,1226700,1219816,3,567993,353
4,0,4,1,8,0,5614,8,5614,570
27,8,19,6,20,767949,302397,100,297772,503
6,2,4,1,15,393303,19969,22,9269,474
6,1,5,1,7,22874,22874,26,884,540
27,13,14,7,11,1638999,96600,37,2799,454
24,9,15,1,19,625853,2415,0,2690,606
20,9,11,0,12,485431,0,43,0,628
24,6,18,1,11,94170,1459,24,3028,491
92,10,82,4,9,97635,3904,15,751,545
3,1,2,0,2,0,0,10,0,555
21,4,17,1,9,90594,18750,23,18750,576
4,1,3,1,8,13885,13885,50,1319,647
9,5,4,5,16,323229,42990,99,6626,489
13,7,6,6,19,31914,44908,120,9425,447
28,5,23,6,10,43542,19725,87,9244,462
13,7,6,3,13,365080,6445,42,3311,521
4,1,3,1,7,13294,13294,26,13294,551
13,6,7,3,17,79954,7170,41,850,517
22,16,6,0,10,1327923,0,38,10065,476
16,8,8,6,14,515288,37403,252,14822,449
25,3,22,0,18,12544,0,7,28240,628
61,11,50,7,14,2206723,554413,89,43416,436
10,5,5,3,10,27452,27452,63,23386,440
22,3,19,0,9,132122,0,158,1261,587
40,9,31,8,10,24371,32087,295,12870,401
8,6,2,0,12,4753,0,2,9811,552
16,10,6,0,23,438028,0,4,0,538
10,5,5,2,8,2274,2055,21,1715,622
6,3,3,4,9,18795,22003,96,9154,530
14,8,6,5,19,553937,32822,16,575,433
20,11,9,7,11,1063805,38477,91,9525,484
8,1,7,1,14,5962,5962,25,5962,502
13,3,10,1,6,30480,21521,33,0,530
8,4,4,3,16,49817,49817,48,29500,560
16,8,8,0,18,1712336,0,0,2474,632
84,17,67,10,15,264820,136702,685,32158,455
12,6,6,2,69,8467,4166,26,3202,643
22,8,14,0,18,175890,0,0,1011,700
8,5,3,5,15,50660,49926,24,18435,451
7,5,2,3,6,32876,15005,0,0,460
22,11,11,2,4,290308,6049,22,1250,503
9,2,7,1,9,1280,1280,17,64,476
11,6,5,7,7,23810,26266,103,10448,503
10,3,7,0,8,10274,0,4,78,609
5,3,2,2,3,104734,10137,26,5317,440
9,3,6,0,2,9575,0,0,0,593
21,10,11,5,15,194328,48973,32,9579,502
10,5,5,1,4,129730,1613,8,0,568
5,2,3,1,7,19332,274,3,615,589
5,3,2,2,15,16708,12339,37,0,462
17,4,13,2,14,449678,19130,48,11112,573
28,7,21,6,8,27036,31160,105,668,514
7,4,3,2,5,14467,1536,9,0,429
22,11,11,12,28,846985,753827,212,0,507
5,1,4,0,5,153271,0,3,0,627
18,4,14,1,8,30255,845,38,0,508
7,5,2,2,25,27990,4349,3,4099,456
7,5,2,1,10,89359,1278,39,1278,595
4,2,2,2,8,7764,20246,13,0,681
11,4,7,3,10,194554,288748,46,0,446
16,7,9,0,12,658733,0,0,0,654
43,9,34,8,18,61766,67489,293,27338,439
9,4,5,0,13,15492,0,0,3592,625
28,15,13,14,16,449372,372207,217,43735,555
7,4,3,3,14,395811,35464,41,9022,502
20,12,8,1,10,228330,23,0,0,536
23,12,11,5,21,108190,57508,124,299,498
47,11,36,0,14,541359,0,0,0,522
9,5,4,5,23,234756,30949,295,13982,470
29,13,16,7,19,150572,10851,69,3324,455
11,6,5,0,7,123743,0,50,419,537
15,7,8,4,8,13928,12468,75,10394,432
23,10,13,6,13,391697,37972,145,22753,407
17,11,6,7,8,329949,25930,152,7075,411
11,6,5,7,17,61549,72333,215,17515,391
12,5,7,3,13,37258,8572,111,11250,459
12,3,9,4,11,20646,26620,77,736,548
5,3,2,1,4,3715,549,12,0,503
13,2,11,3,13,26658,38361,96,2616,499
11,3,8,4,11,285888,35461,70,3914,465
7,3,4,1,4,417952,3677,28,4568,482
31,9,22,0,8,313553,0,8,0,641
20,8,12,0,10,378279,0,21,0,471
10,5,5,0,15,525284,0,0,1319,646
33,22,11,0,41,3248884,0,8,2,582
5,2,3,1,4,7424,6024,0,0,537
46,9,37,1,12,120204,5906,34,2586,525
11,9,2,0,13,120429,0,9,80,597
17,5,12,2,5,28012,3590,150,528,436
7,4,3,0,6,256804,0,2,0,616
27,10,17,10,8,42245,42211,364,14746,411
5,3,2,1,13,444506,427440,26,2082,577
7,3,4,0,10,9172,0,13,0,675
20,12,8,2,10,245556,17857,95,4472,442
12,4,8,5,8,22800,22800,89,12757,381
17,7,10,5,8,235384,136775,77,0,493
13,5,8,1,10,11046,2040,29,2040,513
15,5,10,2,6,83342,31742,27,479,485
4,1,3,1,4,35800,16756,20,0,639
12,7,5,6,7,47949,46808,107,22057,420
12,7,5,2,19,23483,21569,48,17582,526
20,7,13,1,5,59615,35,236,638,539
9,6,3,1,10,19217,718,7,971,537
2,0,2,0,3,0,0,14,125,453
6,4,2,0,6,142899,0,0,0,647
18,13,5,1,11,1478206,24737,4,762,487
19,3,16,4,14,51671,36673,48,3691,494
15,9,6,0,14,145760,0,1,0,673
19,10,9,1,9,322757,32148,8,0,495
13,3,10,0,11,25502,0,15,2069,538
13,11,2,11,6,46572,60853,115,20930,385
16,11,5,5,14,478747,68764,100,9573,396
27,16,11,15,8,321855,119181,299,0,442
16,5,11,5,9,26372,20891,193,7808,485
10,6,4,4,9,18994,19222,69,0,485
28,7,21,7,18,426486,44403,0,0,465
17,8,9,1,19,64506,23284,22,0,598
14,7,7,10,18,40638,59370,104,11278,459
3,0,3,1,5,7720,7720,29,7720,616
43,5,38,2,18,121118,17407,231,8712,535
15,5,10,0,12,137434,0,0,0,624
16,12,4,7,11,531725,184643,216,73445,476
14,8,6,9,19,137084,167354,120,91053,426
6,4,2,1,3,25357,2714,98,1940,440
34,8,26,6,11,552823,44879,348,16741,440
15,9,6,5,13,546146,136647,75,23342,446
4,2,2,1,17,4963,4962,15,4963,599
16,4,12,1,7,25270,526,2,374,551
22,8,14,2,11,200706,29821,88,25066,497
9,2,7,1,7,15474,8236,158,2251571,436
55,4,51,1,12,421774,26537,9,0,518
20,10,10,0,7,1067457,0,24,1256,450
7,5,2,1,8,9161,2878,8,4919,473
21,10,11,0,23,2913245,0,2,0,657
13,7,6,1,18,225821,8914,26,0,692
13,9,4,7,11,828973,132990,76,27204,458
12,6,6,2,5,20975,11143,48,9109,464
10,5,5,8,6,16625,45513,106,8058,444
14,6,8,5,8,95765,61191,93,15621,451
10,6,4,0,6,103922,0,8,0,508
7,1,6,1,20,6170,6170,0,0,532
24,10,14,7,10,723572,216110,40,68997,410
15,7,8,3,12,24953,8151,63,5066,518
5,2,3,2,11,6292,6292,21,3222,473
20,7,13,6,18,82865,102046,0,0,453
5,2,3,2,12,286784,286784,68,271239,474
6,2,4,4,8,39591,86891,70,30251,477
17,5,12,2,9,13075,3089,260,2046,509
3,1,2,0,8,1559,0,0,650,654
21,7,14,6,15,25936,20089,96,6508,432
23,10,13,0,16,266942,0,0,0,693
10,4,6,0,13,52226,0,0,0,715
16,6,10,10,11,172314,172330,234,0,494
9,3,6,1,5,15823,5625,22,5625,453
6,4,2,2,7,16262,16258,110,15198,563
47,9,38,4,7,140868,112548,73,57024,490
4,2,2,1,9,596,596,18,596,613
11,4,7,1,14,810170,10771,21,10771,411
35,8,27,5,13,337860,72560,100,28243,466
21,8,13,1,12,314766,2431,37,20888,494
25,11,14,5,23,290019,92348,85,0,480
15,7,8,0,10,106425,0,0,0,688
11,8,3,5,9,393803,193442,58,11377,443
21,10,11,0,18,554503,0,2,1364,583
12,4,8,1,6,33993,14981,28,0,542
11,8,3,5,20,877684,584892,81,493237,584
8,5,3,0,14,227189,0,0,0,592
36,2,34,0,7,52128,0,3,0,721
9,7,2,4,9,181204,94628,171,55056,459
42,6,36,9,9,141388,138828,262,32943,448
8,5,3,0,7,156090,0,0,0,664
15,9,6,9,7,33330,15523,193,2252,441
6,1,5,3,5,28170,42080,46,18339,541
11,6,5,2,16,123458,32808,46,28921,496
10,4,6,0,3,251550,0,0,0,606
15,4,11,6,15,259572,50422,79,6756,545
26,12,14,4,12,189042,45924,100,32856,461
17,13,4,1,10,524241,5467,24,5467,454
10,7,3,2,7,210618,14880,12,1330,572
12,8,4,5,19,128225,8557,63,8509,459
7,2,5,0,11,2500,0,49,0,567
18,7,11,6,13,382303,304884,25,32710,420
7,4,3,3,15,40922,94473,0,0,581
12,4,8,4,8,11827,11827,66,19975,432
13,3,10,1,21,477307,999,10,4928,572
21,6,15,5,8,37863,27111,18,4594,466
11,6,5,0,18,54617,0,1,0,673
15,9,6,4,14,631625,28748,87,0,474
7,2,5,1,9,36346,2996,0,0,513
7,3,4,1,17,167665,167665,23,167665,602
92,16,76,8,14,724763,147678,54,8478,501
48,13,35,6,28,57156,179968,49,5531,505
31,2,29,0,13,27416,0,36,1340,724
5,1,4,0,3,1144,0,3,236,628
11,6,5,4,9,81771,71125,67,228,548
18,8,10,3,9,235993,48895,24,622,508
9,5,4,6,13,83628,90242,183,28651,510
11,2,9,3,15,50461,23852,48,1772,466
8,3,5,0,14,7103,0,0,8857,677
12,10,2,3,14,233543,35953,77,20151,435
13,6,7,1,16,153401,5847,4,5847,610
11,6,5,6,7,7664,7664,235,1484,480
42,9,33,0,6,121872,0,3,5000,606
42,5,37,0,5,65094,0,1,158,578
18,6,12,0,10,391038,0,27,4944,572
19,10,9,6,7,197916,61602,132,24198,417
9,4,5,2,14,313202,77239,158,12295,509
39,7,32,1,8,404534,606,19,1816,568
27,5,22,4,13,308210,524992,63,203627,485
6,3,3,1,6,198793,34586,18,2352,492
9,3,6,0,11,12708,0,1,0,715
17,9,8,8,15,460636,461076,124,114252,465
9,5,4,5,13,27735,25337,43,5236,466
11,8,3,3,23,186454,17774,60,15612,536
28,6,22,3,7,484129,1536,42,4179,539
9,4,5,3,4,19322,326,20,370,580
14,4,10,6,7,73248,84108,104,4650,451
13,5,8,0,7,97300,0,0,0,684
7,5,2,0,18,10546,0,5,3675,654
19,14,5,1,16,247458,1390,2,948,541
4,2,2,0,10,0,0,1,2000,599
10,5,5,4,8,18579,18579,240,7502,548
57,18,39,10,7,86107,70803,186,7985,423
6,4,2,4,21,32713,32713,70,12582,458
7,1,6,2,6,9431,9431,89,6420,615
32,2,30,1,5,337666,1954,1,1954,482
30,18,12,4,69,273925,32203,34,2628,514
27,7,20,7,10,116274,115022,34,6802,423
27,13,14,8,12,258991,229688,0,0,446
9,3,6,0,10,1718,0,0,0,701
6,4,2,1,11,536062,124053,3,9259,419
16,9,7,0,22,447663,0,18,1181,501
4,2,2,2,9,2383,2383,27,7540,473
27,7,20,5,11,11873,10478,135,14747,449
6,3,3,2,8,380314,18679,0,0,542
6,4,2,3,12,96065,96065,163,24646,511
39,18,21,2,8,6732010,45871,22,53213,434
18,9,9,8,6,59229,4736,84,12670,454
14,2,12,0,12,117287,0,0,0,618
18,5,13,0,8,27739,0,129,2674,463
2,0,2,0,3,0,0,1,0,646
5,3,2,4,13,18887,31559,39,10905,451
21,16,5,14,18,710802,253195,219,10860,443
15,8,7,9,20,486033,492914,145,4772,473
36,13,23,2,16,326574,7280,90,1143,571
9,3,6,3,14,194185,194185,0,0,484
9,3,6,3,10,19975,19975,12,16131,568
10,2,8,4,7,17103,83608,37,4034,563
18,5,13,5,4,161744,160069,49,2700,485
13,10,3,10,12,40587,63182,90,15941,599
11,9,2,6,5,30830,2678,17,419,437
10,4,6,1,5,28471,1340,42,1488,546
5,3,2,3,8,19923,15038,35,0,529
20,5,15,2,7,24003,1777,13,2402,545
14,2,12,1,3,13887,215,74,8910,609
5,2,3,2,7,9732,9732,48,4866,611
4,2,2,3,7,57453,71170,47,0,610
34,10,24,5,12,37390,11206,195,5158,451
6,4,2,1,13,189074,1425,5,1425,532
6,4,2,3,10,136587,41920,64,2698,457
54,7,47,6,9,43654,43654,287,23010,453
68,4,64,1,25,357860,40606,2,0,541
28,4,24,3,15,10612,10612,28,29650,425
17,2,15,3,13,199989,147013,20,0,451
9,5,4,0,11,107169,0,0,0,661
28,7,21,4,13,255425,8405,62,4341,426
12,10,2,1,7,6501,206,26,0,481
4,0,4,0,5,0,0,1,0,667
16,6,10,5,13,21421,49139,121,29165,434
16,11,5,1,7,96852,1400,2,0,618
15,6,9,1,18,206574,54461,35,622,507
13,5,8,5,9,105321,52833,0,0,451
10,7,3,1,5,35362,3166,24,3166,421
18,8,10,1,7,70240,6137,32,233,551
5,3,2,3,7,5025,5023,27,0,487
16,10,6,2,18,2416247,41413,29,1395,437
14,10,4,0,16,154863,0,15,14812,612
17,15,2,9,31,856909,59167,70,5301,445
27,7,20,2,10,283906,7096,4,5675,497
12,6,6,5,11,329124,19053,60,9490,386
8,6,2,5,10,282638,12033,24,4497,424
18,9,9,8,8,105190,106803,157,32343,397
7,2,5,0,10,19744,0,0,0,634
3,1,2,0,12,686,0,0,6085,649
42,22,20,18,17,121724,97307,264,54347,430
15,4,11,0,9,96405,0,0,0,725
3,1,2,2,5,6798,6218,45,4955,452
14,7,7,0,6,93679,0,0,0,644
18,6,12,6,13,374021,192178,146,33670,427
41,8,33,1,14,52240,966,7,2898,448
5,3,2,5,4,91126,103100,68,31765,513
27,7,20,0,16,362741,0,0,1681,434
8,5,3,2,7,37027,1265,27,415,495
6,4,2,5,5,17007,24716,73,344,598
8,3,5,2,8,134038,133429,49,0,496
36,21,15,5,12,168436,42661,55,24791,489
8,6,2,5,15,218826,605945,43,814058,529
54,5,49,1,14,89929,1333,7,10136,482
170,8,162,5,13,64658,67016,68,18749,411
2,0,2,0,8,0,0,7,0,559
11,8,3,6,20,900907,617222,87,493237,453
12,6,6,1,16,24478,297,8,0,595
8,2,6,3,11,1824,12901,11,11077,435
9,3,6,0,7,10910,0,0,0,648
12,3,9,3,16,572763,396716,36,0,549
17,2,15,0,5,11928,0,0,0,580
33,3,30,3,5,26279,26279,63,18800,440
35,9,26,6,11,55610,40141,67,18958,514
45,13,32,9,6,314062,41742,123,20919,419
8,4,4,0,35,112814,0,1,895,697
12,7,5,6,20,764035,1103388,146,644788,458
10,3,7,3,12,36917,60385,0,11692,553
32,8,24,5,20,123195,112135,199,51410,537
5,0,5,0,9,0,0,0,0,612
15,10,5,5,9,336359,34486,92,1194,451
22,9,13,0,7,599509,0,3,0,631
8,4,4,0,5,23792,0,0,0,663
19,6,13,2,6,10092,6602,34,4799,570
15,6,9,0,34,75746,0,0,0,617
34,12,22,9,9,2463108,668556,131,11276,478
18,13,5,8,18,429717,68461,0,0,462
5,0,5,0,6,0,0,6,728,646
36,6,30,5,8,73812,20110,100,4500,550
8,1,7,1,12,0,26549,7,60000,668
5,3,2,0,9,28915,0,6,0,634
5,3,2,0,6,31059,0,0,0,613
5,2,3,0,8,0,0,12,922,551
21,11,10,11,16,110344,113671,541,42746,409
31,8,23,9,10,98250,87326,198,10480,386
34,8,26,2,13,87191,14372,193,3274,475
14,6,8,0,12,64233,0,30,1320,563
6,2,4,2,12,83006,23397,36,0,587
30,12,18,10,10,306077,205823,38,6659,438
9,6,3,1,7,226235,826,25,0,523
7,5,2,0,14,237592,0,2,0,609
7,5,2,4,17,308267,117681,47,23827,484
6,4,2,5,5,25314,25314,230,17393,448
14,5,9,0,13,55307,0,0,0,628
10,2,8,3,14,187718,56099,38,46244,568
5,3,2,0,4,29636,0,0,0,584
7,4,3,1,15,352980,3056,21,8726,644
17,13,4,1,11,280836,8626,26,8626,678
7,4,3,1,10,25367,895,11,0,513
2,0,2,0,9,0,0,0,0,701
14,4,10,3,12,15400,10517,57,0,523
18,4,14,0,11,6565,0,130,1901,619
7,4,3,2,2,36643,232,70,3112,456
10,7,3,5,15,111350,18753,45,1830,562
40,9,31,5,16,405054,21932,176,4086,459
11,3,8,0,7,152436,0,37,4623,462
23,10,13,12,9,310123,423154,475,28864,554
6,1,5,2,7,31090,31090,16,23707,580
4,1,3,0,7,6936,0,2,0,636
14,7,7,8,12,25130,38644,93,4506,434
59,7,52,3,14,273264,13585,53,4506,572
21,8,13,6,8,21722,19718,202,12250,519
3,1,2,0,2,2641,0,1,2191,637
9,6,3,3,12,348464,17137,2,7375,445
19,2,17,1,13,334756,21514,17,21514,655
21,7,14,3,11,42385,39754,52,2712,533
20,13,7,0,16,799236,0,24,1122,683
9,4,5,3,15,283268,9476,43,1827,530
3,0,3,2,3,4330,4330,2,3470,597
16,5,11,3,15,270727,61585,74,55123,520
7,2,5,1,8,24184,16026,37,2392,493
51,0,51,0,13,0,0,0,0,583
2,0,2,2,8,0,6463,32,0,607
25,7,18,5,11,42180,38849,31,14342,523
22,4,18,2,18,103470,22524,26,14363,486
17,12,5,0,10,785675,0,0,0,672
8,1,7,2,4,17219,17219,34,3311,595
9,2,7,1,14,18617,270,4,3068,549
8,4,4,0,8,7365,0,5,32,678
9,7,2,3,6,50722,6282,30,4906,443
21,7,14,0,15,780450,0,8,0,535
18,8,10,6,10,78077,47286,36,12676,442
16,9,7,1,20,411018,1226,13,0,541
79,10,69,2,14,242669,16607,203,12877,525
12,3,9,6,9,113675,162612,13,8806,398
10,6,4,7,8,52505,64884,10,5518,476
47,8,39,4,18,45806,4224,80,1830,488
9,7,2,2,7,86499,5962,36,5961,477
11,5,6,5,11,38844,25229,238,5918,447
52,10,42,8,12,131934,110986,160,10612,429
20,16,4,14,11,500079,38278,133,4370,398
21,3,18,1,11,32287,30253,34,1192,548
70,20,50,3,16,180559,13473,195,30240,427
12,5,7,3,10,72215,8438,0,0,466
5,2,3,0,8,376171,0,31,0,581
5,2,3,0,8,315924,0,0,0,685
11,8,3,6,12,113110,71919,233,22876,491
14,8,6,4,12,122692,97796,39,76873,480
13,10,3,0,5,729546,0,10,0,502
23,5,18,10,13,374658,133815,138,27152,497
8,5,3,1,6,25701,2463,11,2463,457
20,12,8,2,14,172428,11382,17,0,513
16,6,10,5,8,41602,32378,38,12684,465
32,13,19,1,17,3273246,34259,2,0,637
51,4,47,2,12,15737,14329,52,13817,476
6,2,4,0,7,55400,0,5,2781,519
18,3,15,3,11,32421,27079,44,23094,497
6,1,5,1,3,4220,4220,8,4220,456
6,3,3,2,6,311318,1036,12,973,497
19,10,9,1,2,63776,13874,2,2538,482
37,14,23,10,20,1045123,465430,56,1475,480
11,4,7,2,17,99360,109031,39,99360,469
8,6,2,4,7,243462,25335,47,0,519
5,2,3,3,4,5575,9153,65,3578,396
217,17,200,11,18,390682,348076,407,40454,424
25,15,10,11,5,111493,69723,331,13355,482
23,4,19,2,10,373079,22128,130,20545,581
12,6,6,5,4,20293,17351,48,4979,440
47,19,28,12,8,155712,53122,467,8078,442
6,4,2,3,7,15166,28301,59,2007,408
30,16,14,17,24,1514515,3719243,404,428184,482
26,15,11,0,7,487399,0,49,1944,498
17,13,4,11,7,398672,61958,74,17444,481
8,5,3,0,19,137796,0,0,4785,689
5,3,2,0,8,8254,0,0,0,685
35,15,20,2,13,641171,3147,34,909,414
34,6,28,5,13,80053,77048,148,4015,526
41,5,36,1,13,27527,26064,25,1511,588
12,4,8,0,4,19636,0,0,0,591
11,9,2,5,16,67419,66965,53,14457,429
3,1,2,1,11,3253,3253,11,1109,588
17,8,9,0,6,615147,0,2,0,702
14,6,8,2,11,4275,1065,140,3592,498
15,3,12,2,10,37503,21923,94,0,538
6,2,4,2,9,17908,2783,13,779,427
26,2,24,2,8,17265,15330,65,11458,470
8,2,6,2,13,139409,81551,0,0,563
15,13,2,14,7,28749,32856,85,6064,413
4,2,2,0,8,5620,0,22,4188,597
7,5,2,6,7,93197,93197,307,48272,485
18,7,11,3,10,105906,4238,13,1340,525
10,3,7,1,6,37765,10400,14,10400,478
18,9,9,7,8,49397,19747,181,13728,446
19,9,10,7,8,40341,9871,89,5917,417
13,5,8,2,26,630215,67322,8,0,684
24,14,10,8,19,688037,115259,176,14449,476
17,8,9,6,12,102337,21732,53,2291,508
5,3,2,2,15,82561,16951,4,69917,503
59,10,49,5,9,286577,241290,112,102424,466
31,7,24,1,14,375432,5651,78,7320,489
17,15,2,11,13,156584,89349,59,10989,377
18,10,8,3,19,337253,12481,36,0,421
41,12,29,8,12,69230,35580,257,10458,411
7,4,3,1,10,0,8483,34,516,580
7,5,2,5,19,41150,34561,35,13305,423
38,2,36,2,7,7411,7411,52,4410,660
13,9,4,0,9,139684,0,0,0,706
8,2,6,1,14,44364,65401,27,0,618
14,4,10,4,21,779006,182123,0,1288,486
110,24,86,12,15,336873,92768,256,55537,410
21,9,12,1,7,51280,1247,3,20,598
11,6,5,6,13,50643,28646,197,11359,494
15,2,13,4,15,15903,27200,100,13727,628
6,2,4,2,12,18414,36156,41,0,520
16,3,13,3,19,17073,17073,8,6288,462
17,14,3,13,33,78904,31673,193,14767,438
8,5,3,2,15,193552,33953,22,0,526
4,1,3,0,2,1571,0,0,0,555
16,4,12,5,9,94440,92213,74,44102,458
7,1,6,1,14,6960,5282,0,1468,637
20,4,16,1,16,77652,7662,1,3636,656
16,7,9,1,9,440217,483,40,2144,652
40,12,28,3,8,85899,17915,280,10425,502
16,3,13,0,9,172958,0,36,373,679
27,11,16,2,20,314974,50740,154,47911,469
14,8,6,1,11,590223,2274,17,2274,490
54,20,34,8,22,267734,20618,166,7160,476
14,5,9,2,16,66338,65110,99,10534,520
10,5,5,1,17,85894,16243,23,0,647
23,6,17,3,10,67726,44862,46,0,590
15,9,6,0,18,516951,0,5,0,504
21,13,8,1,13,271096,3720,23,8410,477
17,11,6,2,7,34114,818,32,1619,590
7,2,5,3,12,8203,8203,89,1772,510
7,5,2,2,8,301802,31128,32,206,522
55,10,45,10,9,99587,105815,121,22610,414
18,8,10,6,16,52282,87401,51,35273,391
16,11,5,10,9,557314,93710,70,13500,445
15,10,5,4,3,70414,23851,21,20032,465
23,12,11,0,12,219177,0,0,0,666
14,7,7,6,7,18814,12509,94,3795,454
49,11,38,8,10,48031,37831,132,12916,450
15,6,9,2,13,345653,306834,10,0,672
12,5,7,5,15,36808,35010,91,3534,435
18,15,3,0,9,143948,0,0,0,480
25,10,15,11,15,143960,129435,79,46361,446
13,6,7,0,9,385418,0,2,909,649
41,18,23,12,17,499265,85554,204,4761,424
7,5,2,0,3,37507,0,1,0,575
33,11,22,4,14,259988,1341,22,933,639
7,3,4,0,15,373747,0,0,0,619
25,7,18,0,15,71891,0,97,770,475
44,3,41,4,6,154094,49598,28,4979,474
8,4,4,3,17,281230,86904,52,2799,544
32,9,23,0,17,388807,0,7,7829,480
14,6,8,0,7,40214,0,1,0,541
40,12,28,14,13,935903,1336124,342,298933,465
12,3,9,0,10,325963,0,22,2672,565
4,2,2,0,3,0,0,27,0,539
30,10,20,6,11,157855,10774,118,117618,415
6,3,3,0,5,16863,0,0,0,665
10,4,6,0,14,259082,0,8,9497,612
37,9,28,0,16,270399,0,74,1710,510
19,3,16,1,8,108151,56263,39,582,481
37,11,26,1,15,748330,5749,15,0,523
3,0,3,0,2,0,0,0,0,379
14,10,4,8,8,111938,74190,94,25468,407
18,6,12,3,18,493498,9240,27,5947,422
35,6,29,2,11,52618,15862,199,17890,459
4,2,2,1,13,75820,75820,25,0,534
33,10,23,7,8,35515,17423,140,4970,423
11,6,5,3,6,46741,25330,94,3511,493
50,13,37,10,34,886409,389938,259,53321,514
12,6,6,5,10,19040,41078,76,22209,506
4,1,3,1,3,4633,4521,4,0,615
70,11,59,7,14,84459,69522,127,20400,449
13,7,6,2,19,33781,6534,52,10650,488
8,6,2,3,15,268120,24060,9,13840,427
43,1,42,0,4,12938,0,0,0,694
28,14,14,7,13,318232,44309,120,15244,405
82,14,68,7,10,80354,64488,176,26090,414
15,8,7,3,9,36722,41877,33,11784,568
30,4,26,3,10,13217,10017,42,3406,502
16,1,15,2,9,11026,11026,34,9381,595
17,6,11,3,9,67276,37266,81,12884,555
12,7,5,7,17,556203,78683,138,8108,457
8,6,2,1,9,341329,166,1,166,578
52,13,39,2,18,588505,1947,25,5585,562
8,5,3,3,5,23509,19249,78,2988,462
17,10,7,10,7,133198,135996,205,28786,384
6,2,4,3,9,22219,24725,53,19568,547
8,6,2,4,5,43498,22337,114,10154,414
7,3,4,3,8,19959,19959,63,1936,498
7,5,2,2,8,361193,17592,88,16888,509
16,9,7,3,14,21281,2964,38,0,447
11,5,6,4,6,44618,44521,106,36024,546
8,2,6,1,9,218415,217067,14,0,646
4,2,2,0,17,35538,0,0,0,725
10,1,9,1,10,5805,5805,96,5805,563
20,6,14,0,3,58973,0,2,781,648
8,4,4,1,8,216093,4771,35,4771,536
27,7,20,6,21,146551,24367,75,2196,446
21,1,20,1,12,0,2499,1,1458,598
20,5,15,4,10,208042,148450,307,2662,506
39,14,25,3,27,676542,84236,61,12946,577
13,3,10,2,16,524,523,20,2120,469
15,7,8,5,10,476818,351220,128,0,501
8,1,7,2,9,0,16918,0,0,659
32,7,25,1,7,17358,253,0,2229,567
10,7,3,4,18,722983,183121,68,34290,538
6,4,2,0,3,910,0,16,0,518
5,1,4,1,8,4588,4588,76,52572,501
15,3,12,1,11,7909,3119,22,3530,537
35,10,25,5,15,444933,16463,179,3351,482
20,9,11,3,14,568414,22163,23,9760,424
5,3,2,0,11,379387,0,18,0,542
6,2,4,1,7,9627,9627,99,13307,577
25,12,13,0,35,169271,0,1,0,665
9,5,4,4,8,59380,44679,111,0,529
18,8,10,4,5,192079,121217,38,3522,437
37,16,21,0,12,968514,0,25,1033,571
15,10,5,0,16,2053300,0,6,0,610
22,7,15,7,14,40169,38708,133,27380,473
7,3,4,0,12,66698,0,0,10474,617
24,8,16,5,25,68255,68227,80,31096,495
17,8,9,7,14,24268,22232,123,7924,467
8,5,3,4,6,21348,15283,32,8086,433
8,2,6,3,12,5731,4864,41,2000,546
29,9,20,0,10,139123,0,5,0,590
47,8,39,1,13,31568,688,159,7875,416
16,7,9,6,12,193372,186512,19,45180,463
16,9,7,1,8,25767,970,28,1315,517
6,3,3,0,13,103722,0,3,0,614
8,6,2,1,16,8308,13970,1,13970,604
14,8,6,3,5,273673,16348,15,4240,480
19,5,14,1,12,250269,3469,15,3848,563
5,1,4,1,9,21022,9472,0,0,644
97,12,85,5,18,381244,57479,220,52068,437
30,18,12,0,4,2458568,0,2,11798,583
31,8,23,6,10,1456089,477860,0,0,494
9,6,3,0,14,140908,0,1,0,713
12,6,6,2,7,18446,2948,17,2678,465
10,6,4,0,6,41667,0,0,0,596
11,3,8,1,23,480830,29352,25,4159,619
16,5,11,4,5,26618,3603,62,2388,556
12,5,7,5,9,40696,40696,119,22729,478
53,9,44,5,13,71043,34218,93,20808,585
18,7,11,0,7,266865,0,6,0,464
18,10,8,2,14,419311,44738,17,7145,447
13,10,3,11,7,66680,71549,152,32588,465
83,11,72,11,14,79996,79126,158,35240,413
13,8,5,1,13,217096,863,3,0,566
6,1,5,3,4,6881,14963,36,6933,550
31,22,9,11,8,689365,330007,182,112610,449
10,4,6,4,13,66765,71877,42,32885,518
11,2,9,3,7,4087,4086,31,2914,454
15,3,12,6,12,13646,12254,146,445,514
11,9,2,0,15,603045,0,15,0,667
5,3,2,3,14,38767,16079,39,5160,509
10,6,4,3,15,467775,84386,90,24980,532
8,3,5,2,13,61526,61526,37,441,505
15,6,9,2,5,22452,8932,242,4965,423
13,9,4,9,18,768215,170833,159,13422,506
5,3,2,1,4,12945,3402,5,0,464
77,12,65,7,13,381694,39088,139,17952,414
15,8,7,0,16,308049,0,2,3380,583
6,4,2,0,26,292366,0,1,2395,684
19,13,6,0,8,271470,0,28,0,496
36,7,29,7,9,50163,43043,394,14014,482
20,11,9,8,15,313802,46694,277,17385,414
21,11,10,6,13,120338,34500,118,8610,421
16,2,14,3,11,477168,51639,0,0,551
22,7,15,0,14,167000,0,5,0,562
14,6,8,0,9,26243,0,186,1196,607
13,3,10,4,11,45588,76504,21,33845,465
13,10,3,12,14,533796,741713,190,2437,450
62,13,49,1,69,73670,1059,19,2079,486
11,2,9,1,9,22951,1725,98,2131,574
16,4,12,2,8,8506,1925,34,990,462
11,7,4,6,16,452618,83002,80,41232,447
19,7,12,6,13,28402,53418,115,12178,438
14,7,7,8,8,82298,84828,289,51350,418
21,9,12,1,27,222533,1523,79,0,489
12,7,5,2,18,30000,16102,33,8428,499
6,2,4,3,8,12417,79794,60,11397,489
25,9,16,3,10,233104,12417,55,4819,418
9,5,4,5,7,42587,42587,261,16063,447
30,9,21,4,12,41548,22748,77,3164,462
34,21,13,0,10,229515,0,13,2965,489
19,6,13,2,8,18780,14000,77,12541,491
10,2,8,0,14,0,0,16,5843,436
17,14,3,12,13,444197,92094,189,39220,441
3,1,2,0,9,0,0,0,0,664
15,5,10,5,9,58153,40246,66,26369,572
18,9,9,5,5,110935,23157,14,7267,460
24,10,14,2,10,584253,24153,22,18413,518
8,2,6,3,6,4133,15830,63,1350,465
11,5,6,3,14,39950,23176,37,17808,474
17,11,6,1,8,516320,2508,9,2508,518
20,17,3,11,5,302608,84370,203,27728,404
50,6,44,2,5,110345,10339,85,10092,526
12,7,5,3,21,1186134,145891,46,0,469
27,6,21,6,8,32768,32768,363,17223,418
8,4,4,0,17,14183,0,9,3164,449
14,3,11,0,13,206537,0,0,0,685
7,4,3,0,6,41047,0,0,187,708
12,2,10,0,9,167588,0,0,0,702
27,7,20,2,11,364617,18629,13,7001,440
8,2,6,2,9,7483,7483,23,4141,526
7,5,2,0,3,25244,0,4,631,623
11,9,2,3,18,206636,22397,0,0,487
16,5,11,1,69,300619,7207,24,7207,471
53,8,45,2,12,50956,35661,45,35250,520
4,1,3,0,17,4127,0,0,11550,542
37,4,33,1,21,482056,3764,48,26987,400
28,8,20,2,7,543158,318648,56,307418,481
14,9,5,2,13,871900,597477,2,0,612
60,6,54,0,19,832331,0,40,887,583
21,5,16,1,8,21936,884,15,1222,577
5,3,2,1,7,20129,6980,27,0,441
5,3,2,2,6,10970,2998,10,2738,487
7,4,3,2,10,53157,2084,6,885,620
21,9,12,4,16,197513,11594,16,9306,432
10,2,8,1,8,58103,319,13,882,508
10,4,6,1,12,485932,33957,25,0,677
9,5,4,2,19,85530,18060,20,369,457
21,9,12,3,6,169270,97501,138,24466,484
17,9,8,7,17,414677,139353,119,38559,464
7,4,3,1,8,201231,1300,37,0,590
6,4,2,2,11,338253,88438,0,0,442
6,3,3,0,12,4261,0,0,0,699
9,4,5,0,12,41828,0,1,0,633
5,1,4,0,4,0,0,52,1199,588
13,8,5,1,8,101140,1333,42,0,453
10,7,3,2,14,435885,78551,29,74299,414
34,12,22,1,16,2526139,8562,54,17141,452
17,8,9,0,14,639890,0,1,0,679
8,6,2,0,18,304780,0,1,8410,683
7,5,2,3,10,48303,34138,21,13452,485
29,11,18,6,12,273198,287960,60,3038,446
14,4,10,3,7,20193,17082,71,8759,455
9,2,7,1,8,11249,7330,12,250,621
4,2,2,2,7,46797,26660,43,2360,483
12,7,5,7,10,468247,80801,34,9265,487
16,9,7,1,8,1257981,482231,4,482231,573
45,12,33,0,17,143423,0,19,2270,545
6,2,4,2,8,336900,3040,36,0,566
20,5,15,0,6,384548,0,17,738,608
11,6,5,8,8,215637,213919,134,4570,456
8,5,3,3,18,878714,174680,106,139355,441
13,3,10,2,9,21929,32621,46,1323,481
9,5,4,1,7,48387,11686,31,11686,576
19,7,12,1,6,31082,181,48,612,462
3,1,2,1,4,14615,13795,6,0,609
18,15,3,3,8,335684,227489,20,0,489
6,3,3,0,7,94938,0,0,0,681
12,9,3,1,16,394625,108184,31,0,529
16,5,11,5,11,236588,26641,69,8438,485
9,2,7,0,7,15268,0,5,0,633
11,5,6,2,17,12639,12633,54,0,464
13,8,5,6,16,107613,104830,92,38307,386
10,4,6,3,11,22762,20700,48,16254,521
33,13,20,5,11,90268,40342,100,16249,440
5,1,4,1,8,0,29595,23,0,578
13,3,10,0,10,113969,0,7,912,534
11,5,6,0,26,36213,0,0,966,636
19,10,9,4,7,39938,4253,46,2580,554
9,3,6,3,11,15965,15965,186,16006,489
4,2,2,1,20,23210,23210,24,23210,584
17,4,13,3,7,38907,34804,126,8175,426
6,4,2,0,10,16831,0,0,0,563
9,7,2,5,13,580228,578598,94,198418,401
6,4,2,3,8,301765,10800,41,0,483
6,3,3,2,8,16525,16525,36,15452,437
5,3,2,3,6,20265,20265,189,15524,594
15,7,8,4,7,69479,23617,144,6414,449
11,6,5,2,18,117732,44172,71,3532,579
10,5,5,1,16,572746,94233,71,94233,490
12,6,6,4,19,13785,13486,64,6569,438
31,10,21,7,8,43021,16174,65,2067,451
10,6,4,6,6,21916,36143,110,16597,629
48,12,36,3,16,495685,19007,104,11752,442
13,5,8,3,12,35579,12827,51,1267,592
24,11,13,3,13,316126,1275,28,269,469
14,4,10,5,12,12008,28708,61,1701,493
13,4,9,3,18,40176,40176,71,12902,509
7,5,2,3,9,28882,17662,5,8498,441
14,5,9,4,13,455012,36366,47,3047,459
26,5,21,3,8,301010,355555,55,223157,516
17,2,15,2,11,7836,7836,48,5376,597
19,14,5,4,6,1349524,66634,6,1997,482
10,4,6,3,11,85493,7119,0,0,500
5,2,3,1,11,1538,387,22,387,542
27,8,19,10,8,203105,206905,234,1632434,449
16,8,8,8,16,1493882,60279,100,0,508
6,4,2,4,6,48755,48755,10,4980,440
24,5,19,3,14,70645,70045,75,1010,503
14,10,4,4,12,216184,17135,21,0,512
25,3,22,0,12,43535,0,40,35786,556
7,4,3,0,17,0,0,10,590,635
4,1,3,0,6,1236,0,0,0,509
38,12,26,4,10,347035,37452,70,5381,483
12,5,7,1,9,167242,1400,49,1400,462
7,2,5,0,2,22481,0,3,2138,524
21,9,12,3,14,211877,5176,53,4406,409
24,12,12,1,10,268517,6297,20,5533,466
14,10,4,2,8,409243,4366,15,0,560
6,3,3,0,7,52047,0,2,0,704
5,2,3,0,6,8165,0,0,0,587
13,5,8,7,8,399625,143477,127,10509,469
37,4,33,3,14,35453,21432,305,6612,459
9,6,3,4,7,248561,10915,45,2987,462
13,3,10,2,7,477,33762,39,477,507
24,11,13,3,14,241307,41948,35,19765,509
19,10,9,5,9,338912,172050,32,46489,468
17,7,10,0,11,474553,0,4,743,514
12,4,8,3,12,51371,9673,85,6876,482
13,9,4,10,7,211755,201980,399,105420,414
10,3,7,2,9,9755,9755,139,6517,602
9,4,5,2,15,27584,22334,66,0,462
6,4,2,4,5,5570,6432,14,3462,515
13,8,5,0,22,87492,0,35,1154,542
4,1,3,0,6,3593,0,13,0,644
11,9,2,8,7,50803,44161,71,11513,473
16,5,11,1,8,305652,4532,23,4532,606
5,2,3,0,6,21356,0,17,3113,615
4,2,2,1,8,6143,6143,24,6143,576
14,2,12,1,8,39207,4294,142,4294,539
18,9,9,0,14,81726,0,20,1824,539
13,5,8,2,17,643832,18360,50,1335,554
15,4,11,0,6,8854,0,315,730,462
11,5,6,2,16,335223,35437,0,0,446
5,3,2,3,12,16715,16715,0,0,500
17,5,12,2,9,14729,5173,0,0,496
12,8,4,4,9,70012,50490,0,0,451
53,23,30,1,16,1519443,3287,6,3287,517
8,5,3,0,8,306898,0,6,0,556
11,4,7,1,9,78237,11857,19,11857,443
29,9,20,0,11,432812,0,0,0,429
26,8,18,3,16,256228,12173,21,4228,517
10,4,6,3,9,15779,15779,223,17818,454
14,9,5,1,16,134964,27342,30,0,431
18,7,11,4,14,29211,19742,16,11606,398
5,3,2,4,15,43375,53059,23,21223,501
16,11,5,0,18,143888,0,12,0,537
25,6,19,7,15,326617,166008,118,76485,447
9,4,5,0,15,7064,0,3,2200,655
7,3,4,0,8,89426,0,5,0,565
19,10,9,5,16,346127,12829,87,5404,523
4,2,2,2,8,9408,12052,0,0,490
7,5,2,1,4,23745,392,2,0,553
3,1,2,2,10,6930,6629,46,5376,630
24,6,18,2,14,21826,6886,13,4803,487
31,11,20,7,10,557502,78231,0,0,443
26,17,9,2,7,762135,108108,4,91656,522
4,2,2,2,22,1063594,226898,30,0,635
4,2,2,0,9,0,0,0,0,770
19,7,12,0,15,175807,0,75,762,533
141,7,134,7,8,205594,87919,152,11656,481
17,5,12,1,9,51690,848,71,174,455
39,18,21,19,18,303541,278852,203,61052,435
4,1,3,1,8,32553,32553,0,0,508
20,4,16,0,13,169446,0,35,4527,624
10,2,8,6,8,12699,60672,0,0,492
15,7,8,1,7,27573,264,14,0,552
8,1,7,0,13,941,0,1,1278,672
15,7,8,5,10,38003,32121,31,15161,459
4,2,2,2,4,122659,122659,2,4414,477
29,7,22,8,14,27502,27011,88,8750,540
27,8,19,1,10,400112,14893,20,3780,586
12,2,10,1,12,276,162,16,162,625
8,2,6,2,8,28156,11676,0,0,456
16,6,10,5,12,38244,24188,46,31551,449
7,4,3,4,8,9272,6441,83,2037,459
45,13,32,1,14,346258,13967,24,0,607
6,3,3,0,1,17040,0,0,0,546
9,5,4,3,12,59039,19017,93,2050,525
84,14,70,11,18,90707,46700,124,8932,462
16,4,12,4,15,196713,111304,130,0,544
19,6,13,4,17,13136,14677,254,5604,493
11,3,8,3,8,26176,26176,80,0,517
23,4,19,1,9,11547,1692,31,488,652
10,4,6,1,18,186750,12953,0,0,557
8,4,4,1,16,35128,32335,46,0,526
25,10,15,1,17,1533260,155636,16,1548,511
41,12,29,2,13,415953,37293,20,3789,500
27,8,19,2,5,35224,1676,213,1843,528
23,7,16,4,8,18587,46820,83,9650,486
34,6,28,4,34,47277,19702,56,12590,480
10,6,4,5,8,141194,85299,0,0,545
11,8,3,4,11,288404,24147,26,7494,446
10,6,4,2,8,32405,20771,223,34570,498
35,16,19,0,32,1913058,0,13,0,581
16,5,11,5,16,341125,109616,136,44688,453
19,5,14,1,9,79730,52787,30,775,528
18,9,9,6,29,115049,1825627,112,76881,524
22,15,7,14,7,181533,184075,183,532,445
14,9,5,2,21,194561,4876,4,10571,610
11,6,5,8,9,100210,98558,8,12298,495
5,1,4,3,9,30369,31363,0,0,488
10,4,6,0,11,166351,0,0,620,547
14,6,8,4,13,408386,83745,73,0,498
10,7,3,4,9,47183,32234,3,17461,426
18,4,14,2,18,48858,18255,10,16965,560
56,9,47,3,9,79589,15286,44,3978,420
33,11,22,0,13,1634269,0,2,0,601
8,6,2,3,19,307462,30005,21,0,456
9,1,8,0,5,5512,0,0,0,607
12,5,7,3,16,774311,26946,44,0,626
12,4,8,5,9,38296,45428,127,13137,416
7,5,2,1,11,538500,13889,30,5431,474
33,9,24,4,8,72883,24907,96,7305,517
9,5,4,4,8,210603,25665,58,1473,464
18,3,15,3,10,298246,141030,45,4256,511
23,14,9,2,8,258619,4609,60,3400,466
16,4,12,1,12,9152,177,8,1000,508
17,14,3,13,6,50476,45698,220,8824,382
8,4,4,0,9,21034,0,11,0,590
11,4,7,3,10,37377,8971,35,5513,447
15,8,7,2,11,297605,1306,27,4821,547
10,7,3,1,5,275651,7321,0,0,503
8,6,2,0,2,301912,0,3,0,570
25,6,19,4,10,15085,13342,85,4994,371
9,5,4,3,4,39112,4422,6,2701,508
21,9,12,0,8,210714,0,270,8371,431
7,5,2,0,8,356053,0,0,0,538
8,2,6,2,7,21913,16418,34,12390,548
45,4,41,0,14,232657,0,22,2972,622
15,4,11,4,15,12978,23247,64,1161,518
4,2,2,1,6,25556,422,4,422,543
9,4,5,3,4,22240,15193,41,14776,435
25,14,11,1,13,1186795,864,43,1376,556
11,3,8,3,19,100252,87910,41,65947,503
13,3,10,4,10,91951,109646,89,1945,506
22,14,8,9,17,646382,228314,149,98824,421
6,4,2,1,2,22237,850,1,0,565
22,7,15,2,7,14960,5904,24,3778,480
20,2,18,1,10,21699,7547,10,1504,512
18,2,16,3,17,6104,6104,0,4152,499
29,8,21,3,14,170403,30081,143,16907,491
23,16,7,14,10,74132,73852,171,15724,411
27,3,24,3,14,4312,41339,65,4869,524
32,15,17,1,7,62195,1620,49,5788,646
5,3,2,1,7,13163,12175,1,3055,470
3,1,2,2,7,12239,12239,0,0,499
16,7,9,6,5,59187,35083,236,15843,503
12,5,7,2,18,508901,137080,47,1332,554
4,1,3,0,14,3683,0,15,0,529
39,13,26,31,14,1712688,3621709,400,182021,423
3,1,2,1,10,6478,1395,27,281128,512
7,5,2,3,10,978216,27673,67,612,451
4,1,3,1,5,1562,1562,10,0,529
11,5,6,2,8,233921,12076,26,50,527
7,5,2,3,9,11601,15821,0,0,515
4,2,2,2,10,20602,6988,51,2648,512
18,6,12,0,10,23621,0,0,0,501
18,11,7,0,21,808989,0,12,1323,521
5,3,2,2,13,26876,12822,54,4080,550
26,5,21,4,5,46307,41887,14,11393,448
10,5,5,5,3,29190,11678,62,2612,473
11,6,5,3,8,81123,52710,22,2780,439
9,7,2,1,5,93388,1452,16,498,535
7,2,5,1,14,99720,16499,0,16499,667
28,10,18,0,4,269847,0,3,0,676
7,4,3,4,6,26960,10843,6,4506,441
17,9,8,6,12,293109,50341,64,570,436
12,7,5,6,15,105248,72926,117,11900,410
29,11,18,4,11,574835,5890,104,1492,539
14,5,9,5,11,77639,89653,91,53929,480
8,5,3,1,20,208495,2003,40,0,624
12,2,10,0,12,184828,0,1,590,638
5,2,3,1,13,383772,3520,16,3520,655
21,9,12,3,7,95665,7358,6,5709,523
9,4,5,0,9,19232,0,12,0,507
19,4,15,1,18,28547,3906,5,7407,453
12,8,4,5,20,588313,223342,96,18131,431
8,2,6,3,10,179780,126565,49,10181,547
9,4,5,1,8,20986,7267,26,7267,491
26,9,17,10,15,372861,664908,188,300641,441
7,5,2,5,7,97744,97744,187,67820,451
14,11,3,8,4,275603,269961,58,4324,415
40,10,30,7,17,77056,52642,65,15266,448
4,1,3,0,4,15133,0,0,0,631
14,5,9,7,7,133492,123891,76,1822,460
18,4,14,4,17,18435,24835,85,2499,468
12,8,4,1,4,152598,685,35,918,500
32,6,26,3,11,87386,6124,54,7197,454
11,7,4,4,14,370073,43736,75,1686,500
46,13,33,8,9,32150,25850,139,8812,408
17,9,8,3,19,870058,13310,140,7992,542
28,4,24,3,10,7872,8002,204,5303,601
18,9,9,3,2,154507,29552,17,14769,408
5,3,2,2,4,87134,2733,35,2895,504
3,1,2,0,7,16291,0,0,0,550
6,4,2,4,7,12758,12758,46,4932,397
5,0,5,1,10,12315,12315,2,12494,622
8,2,6,1,13,47621,17230,32,0,526
8,6,2,6,3,21890,27864,56,7140,436
17,9,8,6,12,48043,30785,66,15000,464
23,11,12,2,16,95680,19770,36,2600,525
10,8,2,1,17,339484,1099,3,0,563
28,16,12,3,21,849713,395514,30,136795,447
532,14,518,5,14,33449,25217,388,9389,454
54,11,43,4,14,634283,27793,268,374931,469
18,4,14,4,11,92555,58816,0,0,455
8,5,3,1,11,25854,1130,1,4314,452
22,13,9,0,18,1547108,0,0,0,674
22,5,17,1,8,6837,4921,20,0,543
15,5,10,0,14,541,0,29,58629,598
11,5,6,5,25,97674,220727,118,0,504
6,2,4,0,17,0,0,1,167,630
19,7,12,1,14,167594,2172,122,2172,531
15,12,3,0,8,427874,0,0,0,580
5,3,2,1,11,15116,3063,0,0,686
45,18,27,13,9,1466228,382491,9,17834,444
52,9,43,7,13,314444,62993,178,9508,483
20,8,12,4,9,71712,61304,86,21506,423
10,6,4,0,7,37185,0,33,0,651
23,11,12,5,8,49192,6555,53,4036,423
11,8,3,0,15,778774,0,25,61038,526
69,12,57,9,9,104997,80243,188,7443,402
8,5,3,3,69,47740,4275,42,7435,500
22,2,20,1,12,39135,2812,13,0,542
43,4,39,1,13,323327,682,7,3620,488
9,2,7,2,8,337191,14287,36,7887,592
13,6,7,7,6,53443,147059,8,32613,437
19,7,12,5,9,10377,3958,91,1272,516
63,7,56,2,10,165830,21496,128,2761,446
34,9,25,8,11,720243,307478,149,9997,483
20,17,3,0,18,444604,0,41,622,615
43,18,25,0,29,316095,0,7,1155,577
35,20,15,19,9,74722,73289,324,8531,420
23,10,13,5,5,50246,27483,129,7377,429
7,3,4,1,10,11642,7463,23,7463,668
15,8,7,4,8,256843,14981,95,3499,606
24,8,16,11,13,103160,125516,116,12033,427
26,12,14,9,19,679815,97692,55,3223,523
19,10,9,2,15,436873,19753,95,12048,488
6,4,2,1,12,108307,365,0,0,491
20,11,9,0,18,715437,0,23,1429,619
78,17,61,4,16,736509,15357,163,11192,438
4,1,3,0,13,0,0,0,20605,703
21,8,13,0,11,109334,0,6,0,640
18,11,7,7,13,174452,42795,1,1478,515
17,7,10,4,7,33442,1800,11,824,605
12,5,7,2,5,240734,14175,11,0,505
13,6,7,8,6,113295,41745,153,4029,462
4,1,3,1,4,2476,2476,7,2476,494
36,13,23,4,13,116369,21912,59,8288,471
12,8,4,8,6,23716,26218,47,11118,431
8,1,7,0,2,2000,0,1,2000,534
6,4,2,0,10,82345,0,0,0,628
15,6,9,1,8,74118,46876,12,0,557
14,3,11,2,9,26144,261,3,741,567
6,4,2,3,5,7114,2213,148,1848,555
9,3,6,2,15,2236,2066,66,363,545
11,3,8,6,8,26997,51687,0,0,543
13,7,6,5,27,50649,44883,73,21648,416
22,12,10,5,18,1065663,176639,122,43243,453
9,5,4,5,18,9378,46313,55,8675,477
22,4,18,1,12,539539,217380,55,217380,474
3,1,2,0,10,0,0,0,0,634
18,8,10,4,15,173945,18681,52,11188,560
14,10,4,4,20,410309,21330,86,5362,529
18,2,16,0,9,51427,0,41,8419,544
50,31,19,2,18,159924,16463,24,13790,533
6,4,2,2,17,476196,112760,18,110165,563
9,6,3,5,12,11631,21526,121,25218,474
8,3,5,3,10,11518,11518,21,642,430
23,12,11,4,11,36350,16930,47,4147,444
12,6,6,6,15,85367,54922,30,23663,441
16,7,9,5,13,99250,99250,80,40109,504
26,20,6,12,16,349847,347864,112,20187,430
11,4,7,4,14,20884,17363,61,1870,439
53,29,24,25,11,806553,667338,459,37745,396
16,13,3,6,9,87336,15697,62,13569,547
6,3,3,2,6,24402,24402,158,14854,441
7,4,3,3,9,12545,12545,69,0,568
17,9,8,9,12,327735,122123,41,14328,419
18,7,11,1,13,263532,2048,17,2048,447
33,17,16,6,14,101940,57699,191,15220,384
10,4,6,4,13,24472,30333,55,2315,468
15,11,4,7,14,30377,22292,9,2387,446
19,2,17,0,12,33805,0,39,890,632
10,5,5,0,5,78377,0,3,893,555
16,3,13,2,5,8736,8736,37,0,516
8,3,5,2,10,25294,25461,45,18751,603
16,11,5,5,11,133698,43363,142,13848,443
12,7,5,7,14,33142,34937,84,14281,576
36,9,27,5,11,118398,38923,130,6328,467
72,13,59,5,12,263724,258775,64,29461,474
20,9,11,0,6,406020,0,19,42,553
3,1,2,1,1,30257,494,1,0,632
12,1,11,2,8,5091,5091,0,0,499
12,7,5,5,9,54946,47615,118,0,510
14,7,7,3,7,48824,54325,63,0,473
8,5,3,0,6,48009,0,17,2394,496
13,8,5,6,10,138406,150314,62,33728,413
5,1,4,1,6,4280,4280,9,4739,423
10,4,6,2,12,73969,30616,60,0,523
13,8,5,4,11,104053,4432,31,0,477
28,7,21,0,8,48536,0,9,0,620
14,5,9,3,13,53219,3973,87,1197,451
5,1,4,1,13,1,12532,14,797,490
8,2,6,2,19,149575,59219,59,3194,584
10,6,4,1,10,709699,953,23,953,528
24,10,14,15,8,385128,237309,346,40888,455
6,2,4,3,15,366812,85666,14,2055,451
12,3,9,1,9,26733,5998,50,5998,558
18,11,7,3,7,650351,35775,76,6116,458
6,4,2,1,4,6761,3574,32,3574,560
5,2,3,0,12,121116,0,9,32289,538
44,6,38,6,16,22964,22964,107,6386,452
3,1,2,1,11,71749,32227,26,21167,515
39,5,34,2,10,20604,18427,48,13494,529
88,8,80,6,8,71270,40717,117,15359,516
7,5,2,6,8,244558,331859,107,0,439
21,13,8,0,14,797318,0,16,5187,536
16,5,11,5,24,67586,87182,335,36395,490
14,6,8,3,12,207163,16002,25,841,430
45,7,38,7,12,60261,42727,175,11770,441
7,5,2,2,13,28043,14587,5,9226,564
7,4,3,3,11,19277,4043,64,0,452
62,5,57,2,8,158725,20553,1,803,604
9,3,6,0,4,58680,0,2,242,628
10,2,8,1,12,245917,36042,38,0,607
15,4,11,1,10,91052,9095,19,0,537
11,6,5,0,14,753343,0,0,1812,628
23,14,9,5,11,62570,6386,16,0,476
8,5,3,3,17,28881,28881,67,15138,481
7,2,5,1,10,32387,31063,29,444,557
6,4,2,0,3,7510,0,0,0,644
45,9,36,2,13,409620,11775,44,0,486
20,8,12,2,11,53441,10383,8,975,511
25,10,15,1,10,250940,3661,26,2027,421
39,2,37,1,17,47240,21575,21,5645,542
73,11,62,9,15,81666,77846,98,33941,462
11,7,4,3,4,248247,41926,55,0,497
14,6,8,6,9,300897,33765,65,3920,460
9,4,5,0,7,62316,0,0,0,602
68,7,61,3,11,48992,22284,52,8342,609
4,2,2,0,5,86486,0,0,0,621
5,1,4,0,8,7422,0,0,0,594
10,2,8,0,16,104144,0,4,2042,575
25,9,16,4,17,453877,27537,123,6861,523
6,2,4,3,6,22154,19531,17,6960,526
55,25,30,6,27,1933444,74645,54,14166,490
25,2,23,0,8,2600,0,40,6640,650
11,8,3,4,11,338276,22124,86,1667,403
44,4,40,1,17,13780,8171,6,8171,635
21,8,13,7,13,237232,63498,131,7350,450
15,10,5,0,8,868478,0,24,1093,511
21,9,12,4,14,366970,15966,56,23098,451
12,6,6,1,12,17356,17356,72,17356,532
6,4,2,1,10,204797,8937,14,8937,636
36,16,20,11,15,291419,47181,79,11931,452
15,4,11,3,6,204041,124142,52,437100,447
9,1,8,2,8,65520,31794,35,2226,529
16,11,5,9,19,47426,42674,101,10069,387
10,5,5,3,12,95950,175643,64,3017,469
28,11,17,0,6,257791,0,28,288,553
34,4,30,4,14,54240,41156,75,28360,458
11,7,4,6,6,108117,96780,95,42121,403
28,6,22,1,12,29862,2658,98,883,483
10,5,5,0,22,364314,0,75,4435,638
7,5,2,6,8,16941,25045,80,2223,414
5,2,3,4,7,120537,37672,86,0,503
14,8,6,9,10,35294,44666,136,3481,442
11,7,4,0,10,72394,0,0,4190,474
18,10,8,1,15,690230,7997,23,5712,558
63,8,55,5,12,50278,28190,51,7174,439
22,5,17,1,9,39745,9955,16,1687,638
40,11,29,5,12,263624,33645,114,21000,427
4,2,2,0,2,548077,0,4,0,571
31,11,20,8,13,155509,1116574,194,0,469
15,9,6,7,9,198135,184975,107,92119,407
28,14,14,1,16,3429604,7348,18,10723,443
16,7,9,2,9,446246,26764,34,24910,520
7,3,4,2,13,19332,15611,18,11488,500
11,7,4,9,8,51375,47114,120,20999,431
11,0,11,1,7,121674,41286,37,400,603
13,6,7,5,11,226638,410116,81,115794,464
19,12,7,2,28,1682318,737,19,247,506
11,5,6,3,7,326461,28242,57,6318,512
25,7,18,2,8,44723,2466,102,503,531
12,8,4,1,7,84744,774,29,3007,525
15,5,10,4,14,3043,1923,50,5000,520
4,2,2,1,5,631,631,1,631,508
7,4,3,3,6,8363,8363,54,3178,572
34,12,22,3,12,48825,1044,81,1605,523
72,6,66,0,18,463909,0,10,1859,647
34,9,25,4,9,105890,13258,87,2224,459
13,5,8,3,12,51840,19723,70,11705,450
6,4,2,2,5,190197,8909,27,1319,524
13,8,5,5,13,49404,44300,60,10022,444
119,10,109,9,7,71801,51120,190,11879,450
28,12,16,0,11,1110333,0,1,0,641
25,4,21,3,15,76225,76225,74,10185,525
32,5,27,4,8,20032,26350,147,4900,527
45,6,39,5,11,32194,32299,76,10971,455
9,4,5,3,12,581067,172471,15,3031,578
6,4,2,5,8,48933,32548,24,11433,491
26,4,22,4,8,10335,10335,74,5999,483
8,6,2,1,13,401042,6941,23,6941,541
40,8,32,8,8,167426,161517,260,144651,425
10,5,5,3,19,11211,10420,80,4695,488
10,2,8,6,8,64918,79206,12,2097,460
7,3,4,2,8,19148,98597,27,1198,538
23,9,14,1,14,398491,582,8,11000,556
31,7,24,2,16,399431,8223,18,312,474
37,10,27,4,13,25370,26625,67,17448,568
3,1,2,0,9,0,0,0,0,747
13,3,10,0,3,17147,0,1,694,501
24,7,17,5,2,30225,6522,50,5672,487
21,13,8,11,11,268995,158879,273,17154,423
17,7,10,3,13,613360,28403,14,6906,431
31,11,20,1,5,1564978,9376,10,11035,564
30,10,20,5,19,101666,53073,96,23052,462
17,7,10,1,12,275976,2877,16,1050,492
11,7,4,2,8,81581,15538,30,10956,608
22,11,11,7,13,168152,89862,140,8548,476
29,5,24,2,12,333933,53818,23,7000,432
14,8,6,1,9,111605,3180,0,0,534
30,7,23,2,7,191360,6169,74,7058,453
12,6,6,7,16,439185,110670,62,53187,469
8,5,3,3,9,501382,38780,29,0,466
3,1,2,2,19,2119,63741,24,2119,633
9,4,5,2,9,25136,19904,30,19903,484
29,5,24,1,21,40603,21300,13,21300,677
15,10,5,0,20,189301,0,1,1,661
23,3,20,1,7,14382,8824,10,8824,587
8,4,4,5,15,210131,41550,104,0,490
11,5,6,7,11,428841,537300,151,215726,541
7,1,6,1,12,13949,13949,15,13949,465
11,3,8,7,19,31636,301357,145,0,509
16,2,14,0,11,16067,0,4,21206,546
10,4,6,4,13,234028,214994,34,104961,433
5,1,4,0,14,15073,0,0,0,656
12,5,7,0,26,105166,0,0,0,662
109,7,102,2,12,214258,3418,59,7407,551
4,1,3,0,13,0,0,3,0,688
27,7,20,2,12,314231,14856,36,6167,520
48,5,43,3,18,91664,26767,32,20906,538
15,6,9,2,6,256147,11677,88,3910,464
10,6,4,1,11,53071,892,6,892,547
4,2,2,4,5,962090,672764,49,377397,457
19,4,15,5,13,140288,140288,167,64800,467
18,9,9,0,8,49512,0,1,925,657
58,15,43,6,12,178266,69200,31,48652,462
21,11,10,10,20,69363,65909,71,26434,457
9,1,8,1,8,4160,2063,25,0,525
67,16,51,20,12,1997663,2616655,337,133281,382
25,5,20,0,12,326586,0,18,0,589
12,7,5,7,7,348718,34240,263,6720,490
11,5,6,0,7,13631,0,19,0,618
10,8,2,3,16,52590,42286,103,16464,485
8,4,4,3,12,335383,31194,41,2357,478
13,9,4,8,11,26098,20667,289,12067,465
44,5,39,6,18,143049,181789,415,89196,517
11,8,3,8,21,471441,206985,75,0,453
12,5,7,8,19,198916,292984,13,86883,421
15,9,6,0,10,142678,0,43,1249,568
40,15,25,7,6,578032,14766,2,5347,464
14,4,10,2,13,341891,10471,23,6872,556
23,12,11,9,7,281857,99502,86,26283,484
8,5,3,4,12,36147,27228,0,0,561
15,9,6,9,18,42826,59848,136,9883,446
9,4,5,5,16,71048,157744,0,0,476
11,3,8,2,9,27016,11061,87,0,534
10,5,5,3,12,49333,71598,143,11312,452
16,10,6,6,33,24356,657348,82,2480,465
15,9,6,1,15,654049,5232,0,0,505
14,6,8,7,6,257336,200610,49,25629,480
8,6,2,2,19,236118,6210,17,876,415
13,4,9,3,7,16662,15010,1,1112,457
28,8,20,4,8,135827,3826,200,2347,450
31,29,2,1,13,1038057,107713,12,107713,496
49,10,39,7,11,62233,34531,159,18522,429
3,1,2,0,13,0,0,0,1096,593
36,22,14,0,17,229367,0,30,1585,531
28,14,14,1,15,4443627,1549,26,0,486
36,7,29,4,16,357842,76772,161,11856,556
47,9,38,4,13,60123,31276,248,24530,455
20,6,14,5,12,590415,78940,387,46320,449
40,8,32,3,6,36836,14457,51,7831,427
11,4,7,0,11,184716,0,65,32779,650
5,2,3,0,23,0,0,0,540472,697
43,9,34,8,14,693923,100792,212,26500,472
24,6,18,2,9,40949,14339,17,2606,452
32,6,26,5,18,123650,88996,36,20019,425
39,18,21,15,8,303874,140997,200,8726,417
46,4,42,1,7,24515,1408,18,8109,573
9,6,3,3,9,464630,8584,72,4872,435
9,5,4,1,5,18924,732,10,0,531
32,6,26,4,11,34910,28788,118,12923,505
9,6,3,5,12,338415,56513,86,6957,397
8,6,2,1,12,43890,3720,23,3720,517
7,4,3,3,8,35489,17654,111,2334,447
31,13,18,8,9,163791,80451,193,10885,393
7,1,6,2,12,3668,31328,36,0,505
49,10,39,11,19,54287,20988,194,3360,435
26,5,21,4,26,543134,57930,63,0,552
13,8,5,8,10,1831452,394794,235,13029,545
12,4,8,5,13,42774,39185,67,13748,429
3,1,2,1,7,11039,10069,27,0,555
15,5,10,2,13,41569,3149,31,2373,562
15,3,12,2,16,32254,32196,26,10058,565
5,3,2,4,19,129112,94144,63,12518,573
8,2,6,1,8,6995,3630,12,3630,608
25,13,12,1,9,119967,399,47,429,520
23,2,21,1,18,192586,8548,29,8548,511
10,6,4,4,7,11622,11622,101,4656,456
18,3,15,3,18,38078,28351,77,20810,482
15,5,10,2,5,35672,229,11,197,556
8,6,2,6,6,233345,28861,94,10956,416
10,4,6,4,28,42339,64312,48,26239,438
12,5,7,4,4,130788,3233,5,0,533
18,2,16,0,9,6686,0,1,257,676
17,7,10,8,18,53317,81523,150,10500,479
10,3,7,3,24,30523,28937,67,815,660
12,8,4,0,7,67298,0,45,1310,492
23,4,19,3,9,11966,11501,293,7019,527
9,5,4,6,11,299367,37042,58,2615,571
22,11,11,11,11,391072,332325,74,13662,429
24,9,15,0,13,3151225,0,1,6139,682
16,8,8,2,7,55944,3307,210,2464,451
15,5,10,1,5,227204,807,1,807,528
6,3,3,3,7,51750,63098,45,17755,517
23,5,18,0,9,132453,0,26,433,600
39,10,29,1,69,100548,30050,75,4530,525
8,4,4,5,9,296750,84902,77,0,483
20,6,14,5,8,28109,26859,52,882,504
5,2,3,0,5,10136,0,5,0,645
32,4,28,4,14,14612,16593,63,8708,528
18,8,10,1,12,125678,2808,25,13405,542
6,2,4,1,11,501089,45086,12,0,605
12,9,3,3,7,849013,8964,9,718,453
5,2,3,1,16,14650,4650,4,4650,527
6,4,2,3,7,184042,23480,40,6727,460
14,7,7,4,8,127002,18280,30,670,395
9,7,2,4,6,431128,17418,74,10356,452
8,2,6,0,4,61454,0,0,0,670
13,5,8,3,7,25945,13466,49,8460,458
21,11,10,1,23,652778,1640,8,0,609
13,6,7,3,18,11197,10115,40,3923,463
7,4,3,5,8,19830,19830,134,7176,478
20,9,11,4,14,643529,125700,83,3916,394
12,5,7,2,12,632943,26446,12,0,415
42,11,31,9,6,87785,58061,114,15180,440
16,5,11,5,12,69947,36614,44,18507,436
16,6,10,0,8,757357,0,0,0,557
7,4,3,0,6,28119,0,0,0,594
7,4,3,1,4,49132,3099,2,3099,469
15,8,7,9,7,29211,34067,90,9026,445
5,2,3,4,6,25189,39566,8,14090,436
14,7,7,5,14,33138,32057,60,49647,459
3,1,2,1,7,10710,10710,150,21420,619
11,5,6,4,8,99221,12987,71,7579,519
13,5,8,3,12,75777,60723,84,12127,474
9,6,3,0,11,12660,0,0,5633,580
14,12,2,5,8,26752,25941,113,7867,441
23,12,11,11,5,114913,109608,293,15634,497
9,5,4,1,13,300788,5610,4,5610,637
16,4,12,1,13,1564,1345,28,1345,537
7,3,4,2,8,10732,22881,26,16623,491
5,3,2,3,19,15080,18577,35,383022,537
16,8,8,3,15,18976,2881,58,4831,455
4,2,2,0,7,0,0,1,0,683
9,6,3,0,10,62457,0,3,0,604
6,3,3,0,9,12604,0,0,0,629
16,6,10,3,7,74110,32707,50,20116,487
5,2,3,1,23,184874,184874,5,184874,529
16,12,4,11,23,475137,809547,175,418202,435
8,3,5,2,8,68645,14571,15,8616,542
9,3,6,2,14,245312,28170,47,2863,481
18,7,11,0,8,65162,0,29,7064,511
16,1,15,0,10,7479,0,15,817,609
29,9,20,2,12,141899,111288,21,567,489
52,9,43,6,15,77750,51478,129,4789,459
8,4,4,5,9,382055,379990,37,0,424
13,4,9,2,13,216707,2221,26,1213,564
28,8,20,5,15,39985,8549,39,2642,427
31,9,22,7,15,51631,21228,129,7407,438
10,5,5,5,7,25000,25000,107,6595,426
9,5,4,4,19,15492,14861,29,6079,567
7,5,2,3,17,2946,2946,69,1643,524
12,4,8,4,18,202296,189090,41,4247,471
8,5,3,4,13,505432,97166,45,22176,458
25,11,14,11,21,22219,56437,85,8247,436
8,5,3,1,8,31190,92785,12,11850,427
4,2,2,0,7,8753,0,1,577,616
15,5,10,0,9,18605,0,19,676,612
23,6,17,5,23,134001,161338,2,3045,408
6,1,5,2,9,4229,4229,14,3848,481
10,7,3,6,8,50445,44332,114,33719,411
7,4,3,1,10,154090,3908,9,711,506
4,2,2,2,6,4732,4732,44,3496,539
9,4,5,2,20,527067,36053,113,9702,476
6,4,2,2,19,73600,72292,0,0,555
29,12,17,13,22,364577,156487,89,25112,473
60,6,54,1,11,28735,9317,9,9317,588
8,6,2,6,10,78740,60892,35,2532,546
4,2,2,0,5,9968,0,10,0,546
10,4,6,4,17,31675,32231,0,0,466
8,6,2,0,11,211314,0,11,0,552
23,6,17,3,7,263816,2157,42,716,569
28,6,22,2,14,68133,1921,30,540,629
8,3,5,4,7,421756,45697,14,5064,451
13,11,2,3,4,387997,12812,33,649,461
13,11,2,0,8,64982,0,11,250,597
22,8,14,0,7,188077,0,52,3708,443
16,5,11,2,13,27602,29164,22,23855,609
11,5,6,0,3,19929,0,2,1007,511
13,4,9,1,27,156843,16737,0,0,500
14,8,6,7,9,383519,118625,170,38057,477
4,2,2,1,8,16613,11520,13,0,617
4,2,2,1,4,10743,4459,0,0,515
33,7,26,3,12,580320,104272,71,92293,413
22,12,10,1,13,517216,62271,10,62271,487
11,5,6,1,14,435521,5573,19,5573,498
12,7,5,8,7,46441,46119,0,0,452
30,5,25,0,9,399647,0,0,0,591
7,4,3,1,8,18916,457,3,714,650
9,5,4,0,7,38318,0,1,233,702
11,2,9,0,13,49258,0,0,0,567
18,5,13,0,10,53216,0,20,667,666
8,5,3,0,7,5128,0,40,0,507
45,12,33,8,7,74036,49485,164,1945,469
52,6,46,5,8,111727,34126,131,13090,485
4,1,3,0,14,0,0,2,4691,713
10,5,5,1,7,38700,11686,30,11686,672
3,1,2,0,12,136,0,5,216,496
8,6,2,1,10,402334,780,22,31292,406
24,8,16,1,18,415997,10501,27,2300,554
12,6,6,2,22,56822,26736,216,8220,465
20,4,16,3,13,1325193,323620,30,0,555
5,1,4,1,11,328835,2297,0,0,613
15,10,5,7,9,44204,19331,45,4980,469
6,3,3,1,11,571392,30308,23,30308,542
5,3,2,2,15,15604,15604,35,4603,503
24,10,14,0,15,363693,0,2,0,585
14,6,8,1,8,217948,13632,0,0,543
6,0,6,1,7,26863,26863,8,0,622
9,5,4,5,12,136755,50841,92,25964,476
50,18,32,2,7,198842,14570,82,8222,487
42,6,36,3,13,11402,4204,2,5264,498
13,10,3,0,4,322047,0,18,49,515
19,5,14,0,13,211072,0,0,0,594
15,12,3,1,12,383566,3944,0,0,652
66,10,56,8,11,59623,56258,69,20189,417
25,8,17,0,13,503687,0,0,0,680
23,14,9,2,20,8944008,16141,0,0,544
23,10,13,4,11,403447,23260,39,7873,484
12,10,2,0,9,47704,0,7,56,655
35,13,22,0,12,95313,0,4,0,597
11,0,11,0,8,0,0,13,1299,575
17,4,13,0,9,143390,0,10,1299,469
124,10,114,6,12,374480,80957,140,29359,451
9,4,5,3,15,38874,21778,30,13394,457
6,2,4,2,7,20700,3943,38,3958,440
13,4,9,4,13,18391,33638,45,15247,471
16,11,5,12,9,67626,83836,131,16577,492
7,3,4,1,9,9619,9619,100,9619,603
17,2,15,0,10,3098,0,35,2660,471
4,1,3,3,12,21904,20893,9,10877,464
7,5,2,0,5,407742,0,1,0,484
7,5,2,2,13,66410,42364,15,19462,497
14,2,12,2,9,4008,4008,72,7186,510
10,4,6,1,30,28463,18483,79,18483,517
8,3,5,1,14,3503,2891,0,2160,534
16,3,13,3,8,16986,12978,49,5994,458
8,5,3,1,12,489042,489042,54,562,576
8,5,3,2,8,58387,4360,44,2175,530
23,11,12,7,13,74351,63677,117,2739,479
6,1,5,2,13,10451,11169,1,3189,537
28,5,23,3,4,24735,19682,28,9098,427
27,6,21,6,9,466696,8705,25,4273,454
30,5,25,1,9,87407,4011,0,0,652
10,5,5,5,7,24629,23298,66,14272,455
14,8,6,0,8,296491,0,13,0,543
9,2,7,0,8,110103,0,1,0,598
8,2,6,0,13,0,0,1,0,637
8,4,4,0,10,641946,0,15,6471,570
14,4,10,2,8,90300,5279,18,16129,535
7,1,6,2,8,85968,85968,0,0,656
16,8,8,7,18,15384,12806,0,0,509
28,7,21,7,19,474227,32476,167,952,493
8,5,3,0,9,204294,0,8,0,563
28,10,18,7,12,279038,204471,140,14406,449
24,4,20,2,8,2736,836,92,512,462
10,3,7,2,9,8418,3842,36,2368,454
11,9,2,0,7,177202,0,1,0,588
39,13,26,3,18,105490,29795,118,19352,493
9,3,6,3,14,28096,4826,65,7805,481
9,3,6,0,14,138207,0,9,0,628
16,10,6,5,15,412680,31813,47,1490,567
24,8,16,5,10,278557,15890,64,5535,492
5,3,2,1,5,14483,1304,28,0,487
6,2,4,1,5,33687,10287,32,0,555
2,0,2,1,6,4421,4421,0,0,631
8,4,4,5,8,12983,14925,170,6237,458
26,14,12,4,17,432782,102705,83,0,565
22,10,12,0,13,89138,0,62,1550,489
51,27,24,12,29,641216,87140,540,20398,475
10,6,4,0,14,106613,0,10,0,537
8,3,5,5,8,6311,20490,72,2196,425
7,5,2,4,18,752967,186972,53,17576,453
24,10,14,7,16,392000,105421,111,35232,393
10,3,7,2,8,14552,1833,31,438,511
15,5,10,4,15,39600,13710,105,7174,450
6,4,2,3,7,9092,22875,93,5713,611
30,4,26,2,11,7328,6891,57,6074,548
3,1,2,0,12,237783,0,0,0,685
7,4,3,0,2,15216,0,0,0,593
9,3,6,2,7,66488,58390,69,305,473
18,3,15,0,14,24391,0,5,0,644
8,5,3,3,7,91785,91567,71,82493,420
37,4,33,4,19,80183,80183,122,33759,537
16,5,11,1,29,77760,16051,17,16051,563
19,12,7,0,12,442949,0,0,0,651
17,10,7,9,11,86677,100855,135,23052,459
21,14,7,2,9,364568,7561,10,0,572
16,12,4,0,5,689628,0,13,17903,622
12,7,5,1,10,954853,26380,21,26380,537
11,6,5,0,11,160808,0,4,0,582
18,6,12,0,7,19230,0,13,412,673
23,5,18,2,18,8195,7133,20,6837,492
17,3,14,0,16,40726,0,1,493,621
11,2,9,1,5,55185,5009,62,2599,485
27,12,15,0,27,151242,0,32,1288,611
12,3,9,0,19,63579,0,9,3286,652
32,7,25,2,15,26475,15710,54,4706,443
14,8,6,0,20,158178,0,9,0,715
12,4,8,2,17,50487,14309,8,11556,554
18,11,7,0,15,251429,0,2,0,688
8,5,3,5,20,913707,913686,25,236475,527
28,13,15,5,12,405207,116331,45,0,444
6,1,5,0,4,1200,0,0,0,617
8,5,3,0,4,43198,0,0,0,627
4,2,2,1,11,2044,806,46,0,548
8,5,3,2,8,343438,15589,66,0,458
5,3,2,3,6,10612,10612,52,6660,508
32,7,25,0,6,59967,0,3,2138,620
9,6,3,0,5,78662,0,1,0,644
6,3,3,0,14,0,0,3,0,714
22,20,2,0,8,383265,0,278,0,593
9,7,2,6,10,123597,106412,375,76759,450
18,9,9,14,7,522886,857243,257,304622,461
15,5,10,3,19,24884,3412,42,2422,446
16,3,13,3,13,15488,14577,23,8318,439
7,5,2,0,4,14609,0,4,0,566
6,1,5,0,6,56123,0,0,0,602
20,6,14,4,7,41109,38317,155,20661,507
15,6,9,3,18,462886,36787,0,735,490
20,7,13,1,13,160509,2025,20,5243,595
18,5,13,2,7,47000,10271,80,5536,484
10,3,7,2,14,8301,8301,48,6415,527
16,2,14,4,8,30670,70164,10,7659,486
7,5,2,0,4,132436,0,1,0,588
13,8,5,8,7,220608,220608,105,16930,427
37,6,31,5,7,125352,134881,16,10987,438
21,9,12,2,7,75842,18100,83,9399,523
27,8,19,2,23,78177,44497,34,39024,689
13,6,7,3,10,268264,25106,32,5660,514
8,1,7,2,3,2981,10681,23,7700,499
6,4,2,4,9,9291,9291,0,0,481
12,4,8,2,21,43361,38577,48,0,519
11,5,6,2,8,40659,32294,36,2718,483
10,5,5,0,7,140633,0,0,0,660
27,13,14,14,28,1150809,760837,172,0,551
11,5,6,0,9,168162,0,24,9839,599
14,7,7,7,17,380106,117109,113,88817,433
17,7,10,3,14,49183,33301,23,23888,424
22,6,16,0,14,63483,0,0,0,722
47,9,38,3,8,325016,36499,65,33400,389
23,14,9,10,11,606045,94025,88,11920,371
27,9,18,11,7,2582449,1938366,226,500,442
54,8,46,0,17,213062,0,6,4568,581
10,2,8,4,6,15968,27157,34,11157,490
12,2,10,2,10,14122,30024,51,2550,515
15,7,8,4,9,206720,146493,107,5475,495
13,7,6,10,12,106610,238640,168,54454,428
31,14,17,10,12,546272,158162,179,7434,423
14,8,6,0,6,640724,0,4,0,529
88,8,80,3,7,101625,13379,29,819,420
15,4,11,3,12,146360,21885,64,16195,494
40,10,30,8,17,254527,23356,229,79659,482
16,11,5,10,18,133829,123886,202,11044,447
15,3,12,1,12,10712,5150,21,5150,465
38,6,32,3,15,24214,20498,45,11378,521
5,1,4,1,14,4550,4550,14,4550,549
11,3,8,0,14,432443,0,117,2631,652
22,4,18,1,16,23524,30558,14,1314,528
15,7,8,6,15,552605,132808,112,52239,451
9,5,4,2,5,41553,6145,85,1103,457
42,8,34,4,13,213707,22149,14,17638,417
17,9,8,2,17,901344,18497,34,6149,472
13,9,4,4,10,1102097,43476,21,0,447
14,7,7,3,16,154687,93865,135,4315,460
33,10,23,7,6,111382,46283,37,11629,495
25,9,16,8,17,50365,52753,135,9490,333
134,10,124,5,8,489086,132721,56,56400,461
20,9,11,0,17,281426,0,25,1069,686
21,17,4,1,11,407474,2045,8,4090,606
8,4,4,5,18,64312,50299,71,6750,457
18,8,10,2,4,49271,1570,34,2295,570
11,5,6,2,11,414653,9258,100,8980,509
13,8,5,2,26,57750,6683,64,4675,466
35,8,27,1,10,35536,2353,124,2353,536
16,12,4,10,14,8162,13036,90,3624,452
29,7,22,5,15,77903,48066,139,25882,455
13,6,7,6,9,54307,56170,149,14898,441
26,11,15,14,25,415771,454252,251,101609,473
21,7,14,5,15,25296,17157,95,2467,481
6,2,4,1,7,2477,2477,22,2477,537
1056,13,1043,5,10,45108,29116,85,10723,448
13,9,4,3,10,397824,17678,74,23372,524
3,1,2,1,12,984,984,0,0,518
30,13,17,2,69,296893,2089,49,1831,469
11,8,3,1,18,317334,73,0,0,566
6,4,2,5,8,26317,27284,109,8855,564
11,7,4,0,10,240623,0,1,1765,544
12,4,8,2,6,334974,11380,105,3918,513
27,14,13,0,22,490882,0,46,0,551
4,0,4,0,10,0,0,21,4974,622
10,5,5,5,9,55983,56303,0,0,529
34,6,28,4,14,167888,120660,46,116033,450
12,3,9,4,9,30249,24580,53,6654,434
11,3,8,4,12,92804,92804,45,11678,482
18,7,11,3,11,60922,11444,17,0,443
16,11,5,4,17,413032,105304,0,0,480
11,9,2,8,8,77573,35879,141,7301,461
14,8,6,6,8,35015,17411,46,5681,449
6,4,2,3,10,29554,12312,45,7823,486
10,8,2,7,8,72845,96722,256,49002,436
21,6,15,4,17,5158,2358,43,1087,499
5,3,2,4,7,18768,18768,117,9045,480
34,17,17,15,25,490842,113114,258,11718,417
7,3,4,2,10,14958,21338,17,12515,613
30,5,25,0,7,36087,0,9,2918,542
13,9,4,7,10,500769,63396,92,5993,443
67,7,60,3,14,639275,13629,184,4675,471
3,1,2,0,9,5218,0,66,3094,548
33,8,25,3,8,43120,21747,101,18287,466
13,9,4,4,9,19584,1846,35,889,537
13,2,11,2,13,396783,99816,50,0,539
12,2,10,0,11,11449,0,0,235,635
9,6,3,7,16,350998,149551,218,21210,418
8,3,5,3,8,67809,40506,47,24359,454
11,7,4,8,8,46740,47561,66,10812,496
8,2,6,2,19,2982,24963,3,1392,643
8,4,4,5,9,31657,40051,57,18985,513
22,13,9,2,30,147727,5077,33,2383,503
9,7,2,0,4,51494,0,0,0,610
19,6,13,7,14,263625,571544,100,112435,469
24,9,15,0,8,38545,0,1,3361,581
15,7,8,0,12,599170,0,0,0,679
7,3,4,3,7,9376,16675,28,8104,473
18,16,2,0,17,1177995,0,5,163,597
9,4,5,1,4,75418,1672,1,1672,469
6,4,2,2,6,17084,327,94,420,526
24,8,16,2,20,311426,1606,27,4882,446
10,3,7,1,6,38031,1125,26,1361,573
74,14,60,9,9,490969,111286,79,13533,437
7,2,5,5,8,45933,63616,86,7717,518
6,4,2,3,10,16953,12051,68,9180,506
17,9,8,11,8,80005,79594,255,31114,395
34,16,18,6,12,627305,41980,25,10513,470
10,6,4,3,4,13325,2819,4,2360,473
5,2,3,1,9,11753,665,14,0,496
30,4,26,1,18,22859,9962,4,9962,500
4,1,3,0,6,0,0,57,4429,569
6,3,3,2,6,24402,24402,158,14854,491
16,6,10,3,18,61951,24722,17,13809,433
10,7,3,7,4,32608,22608,98,6562,422
17,7,10,4,9,468197,251820,59,2089,458
20,8,12,0,69,334101,0,1,49,636
7,2,5,2,10,1288,1288,26,3103,532
23,7,16,1,7,201306,6674,53,3214,646
37,13,24,6,16,512331,82647,60,27812,446
10,4,6,3,3,16566,14493,25,8483,482
26,15,11,13,17,151882,156823,173,63476,475
28,10,18,7,10,68053,66503,118,8545,446
9,7,2,0,7,154477,0,0,0,660
9,5,4,6,5,387205,569160,130,0,483
10,1,9,2,10,3641,4727,18,444,635
15,4,11,2,10,516781,135165,96,85261,491
140,13,127,4,12,647182,102526,152,31317,490
5,3,2,1,4,18948,4328,25,2229,448
39,28,11,20,27,243598,205455,129,52085,424
18,10,8,3,11,504383,18563,35,8913,431
26,12,14,5,14,335798,9290,96,2771,471
15,6,9,1,12,346615,6023,16,2567,433
8,6,2,1,4,87935,1523,5,6075,513
4,2,2,2,8,12458,6714,44,5582,532
7,3,4,2,7,11399,11399,213,10185,536
17,12,5,4,21,431380,99729,77,2102,489
38,12,26,0,16,1204338,0,1,614,673
10,2,8,1,9,20841,6006,0,0,506
44,13,31,7,9,29448,22662,105,8812,464
63,8,55,17,15,299424,457948,504,115066,384
6,2,4,2,8,11131,16524,36,11131,532
6,4,2,2,9,34769,8129,6,0,462
20,12,8,0,8,92696,0,68,2318,514
68,13,55,12,14,110180,30888,274,13713,452
15,8,7,3,15,338701,25730,49,2370,571
11,8,3,1,10,329734,10,3,0,636
2,0,2,0,6,0,0,0,0,609
38,12,26,5,11,1131337,36510,97,9380,405
9,5,4,5,7,29653,29653,254,10836,459
5,3,2,0,15,35949,0,0,940,582
9,1,8,1,5,1501,1211,94,6163,544
32,22,10,3,17,2141258,64896,61,0,529
14,10,4,6,7,14804,14804,130,7429,467
18,8,10,4,14,278416,69157,65,31646,529
7,5,2,3,20,88699,88699,63,58837,471
17,7,10,8,9,35937,41161,169,10403,426
6,4,2,1,7,12094,210,104,892,531
11,6,5,6,9,79902,69275,9,20686,450
3,1,2,1,3,224010,4597,5,1490,461
8,4,4,5,5,51404,98099,60,498,534
3,1,2,0,6,0,0,0,0,694
4,2,2,2,6,4286,4286,39,3042,623
34,6,28,0,5,23553,0,0,299,613
29,3,26,1,23,353624,2739,198,2739,554
25,10,15,7,11,370273,382785,117,4177,454
9,1,8,2,10,12096,12096,26,6465,560
12,5,7,3,10,134724,111401,0,0,514
12,9,3,9,8,48485,55907,233,15167,453
36,17,19,0,14,1111616,0,23,3625,680
12,6,6,3,8,49705,27794,90,11861,440
9,4,5,4,8,0,41148,97,0,626
18,14,4,5,3,102800,2386,43,2626,441
26,14,12,12,8,156178,155031,22,20826,350
13,3,10,2,12,8986,11411,43,0,540
9,7,2,6,4,201723,149723,91,4874,445
8,3,5,1,15,253960,5891,1,6200,572
29,14,15,2,8,48985,2611,144,7500,486
16,3,13,7,19,321971,94328,92,9790,454
31,12,19,6,8,97014,53294,405,1970,466
24,16,8,2,21,1033869,13939,48,19063,424
12,5,7,4,6,24290,4148,71,4706,510
21,6,15,6,3,264946,31345,113,10280,437
10,5,5,3,6,407301,4725,8,0,504
48,13,35,10,11,143899,127377,241,35000,430
2,0,2,1,7,0,19547,2,0,607
13,3,10,3,11,149053,111801,49,0,444
8,4,4,2,18,3464,5820,35,3464,556
14,3,11,0,8,106250,0,1,104027,617
16,6,10,4,8,21128,17110,49,6044,417
26,8,18,7,7,221400,184605,138,13740,494
5,2,3,1,7,38101,2226,14,2226,574
11,3,8,2,10,16424,1758,0,0,534
28,6,22,2,8,33828,2416,14,1203,439
45,34,11,14,14,2682467,53431,36,1130,473
13,8,5,2,10,29596,21953,58,7511,435
9,2,7,0,11,63053,0,0,0,625
7,3,4,5,8,10408,15366,54,3602,466
62,11,51,4,6,97070,25416,61,20793,471
12,5,7,4,17,58664,39299,1,158,521
28,9,19,6,16,526601,46695,62,15886,433
12,5,7,1,11,108362,10044,0,0,537
33,6,27,2,16,30929,9110,87,720,451
8,3,5,3,16,10385,10385,87,5170,482
7,3,4,0,6,62619,0,0,0,661
20,11,9,3,11,423989,25630,0,0,524
18,7,11,6,5,34160,23856,84,10532,515
24,9,15,3,16,298246,40381,82,18429,481
14,7,7,6,4,271711,47993,190,22381,464
20,15,5,5,14,15465,8408,41,0,513
15,12,3,4,7,93082,16783,32,3679,465
6,2,4,0,4,24943,0,2,274,671
24,14,10,0,11,1556525,0,0,1090,616
18,11,7,0,17,391939,0,0,0,697
6,2,4,3,8,21084,24157,0,0,642
12,3,9,4,7,24161,29361,72,9948,502
9,4,5,0,10,82642,0,0,3910,582
7,3,4,2,14,350426,47780,23,40111,542
16,5,11,4,11,47101,34852,102,14776,455
18,12,6,5,4,609468,14531,63,11389,424
51,1,50,0,9,825,0,0,0,613
7,5,2,1,7,320989,1710,7,0,622
11,4,7,4,7,26131,26131,29,15066,470
10,6,4,3,18,267872,35421,62,28094,466
30,9,21,8,14,91584,61113,32,5392,436
7,3,4,3,12,4837,3877,19,1654,517
17,9,8,2,6,27549,1247,165,1992,516
7,4,3,4,14,27896,25981,70,15335,523
7,4,3,1,10,19751,19751,0,0,508
37,26,11,2,15,658482,1666,14,197,602
10,8,2,7,14,203839,149708,87,10495,477
23,9,14,5,17,180824,36091,108,4704,446
9,6,3,1,5,95738,1828,10,0,421
6,2,4,2,14,43856,41426,17,22829,408
11,5,6,0,8,450578,0,0,0,641
75,5,70,0,13,74946,0,46,2886,686
10,7,3,7,8,204460,217517,134,80206,454
10,6,4,3,15,363164,39169,96,10676,489
7,2,5,2,12,3806,1252,7,1042,512
6,4,2,2,13,344318,25903,43,21596,529
12,8,4,3,13,59212,26437,9,9512,474
28,7,21,2,13,72378,11660,16,7932,524
8,2,6,0,11,671,0,12,0,603
37,9,28,1,11,31240,2100,72,12201,549
44,3,41,2,13,86968,33194,280,30716,557
7,3,4,2,6,20210,9908,64,7184,417
9,5,4,5,11,188908,259008,95,165362,431
12,7,5,0,17,1071343,0,2,0,652
24,10,14,3,6,51550,6142,24,4607,475
9,4,5,2,4,36995,1527,12,1274,506
17,7,10,1,7,86715,24203,126,676,519
7,5,2,0,7,585796,0,5,0,583
38,10,28,2,11,35503,15269,78,1903,449
7,4,3,0,13,20993,0,7,1487,619
5,3,2,3,7,8810,8810,46,8460,492
203,17,186,8,8,126635,56750,316,22649,484
13,9,4,2,10,210213,3101,1,896,546
13,9,4,3,14,98616,102817,57,849,603
15,4,11,2,12,366993,59312,12,29924,491
20,18,2,8,5,146976,139637,100,9546,424
5,2,3,0,12,8045,0,0,955,629
52,4,48,4,13,18470,25028,152,19075,513
32,10,22,5,14,336187,44004,138,30116,450
17,6,11,2,12,35682,20197,47,3553,446
8,4,4,0,7,329112,0,5,0,489
11,8,3,7,6,236005,11445,0,0,473
10,4,6,1,11,530903,11056,9,11056,530
8,6,2,4,9,606620,99584,59,825,443
34,7,27,7,11,317947,44196,112,12957,446
17,7,10,4,6,304523,542352,62,0,545
35,11,24,1,10,373761,2004,4,0,585
12,3,9,0,9,90630,0,9,5135,505
26,7,19,1,9,443018,26,9,4212,509
36,5,31,1,15,48388,23727,13,23727,583
4,2,2,1,6,150000,3530,19,0,527
6,4,2,0,8,35769,0,0,0,596
17,5,12,3,10,182806,7506,56,5526,605
8,5,3,6,12,102545,100196,110,598,481
2,0,2,0,13,0,0,0,944,575
27,17,10,0,8,169528,0,4,421,587
12,7,5,1,14,776103,92582,13,0,523
15,6,9,2,15,215006,5679,70,8154,504
19,6,13,3,11,54428,12226,26,7881,464
27,6,21,2,13,41661,26585,21,19390,528
16,6,10,6,8,14177,25588,100,4683,439
63,10,53,9,16,91758,83662,355,44705,494
7,1,6,0,8,0,0,6,0,701
49,11,38,8,8,59914,31702,296,9021,412
12,5,7,8,6,29363,48863,174,10184,539
7,5,2,0,8,353754,0,0,0,606
8,5,3,3,8,67457,43910,253,24530,392
28,16,12,0,15,210298,0,11,0,431
12,5,7,2,9,112088,1119,19,1782,430
24,12,12,2,10,334350,29004,38,16434,522
12,8,4,5,7,489379,49427,30,1662,423
11,4,7,6,6,412700,206202,120,4181,477
5,1,4,2,8,12877,12877,22,4681,651
21,13,8,5,8,240290,58353,50,24625,510
18,14,4,13,7,629092,314492,76,14717,474
39,10,29,5,9,42116,5347,179,10993,441
23,11,12,0,11,243562,0,4,0,580
14,7,7,1,17,45016,8895,23,395,427
14,6,8,2,13,52906,1195,21,4355,532
38,5,33,2,15,375045,45824,246,43709,472
12,5,7,3,12,14913,33510,78,0,485
29,8,21,2,10,201345,1775,13,8419,524
22,10,12,7,18,235351,24806,58,2791,453
7,5,2,4,7,34210,34210,104,18615,393
16,10,6,11,5,101423,81692,1,3312,437
39,17,22,2,21,552726,706,8,3845,577
7,2,5,2,15,3225,3224,115,8085,403
12,3,9,0,12,970062,0,0,0,625
4,2,2,2,7,51115,57403,30,0,558
57,22,35,18,24,292838,142460,114,43438,479
21,3,18,3,12,22825,22825,44,13440,445
9,7,2,3,21,122352,119682,59,0,588
9,5,4,5,18,604431,209224,49,12551,485
11,5,6,1,5,14982,343,87,752,508
127,13,114,1,18,203263,3758,33,8706,450
21,10,11,2,21,635435,115414,32,4000,646
15,4,11,2,4,28097,13552,25,3494,460
26,11,15,1,9,950323,2199,24,0,480
19,11,8,4,27,724373,44665,40,0,490
23,6,17,6,7,63100,33692,25,11776,478
12,7,5,1,9,105316,810,15,745,559
8,3,5,4,12,47886,177032,0,0,545
23,8,15,7,18,34400,35920,34,10320,417
16,9,7,4,4,45427,9949,29,6990,459
7,4,3,4,6,13612,5904,52,951,587
15,10,5,10,8,74139,72666,212,11711,456
8,1,7,2,8,8028,14184,18,590,660
42,6,36,5,13,77591,63103,68,28857,468
12,3,9,1,15,15643,1353,2,5506,600
22,4,18,3,7,252707,136280,40,0,518
13,6,7,5,10,57760,44774,268,16437,453
15,7,8,6,9,14849,22839,344,7960,415
17,8,9,5,15,43689,22875,147,14350,567
24,8,16,2,11,161187,8213,84,5393,518
9,7,2,1,9,30357,7903,20,7903,571
48,7,41,4,16,43530,30069,108,11973,466
99,11,88,6,14,240658,21559,122,29534,474
6,4,2,1,11,6679,4778,28,24860,457
20,4,16,7,10,576958,337596,79,0,548
22,16,6,7,9,428626,13594,29,7654,469
28,7,21,3,5,48223,14550,9,8731,476
11,5,6,7,8,76914,92357,151,27095,500
19,9,10,0,6,212436,0,37,0,570
19,5,14,2,13,2510725,23188,7,5641,574
5,3,2,3,7,16880,16880,59,10411,535
10,5,5,6,8,30235,40422,350,15684,442
17,7,10,6,14,73307,64754,62,26712,515
33,5,28,3,10,25416,20569,244,45063,500
26,3,23,1,13,335235,1658,5,5957,546
46,21,25,5,13,2362003,14157,71,8642,484
16,5,11,7,13,115398,73523,83,1529,488
35,18,17,5,28,625356,41508,43,12893,493
6,1,5,4,6,101236,176323,41,0,448
25,16,9,16,18,403238,332823,383,6943,410
7,3,4,1,25,67290,67290,26,67290,612
19,12,7,2,7,193988,6088,33,4307,520
6,4,2,0,7,7182,0,0,0,587
13,5,8,1,15,1177615,9485,0,0,522
6,4,2,1,18,730135,730135,0,0,635
15,6,9,3,9,346223,12202,75,2759,539
9,3,6,3,6,4179,4179,56,1853,405
4,1,3,1,3,4180,4180,33,6460,556
22,7,15,6,16,51514,45705,117,47133,414
17,7,10,3,7,514048,19094,59,394,442
5,3,2,2,14,17400,6921,75,971,557
20,7,13,10,9,62144,76109,201,14510,493
19,8,11,0,8,1240936,0,2,0,608
47,25,22,0,18,1849789,0,5,801,555
11,9,2,6,10,1042962,103801,54,0,495
12,9,3,3,17,253999,27358,25,8676,464
248,24,224,23,6,2279676,1999642,372,947086,417
5,1,4,1,8,361121,26082,20,0,636
17,6,11,0,5,51182,0,0,0,587
22,10,12,0,8,84063,0,17,0,514
7,5,2,6,17,210358,210358,100,70443,480
4,0,4,1,10,74529,74529,2,3792,584
20,8,12,2,10,135098,8898,34,0,532
14,9,5,7,13,28732,25174,53,10231,423
21,12,9,11,8,1130695,580087,221,199286,439
9,3,6,0,18,626,0,3,10540,514
25,8,17,7,12,448991,37238,142,11092,460
8,3,5,1,14,344677,7022,4,4248,480
7,3,4,2,5,4694,2210,65,1630,604
33,10,23,11,9,117541,62939,295,9360,384
11,4,7,3,11,149529,8422,14,0,447
16,5,11,2,12,29944,13388,61,12005,491
8,1,7,0,13,0,0,0,1770,682
16,12,4,2,13,257148,61189,42,33384,446
29,6,23,4,15,20708,4534,105,2000,469
4,2,2,2,8,13509,13509,37,12309,530
6,3,3,1,6,14157,3913,17,0,673
12,8,4,0,10,154837,0,0,0,665
6,3,3,1,8,7385,13179,17,0,619
46,16,30,5,24,561419,19208,120,20890,452
8,6,2,7,11,28218,24571,28,8975,347
74,14,60,5,11,520186,72115,69,3904,540
52,8,44,3,14,102198,86872,80,24263,446
6,4,2,4,13,397791,280237,81,12699,432
8,4,4,0,5,217304,0,4,1023,590
5,3,2,2,8,19765,17019,32,3618,455
15,6,9,2,15,91081,748,95,2032,482
12,2,10,2,14,19537,18571,41,16398,492
4,2,2,1,4,4572,4072,28,4072,528
34,7,27,7,15,121923,126144,58,30371,440
13,9,4,0,13,164953,0,0,0,649
23,8,15,5,12,146631,8929,16,3681,482
4,2,2,3,9,26694,26339,10,1603,496
10,8,2,0,7,1320468,0,31,2855,470
39,12,27,2,25,488781,24761,16,0,450
10,2,8,1,10,7295,6470,0,0,628
6,3,3,4,8,289159,16407,13,5277,522
35,13,22,0,52,402705,0,2,394,652
14,7,7,1,7,29934,474,1,3227,529
13,5,8,6,5,57617,45800,65,27572,413
17,7,10,5,12,55984,53451,72,26494,439
10,5,5,3,17,36146,30601,24,14894,523
8,6,2,1,2,55318,294,24,972,491
17,12,5,12,10,89829,89620,220,29730,445
12,4,8,3,8,37881,33546,82,29317,579
9,4,5,3,8,407792,106314,42,16000,549
111,13,98,4,6,207855,63488,115,4928,414
13,11,2,1,13,857349,7398,1,209,612
6,3,3,0,9,145385,0,42,7765,589
21,13,8,12,9,671850,105044,190,33264,432
14,6,8,5,14,115675,169626,103,0,468
20,7,13,3,15,545196,12300,52,4079,468
45,5,40,3,10,58631,53741,120,43454,458
36,8,28,8,32,33509,47701,155,319,453
9,7,2,4,17,16476,16096,109,7785,498
11,4,7,4,9,56871,30978,70,18375,454
20,7,13,1,15,2737079,20992,26,0,572
21,2,19,1,8,6817,1685,3,4402,501
7,3,4,0,18,1616264,0,24,0,640
18,14,4,9,14,160839,121190,275,31773,426
7,5,2,0,4,2335,0,0,0,644
38,16,22,0,23,341417,0,0,470,599
9,5,4,5,13,32243,32243,388,30786,470
34,8,26,4,19,1001055,169815,84,18907,375
20,12,8,1,17,758488,1111,1,1111,601
10,6,4,6,5,22325,22325,11,19943,537
8,6,2,0,17,86071,0,31,0,483
21,10,11,15,22,2655610,4161311,290,303260,476
10,6,4,5,13,516022,30827,51,9812,466
40,1,39,0,3,7738,0,0,0,670
16,7,9,1,8,80550,920,8,1685,460
10,1,9,1,12,22743,22743,0,448,528
12,6,6,5,20,470485,77002,18,13537,469
10,2,8,3,7,0,18457,0,0,575
79,3,76,1,3,8308,210,6,5906,567
6,4,2,6,3,47886,37141,38,15750,524
23,10,13,3,14,263953,8714,55,4130,398
16,4,12,3,8,35112,16823,2,190,620
7,4,3,4,6,11735,3023,95,2973,461
10,6,4,2,16,16886,13370,28,8555,470
12,4,8,5,27,721245,75680,101,0,515
22,12,10,13,9,92808,116070,110,2121,420
14,7,7,4,7,48472,34190,70,10343,439
29,6,23,7,9,43022,32541,125,10089,446
13,11,2,0,3,287179,0,0,0,617
6,4,2,2,6,217244,12079,188,10825,475
9,7,2,0,14,177178,0,0,0,647
17,9,8,0,16,238792,0,19,2630,518
18,9,9,1,9,381202,205,10,56,559
8,5,3,5,13,25948,24658,75,16826,491
10,7,3,5,17,26302,22901,30,6863,432
8,3,5,1,16,11836,11836,29,11836,530
9,2,7,0,14,67012,0,23,292,640
7,5,2,0,4,249438,0,0,0,641
7,1,6,3,8,40477,43790,0,0,464
10,1,9,1,12,750,750,9,750,572
33,5,28,1,18,34724,30793,9,30793,593
9,6,3,3,15,48770,13932,8,5568,453
9,7,2,7,10,35049,35049,171,13622,486
19,11,8,8,69,304306,175364,187,23770,470
16,9,7,11,7,360547,360547,0,0,448
19,14,5,0,6,583160,0,8,0,568
16,10,6,10,14,400972,461695,215,246160,510
31,10,21,9,10,82155,89773,101,12708,414
8,2,6,1,10,14546,6019,1,3236,539
14,6,8,0,11,186713,0,3,0,523
18,15,3,13,22,706362,693729,370,41411,461
18,9,9,7,7,64023,43541,9,17128,485
8,6,2,6,14,153273,127471,56,12550,481
21,9,12,0,12,225650,0,15,0,532
32,6,26,0,21,54916,0,29,6505,546
4,1,3,0,11,0,0,0,0,658
21,7,14,4,13,52048,20083,61,3816,501
6,2,4,2,4,3612,3612,94,2477,466
13,9,4,8,14,475818,778170,58,32771,403
12,5,7,9,10,88244,108613,100,17287,493
4,2,2,2,4,36139,35644,45,0,520
10,6,4,0,12,31322,0,0,0,606
7,3,4,2,14,228176,35422,0,0,525
8,2,6,0,6,3233,0,24,1248,675
10,4,6,4,6,28525,32599,145,14632,485
20,5,15,0,9,682898,0,144,13534,494
24,18,6,0,6,360464,0,8,258,551
19,7,12,5,18,31012,14701,225,20809,412
4,2,2,1,3,0,2753,9,2753,458
31,12,19,4,14,959693,60420,25,26967,513
11,4,7,0,5,280014,0,135,1480,629
8,6,2,2,14,23855,12158,29,10527,598
7,3,4,2,4,1158,9310,13,0,530
35,12,23,0,13,1248374,0,15,1980,635
11,5,6,5,9,31850,32167,0,0,477
38,16,22,0,18,1447568,0,25,6088,445
6,4,2,4,9,10523,10523,38,4099,581
7,1,6,1,8,436,436,2,436,485
9,3,6,5,8,129355,151259,133,47504,492
3,1,2,1,7,122049,123337,25,0,545
6,2,4,2,3,20514,20514,36,18397,431
16,12,4,1,7,108118,275,11,1167,516
12,8,4,1,12,32472,299,1,0,653
16,9,7,1,12,141422,736,12,5123,571
10,5,5,0,11,312656,0,0,0,663
23,10,13,8,10,35066,31125,81,8045,418
11,4,7,3,9,69581,17982,321,14105,633
10,6,4,4,8,695524,53866,62,0,443
4,1,3,1,14,300868,14873,25,0,649
24,9,15,9,15,331438,398576,131,0,530
31,16,15,1,31,3233798,3287,9,3287,619
25,12,13,0,12,639529,0,10,0,572
13,4,9,5,6,51116,65783,81,14667,469
182,6,176,4,14,73255,63879,240,35580,518
26,4,22,4,11,21439,19620,33,9455,462
45,17,28,5,22,6010704,54750,28,1150,453
13,4,9,3,14,165828,67345,48,0,575
11,9,2,7,25,384830,240711,110,169727,457
11,3,8,0,13,106819,0,0,0,662
11,5,6,4,9,246725,44497,118,7409,493
12,4,8,3,12,292684,66470,54,47551,444
17,9,8,7,8,163044,62660,110,30372,454
6,4,2,2,4,157610,12767,47,9286,464
25,6,19,2,18,19080,8325,57,3243,529
36,3,33,5,14,541988,92100,0,0,605
18,12,6,2,12,120791,1233,57,14731,577
33,13,20,1,16,474302,2608,32,1897,571
6,2,4,0,4,217,0,2,0,623
16,11,5,15,9,562286,700505,149,146772,401
11,5,6,4,15,27880,20603,12,10523,529
12,6,6,0,15,51118,0,0,1786,563
13,0,13,0,6,0,0,2,1632,674
19,6,13,0,9,20523,0,7,961,642
20,6,14,2,14,320993,13365,28,12233,524
18,4,14,3,12,12529,23127,28,4158,588
26,14,12,0,6,872344,0,1,0,591
12,4,8,0,9,107942,0,3,1533,551
26,8,18,0,19,219353,0,3,1154,606
5,3,2,2,10,12867,8363,34,3471,596
15,8,7,10,9,77284,86062,125,24270,448
15,6,9,2,15,199969,7853,47,3097,468
17,13,4,3,5,803750,3820,10,0,462
13,8,5,2,6,644520,16699,36,1256,495
22,6,16,3,5,19651,7127,8,2587,429
19,17,2,19,13,471235,411066,230,74703,420
18,5,13,6,14,24595,29869,64,12219,458
6,3,3,3,10,351183,66699,43,18275,459
26,8,18,0,10,178631,0,31,1000,511
21,15,6,0,10,1976212,0,5,0,538
7,4,3,0,13,14054,0,0,0,598
6,4,2,5,11,70675,95320,38,36220,494
9,6,3,2,4,31754,5693,29,322,427
17,7,10,5,16,49158,84288,43,35273,398
25,10,15,6,14,194730,72342,121,36214,383
7,5,2,2,26,7596,6558,34,0,500
8,3,5,2,12,199813,29124,0,0,560
10,4,6,1,13,276999,40296,0,0,625
7,4,3,2,17,292911,29216,27,15107,412
16,6,10,1,7,298746,398,3,0,560
12,4,8,0,16,8751,0,0,1924,669
29,8,21,3,7,83236,3133,23,2972,585
4,2,2,3,8,147290,192583,70,112052,492
22,6,16,0,10,39228,0,54,1911,604
40,13,27,11,9,106288,76157,376,3622,407
76,14,62,9,14,185831,142951,171,25707,406
17,8,9,5,9,135912,72453,96,29750,417
22,8,14,4,13,397256,137133,24,25570,427
9,2,7,0,10,135650,0,16,3340,566
13,7,6,3,17,237778,155411,77,16431,493
19,8,11,9,17,48686,67493,338,17408,412
9,7,2,6,14,180957,83067,43,23811,456
48,9,39,8,13,373798,154112,144,14474,435
5,2,3,1,11,0,3312,21,2873,511
59,6,53,5,11,38692,22024,257,14724,531
6,3,3,2,14,104416,88166,8,0,501
7,5,2,2,14,413892,22787,20,3773,424
13,7,6,4,18,24429,21667,63,17488,449
12,5,7,2,8,196830,3251,2,505,571
4,2,2,0,6,4452,0,19,2322,639
14,7,7,5,15,97520,40838,10,20799,494
10,6,4,5,14,32552,48125,89,4307,514
15,9,6,9,8,3270883,153476,115,54205,434
21,10,11,10,18,297295,311267,225,14407,433
30,7,23,7,19,13682,19943,99,6568,460
6,1,5,0,6,8928,0,0,2807,638
22,8,14,4,19,293512,91442,39,2875,499
11,6,5,3,15,371897,29445,36,10047,495
125,6,119,0,14,17271,0,49,2292,512
18,6,12,5,9,83889,21805,238,14208,443
27,7,20,1,9,46025,5716,11,5716,662
6,4,2,0,14,88160,0,7,0,600
13,4,9,4,14,35083,47421,51,142,581
9,6,3,4,13,41767,41767,244,16487,452
24,10,14,10,27,524307,247606,197,1139,413
7,3,4,3,11,7743,4960,55,5284,392
12,6,6,0,5,44045,0,33,743,624
48,6,42,2,8,77180,18600,35,12943,469
19,9,10,3,16,491546,148786,36,0,559
8,6,2,6,11,302209,302209,12,9886,427
23,11,12,5,8,286744,29417,180,12695,463
19,12,7,0,9,435344,0,1,4402,497
22,4,18,1,13,16105,4180,23,8987,372
9,7,2,0,5,176332,0,38,7348,573
32,8,24,3,14,301238,90492,234,51547,423
20,6,14,6,12,32528,47854,0,0,459
19,9,10,0,12,170922,0,5,0,631
4,1,3,1,6,0,5361,7,0,566
11,8,3,0,14,110722,0,2,4927,517
33,12,21,9,14,632838,122899,110,7190,426
11,8,3,5,4,61301,41087,35,22841,409
32,5,27,4,13,305916,36137,141,14909,424
5,3,2,1,8,21782,21782,14,0,482
22,5,17,4,22,329610,40615,102,7404,442
8,3,5,2,7,71683,71281,43,0,508
8,5,3,4,12,13081,10403,55,1758,434
97,16,81,2,7,328270,4161,0,0,512
9,7,2,4,9,33634,42582,74,23645,403
7,3,4,3,7,38199,16906,28,2844,489
6,2,4,2,5,30,2014,8,775,611
3,1,2,1,12,5454,5454,187,5454,588
14,4,10,3,13,155143,19154,138,1291,575
23,14,9,11,12,267407,149297,75,16957,362
12,6,6,2,7,68491,48815,30,6240,500
8,2,6,1,17,10845,51,70,51,496
8,6,2,1,3,522557,36,2,36,656
4,2,2,3,14,557633,30919,25,19841,423
17,13,4,1,26,357932,695,1,0,635
15,8,7,1,69,126255,1852,4,5385,476
14,4,10,2,8,31748,4113,19,1113,589
4,2,2,2,7,35389,29202,31,0,488
12,5,7,2,28,18249,12433,54,186,518
9,5,4,5,12,31777,49518,176,2126,509
4,1,3,2,3,23360,6542,14,0,476
16,8,8,6,16,65937,41017,34,5958,462
16,4,12,3,9,76270,71581,77,0,518
7,4,3,0,4,216643,0,7,0,580
4,2,2,4,9,56562,55390,72,8714,485
6,4,2,1,5,25521,6670,24,6670,563
8,5,3,0,4,42113,0,2,2495,569
15,9,6,8,7,477753,113939,30,0,466
13,7,6,0,4,72738,0,0,0,584
51,14,37,7,18,125716,13364,291,4692,436
37,15,22,0,12,2478763,0,3,0,469
10,7,3,3,8,429142,357665,0,0,488
8,4,4,3,6,14464,9832,43,4837,465
7,5,2,2,11,369072,3535,5,0,443
12,8,4,2,12,370591,74135,50,0,529
4,1,3,0,13,0,0,0,0,652
11,4,7,1,6,50003,33,26,0,618
11,5,6,10,10,272121,402953,0,0,476
48,10,38,7,13,255909,31446,435,15442,449
15,3,12,2,16,142827,44729,23,35626,409
5,2,3,0,8,38608,0,0,0,667
13,7,6,2,18,822335,180928,45,90230,469
15,8,7,4,4,515402,351813,108,1524,492
19,5,14,3,19,39976,35543,46,766,472
41,16,25,8,30,404366,135591,109,26505,480
4,1,3,1,14,17090,17090,14,17090,527
7,5,2,3,3,45484,11971,1,1350,512
16,0,16,0,7,0,0,22,0,566
9,3,6,3,2,12197,12197,21,3310,375
14,7,7,0,9,271595,0,52,0,503
15,8,7,6,5,35307,44018,91,9229,505
5,3,2,2,8,12265,6658,0,1450,529
20,9,11,2,11,708327,3433,116,8312,490
31,14,17,11,13,296950,246934,579,30553,447
14,9,5,1,6,61010,3349,0,0,573
13,4,9,5,15,918815,953994,85,48566,450
15,11,4,0,7,316084,0,1,0,648
13,6,7,0,8,50351,0,1,1,635
8,4,4,3,12,14592,14592,49,5499,483
3,0,3,1,2,0,3073,7,3073,482
11,4,7,1,12,286612,606,105,3397,444
9,6,3,6,11,45006,32961,5,2898,421
9,6,3,5,14,21797,15192,85,2850,486
14,10,4,6,14,786726,45917,58,16758,462
13,4,9,0,10,14112,0,15,84,643
14,4,10,1,11,49938,1932,3,3103,529
35,13,22,11,12,40569,57420,415,10550,439
45,23,22,1,24,5123547,7149,21,7149,561
82,11,71,5,16,281210,3400,134,2083,474
49,12,37,6,18,358611,40726,77,30850,542
16,4,12,1,13,265301,30822,10,0,463
29,7,22,1,9,75332,1149,47,1120,491
9,5,4,5,16,537838,1848383,73,105522,589
10,6,4,4,3,51123,3928,25,3660,464
13,3,10,2,8,42465,41930,66,5336,507
32,7,25,2,17,621434,3379,16,5994,683
9,4,5,0,6,23456,0,21,4658,649
72,21,51,9,15,189898,53476,386,13095,418
5,1,4,1,9,1195313,28490,27,5730,618
6,1,5,0,10,21770,0,30,0,572
24,6,18,6,14,60614,85867,108,24337,507
9,6,3,5,5,34505,37071,325,15629,513
23,13,10,5,13,226426,28112,93,22076,417
29,10,19,2,8,59833,5418,40,4328,427
21,6,15,0,4,36098,0,31,2156,602
72,31,41,2,10,19362,3365,31,3241,504
12,0,12,0,8,0,0,9,0,557
21,10,11,6,24,595132,115710,194,26323,450
15,7,8,3,16,387733,29702,75,6192,525
10,4,6,2,13,48243,12938,49,4500,541
22,10,12,5,12,114895,39236,264,11538,452
12,6,6,7,7,26447,209616,119,20032,426
9,5,4,0,9,76831,0,14,0,549
16,8,8,1,11,73575,12260,30,12260,568
14,12,2,2,4,87614,197,25,300,557
11,6,5,0,8,74132,0,12,0,590
9,3,6,0,5,57363,0,6,4110,608
26,16,10,17,8,266619,241816,399,32170,441
12,4,8,1,8,15975,7197,31,1279,621
6,4,2,0,10,20296,0,7,19767,618
122,9,113,6,15,226807,70365,403,40742,495
15,2,13,2,13,25199,40364,33,24859,554
50,19,31,11,12,287286,59830,107,11992,418
10,6,4,0,8,190091,0,3,0,656
29,10,19,6,9,1479950,470583,154,175623,432
20,4,16,3,11,57051,5013,4,3418,438
9,1,8,1,8,3003,3003,118,3003,629
16,11,5,0,7,138677,0,1,775,595
6,4,2,1,2,9648,9,6,206,544
10,8,2,3,16,565263,16940,32,309,522
6,3,3,3,7,27281,27281,285,16500,517
13,0,13,0,9,0,0,0,2265,600
6,4,2,4,5,32990,52261,51,28868,504
90,5,85,2,6,22225,1270,186,1713,480
6,1,5,1,6,652,2000,25,4140,486
13,8,5,4,13,22454,23353,20,9108,551
14,6,8,4,10,187249,187249,94,15393,446
6,2,4,2,8,62427,48194,51,0,507
8,3,5,1,10,335499,24935,64,24935,538
7,3,4,0,4,18546,0,4,0,563
8,4,4,1,10,275861,1461,25,0,568
10,7,3,0,2,94780,0,1,0,626
15,2,13,0,7,3155,0,3,6410,549
52,11,41,1,15,706115,3154,50,5368,470
7,3,4,0,14,29073,0,20,16120,644
3,1,2,0,6,699,0,0,0,556
63,7,56,3,7,59672,31240,74,10551,449
13,10,3,6,8,373143,61439,60,0,442
15,9,6,4,4,428104,44784,33,2314,481
4,1,3,3,6,611629,1026634,54,611629,501
26,11,15,0,18,171659,0,25,0,548
42,2,40,0,8,9211,0,79,647,616
20,8,12,9,17,1342130,139286,274,17778,477
18,2,16,2,6,17561,16691,20,5480,546
12,1,11,0,12,448,0,10,0,617
18,7,11,2,6,32913,3952,35,0,550
28,9,19,8,10,44061,38930,252,6842,423
12,5,7,2,18,399220,11542,28,5771,508
14,7,7,5,16,342271,57678,49,45834,474
8,4,4,0,9,31260,0,3,2269,631
22,13,9,19,6,519435,771925,193,213987,397
6,3,3,4,17,18403,27246,92,6398,562
9,5,4,6,13,28956,30338,60,7125,457
4,0,4,3,6,6106,29805,0,0,578
14,8,6,4,25,159914,49380,87,26838,595
8,5,3,3,12,109706,104080,66,82817,492
13,10,3,6,7,114180,5747,8,1425,563
5,3,2,1,7,1368,585,26,99,641
22,7,15,0,8,72565,0,10,0,601
5,3,2,0,7,45801,0,0,0,692
29,11,18,0,24,935857,0,0,120,609
10,2,8,2,19,57648,89723,20,57648,549
13,11,2,3,9,47307,10401,54,1879,443
17,12,5,3,12,162383,2979,7,798,453
19,3,16,2,15,11804,10610,9,1372,486
37,19,18,8,27,1611652,713643,68,0,500
16,7,9,0,4,42374,0,0,0,568
9,4,5,2,20,70604,19724,29,9891,534
23,2,21,0,5,6586,0,0,0,584
5,3,2,1,7,6398,777,0,0,428
17,10,7,5,11,760144,77029,46,1418,486
11,2,9,2,10,29419,27318,22,1797,488
9,4,5,3,13,36697,5373,41,4312,469
19,11,8,5,10,322526,15128,366,10159,420
38,24,14,3,18,1654460,11504,76,13200,567
18,9,9,8,17,611606,950861,168,582346,430
21,4,17,2,13,17630,17630,24,12682,545
11,7,4,0,4,180396,0,0,0,645
26,7,19,2,13,258596,8658,262,15570,469
7,2,5,3,13,42053,28468,62,6070,485
7,3,4,4,6,161384,51567,59,6323,529
43,9,34,10,8,47890,67089,153,13452,477
31,13,18,5,9,178193,54642,68,51958,424
7,4,3,3,6,15963,11950,149,8479,524
12,5,7,4,9,139049,57802,46,0,439
9,4,5,5,8,147652,150920,5,14955,458
12,7,5,0,25,122667,0,4,178,547
8,3,5,1,5,64968,4040,12,0,526
10,7,3,2,7,61383,90972,27,4730,570
67,5,62,3,8,83508,43541,105,40117,543
14,3,11,1,10,17866,5507,49,5507,558
29,8,21,6,18,18463,18463,71,14408,459
7,1,6,2,20,46956,46956,49,0,465
7,5,2,0,15,348429,0,4,0,677
14,5,9,3,16,4848,10942,67,6530,603
5,3,2,2,15,555977,102649,13,12594,536
11,4,7,0,9,16389,0,152,4123,491
13,9,4,7,69,117357,109036,59,22241,440
38,6,32,4,18,794746,162664,85,115229,458
5,3,2,3,8,116847,161872,60,45025,477
19,6,13,0,18,60032,0,22,3780,512
28,8,20,5,7,111955,15940,37,2578,439
6,1,5,4,7,18042,28763,54,14189,632
33,18,15,10,9,392737,63567,158,19873,423
8,4,4,4,12,39049,19785,75,0,526
12,8,4,3,8,303290,9327,8,1154,464
60,17,43,16,17,129502,64426,265,15960,449
10,5,5,1,6,125484,889,29,0,509
9,6,3,3,17,75352,74655,32,71006,414
20,3,17,5,5,19908,19908,121,12669,432
20,9,11,3,16,1737098,107413,140,12138,582
24,7,17,6,18,618378,1062399,94,147583,508
9,7,2,2,3,110630,2906,10,1501,396
9,1,8,3,13,97514,50608,34,19567,497
18,15,3,3,3,947266,116133,13,1114,534
13,3,10,2,13,453024,10402,38,23360,429
14,4,10,4,10,241590,41771,57,9219,439
12,10,2,0,5,78517,0,0,0,617
18,5,13,0,6,52698,0,3,1473,650
11,6,5,6,8,379314,18494,90,7020,478
43,25,18,2,21,140110,22028,47,64,564
9,4,5,3,17,207342,207342,74,849,570
17,5,12,4,11,18056,16849,58,10046,613
3,1,2,2,10,9126,16072,37,0,520
14,3,11,3,10,27061,33456,24,7250,501
56,10,46,5,14,106638,50220,70,31645,472
19,6,13,0,13,122795,0,21,837,544
10,5,5,4,5,13092,13092,237,10384,483
7,3,4,1,7,432279,4946,296,6839,544
8,3,5,3,9,60464,42887,66,0,488
11,3,8,3,11,24439,54575,0,0,485
6,1,5,2,4,7120,7120,25,6486,429
6,3,3,0,2,19898,0,0,0,593
11,5,6,1,18,515963,2173,3,7738,596
18,11,7,10,17,166236,163460,203,18500,418
10,3,7,0,6,9193,0,12,737,614
7,4,3,3,7,115282,111898,98,15306,504
4,1,3,2,16,182661,311775,39,182661,520
23,7,16,6,12,41416,16239,48,8640,515
16,8,8,0,8,81266,0,3,70,547
11,5,6,3,16,22568,13777,33,7820,478
14,8,6,10,9,20769,31694,97,4448,433
10,8,2,0,3,33217,0,49,1180,616
9,5,4,4,5,144642,59641,67,5095,495
8,4,4,1,8,323387,7717,20,148,555
26,6,20,1,14,110228,71783,392,71783,540
7,3,4,2,2,13571,5143,80,4773,452
7,3,4,2,17,607292,12077,12,7193,572
24,7,17,6,16,115498,26559,135,1198,504
29,14,15,2,13,3568010,14755,18,13610,480
21,11,10,7,12,246191,238419,315,93397,420
11,7,4,6,7,40359,32628,122,1154,450
8,5,3,3,6,770981,4138,85,2144,405
26,8,18,1,6,265882,18273,0,0,460
6,3,3,3,6,29587,43511,35,0,552
22,3,19,2,14,268083,6037,2,2171,528
18,10,8,9,28,1312790,265881,221,18602,530
19,10,9,12,7,345938,96934,183,11859,371
6,4,2,0,5,41000,0,3,0,632
33,7,26,0,18,45616,0,59,590,651
5,2,3,3,21,45261,45261,0,0,469
12,6,6,7,10,25681,40952,97,3300,540
4,2,2,1,8,1078,1078,18,2127,538
13,7,6,5,13,38214,37262,163,14648,503
7,2,5,2,11,49502,45328,23,44851,434
10,4,6,5,7,2868,9481,0,0,437
3,0,3,0,8,0,0,0,0,694
91,4,87,4,7,145098,145098,73,10111,450
14,11,3,1,22,461400,337,23,0,551
6,4,2,0,14,154839,0,24,0,520
11,9,2,5,19,643077,11733,128,11432,492
11,9,2,0,5,947413,0,11,0,547
26,5,21,5,15,90939,66261,327,14601,433
15,4,11,4,7,3619,7637,69,3113,461
6,4,2,3,7,80887,69869,75,0,514
11,5,6,2,24,94928,26298,82,0,496
12,5,7,1,8,0,19419,46,409,466
23,11,12,0,13,911872,0,1,0,638
25,3,22,3,13,9763,9763,22,4158,534
12,4,8,2,13,267230,14167,61,4273,436
34,12,22,13,20,147026,147026,337,2840637,443
14,11,3,0,19,177515,0,0,444,689
9,2,7,2,10,8826,8095,37,7538,516
8,5,3,5,15,12070,15855,0,0,447
38,10,28,1,10,132642,75077,5,0,645
9,5,4,5,6,108197,108354,0,0,471
12,4,8,1,7,6921,6469,10,0,505
10,4,6,5,13,26889,13216,69,1254,420
7,4,3,1,8,82245,11096,43,11096,556
11,5,6,4,16,72125,34021,135,33390,506
26,6,20,3,16,41829,44493,65,36918,512
7,2,5,1,10,29949,21941,10,368,652
12,3,9,4,6,28628,23798,37,0,519
9,6,3,1,13,431279,3209,40,5798,498
25,4,21,1,15,311013,13653,20,2425,579
6,4,2,6,14,20489,30096,52,12530,500
12,6,6,6,12,46854,40346,0,0,442
8,6,2,1,5,251122,2228,29,649,611
13,8,5,0,13,34997,0,32,0,600
6,1,5,2,7,7296,5786,55,0,500
11,1,10,0,7,37497,0,2,0,643
5,1,4,0,5,323,0,4,0,628
22,11,11,7,13,53200,13203,103,1706,458
19,6,13,5,10,73418,78971,318,11350,481
12,8,4,1,11,650662,926,0,0,539
8,3,5,4,10,39629,34926,16,5256,537
22,4,18,0,11,174318,0,0,0,613
6,3,3,3,13,83454,83454,56,46486,534
44,4,40,1,13,16735,2204,23,2204,532
24,8,16,4,19,146410,25662,123,16352,431
17,10,7,8,6,314413,32503,36,6695,408
15,8,7,3,13,17006,10740,46,12280,396
12,8,4,6,6,25404,26880,107,10583,477
14,8,6,8,26,67053,154419,30,12841,438
20,5,15,0,13,0,0,11,0,627
27,12,15,3,11,329355,13008,94,2670,453
25,9,16,4,17,183446,17841,65,9362,433
5,2,3,3,13,16566,23696,28,12851,501
3,1,2,1,13,0,11892,8,722,662
16,5,11,8,12,302080,32932,136,6394,454
9,3,6,3,9,91723,91723,157,2740,443
12,5,7,3,5,121894,7479,12,0,554
12,8,4,10,9,136176,143986,160,1405,455
13,4,9,1,6,37564,1966,14,1966,609
17,10,7,8,7,2748849,37473,21,1334,460
10,6,4,4,10,75413,73471,309,46594,482
4,2,2,3,7,20134,15381,11,11743,477
24,2,22,0,9,8578,0,14,0,540
21,11,10,1,18,700830,1107,1,1107,484
9,4,5,1,7,38927,750,6,2041,468
52,6,46,4,11,16954,10196,126,9639,478
16,9,7,3,10,65146,63582,94,541,551
18,9,9,6,12,334862,47265,51,28289,462
3,1,2,1,5,5029,5029,0,0,633
10,4,6,4,11,326781,60561,92,9130,521
13,6,7,2,11,301873,12195,25,0,551
12,3,9,1,10,284441,16627,27,16627,593
14,9,5,3,7,92547,18262,41,9610,450
16,7,9,2,31,211490,1244,32,25777,470
31,6,25,0,10,56014,0,44,1481,607
21,7,14,5,13,133191,180380,73,7918,446
8,3,5,3,9,6857,6857,38,2719,481
9,6,3,1,5,150274,9332,2,4836,464
7,3,4,2,10,116003,82356,0,0,453
10,6,4,2,13,288874,4493,34,8059,414
23,4,19,1,18,222771,580,1,3685,638
16,12,4,11,8,125755,137414,233,39531,384
6,2,4,1,6,127519,3304,33,0,470
8,4,4,5,7,52257,41126,58,16235,430
75,6,69,1,15,76755,4532,107,34096,492
13,6,7,1,8,14873,2600,19,2645,497
30,10,20,5,14,677586,16854,290,6661,443
42,8,34,4,13,213707,22149,14,17638,417
17,7,10,5,17,25781,30166,64,16017,534
29,16,13,12,10,220821,108131,284,13707,371
30,13,17,1,25,1013607,25791,50,4400,492
18,2,16,2,10,37302,16315,0,0,476
12,7,5,7,7,14232,13287,248,15400,433
9,1,8,2,8,14370,18370,40,14370,561
23,12,11,11,10,122810,81128,136,17631,423
17,6,11,2,26,346855,7488,51,13626,588
14,10,4,0,20,9555,0,8,0,641
34,8,26,10,11,153424,139418,330,31920,387
14,5,9,1,22,78068,1294,22,0,602
10,1,9,3,5,27662,27662,44,18046,509
6,3,3,1,13,7027,5837,23,5837,587
17,14,3,1,7,417064,670,9,0,552
13,8,5,4,9,11862,10729,102,1453,366
11,7,4,4,7,21646,21645,34,10131,415
6,3,3,4,9,19812,7205,29,6955,477
145,6,139,1,15,255755,6948,10,6948,532
8,4,4,3,5,52735,27389,0,0,491
16,8,8,0,7,151313,0,1,0,582
19,13,6,13,8,138812,188839,61,35819,425
3,1,2,2,3,512,12866,31,0,489
26,12,14,0,14,809554,0,0,0,715
9,5,4,6,7,9966,13299,305,5200,437
45,7,38,7,7,45860,39910,226,9995,482
8,3,5,0,7,287493,0,0,32174,626
16,12,4,11,3,187170,130271,153,30513,371
6,2,4,3,7,29793,42386,0,0,455
36,7,29,2,10,108503,8266,468,7717,584
36,16,20,11,14,396049,200278,74,40693,472
10,3,7,1,11,284120,279885,16,279885,519
20,11,9,16,17,837034,802748,320,109934,465
567,8,559,3,17,137212,15001,91,9084,534
11,1,10,0,5,5851,0,6,2418,650
47,15,32,10,13,422313,119690,167,25252,482
5,2,3,3,8,7956,18041,0,0,515
2,0,2,0,4,0,0,0,0,606
8,3,5,2,5,24307,8340,0,0,397
21,5,16,7,13,152784,169037,76,61423,417
26,16,10,13,8,91887,58269,239,8503,419
13,10,3,5,7,53164,58560,248,25184,479
12,6,6,4,38,95403,56390,70,4344,462
68,13,55,10,15,508684,457447,2,6027,451
14,7,7,0,2,76412,0,0,4771,511
12,9,3,10,12,163045,139327,156,23084,436
17,1,16,1,14,11631,11631,10,11631,472
5,3,2,1,2,2312,74,57,378,510
13,3,10,2,9,796695,18108,30,7213,450
19,4,15,4,8,16125,19571,289,14752,529
34,9,25,5,14,35044,12374,229,5064,489
59,10,49,2,13,241302,4173,40,0,518
41,8,33,6,9,63430,56254,311,17912,469
37,12,25,2,16,416043,5203,29,6440,444
41,7,34,0,5,513181,0,3,0,582
6,1,5,1,6,7300,6300,8,6300,634
17,9,8,13,8,352709,398634,232,0,465
19,12,7,6,9,207630,19876,135,8745,411
12,10,2,0,14,121726,0,0,0,609
11,5,6,3,11,64452,9147,43,8290,488
10,7,3,0,4,264454,0,0,0,671
9,6,3,4,6,40981,39265,0,0,474
13,6,7,5,6,78474,42690,94,2360,440
48,17,31,9,18,183569,75105,124,19151,443
11,5,6,0,8,106965,0,35,2465,461
9,2,7,2,8,0,36748,11,0,658
37,8,29,7,9,36663,21934,337,8581,419
45,8,37,4,6,161449,14676,55,7976,474
9,1,8,1,18,0,5131,2,2208,649
15,5,10,4,16,22032,22032,80,5521,457
39,13,26,7,11,133805,29312,170,15355,481
14,4,10,6,8,25010,42787,50,6170,457
22,6,16,4,7,96097,10219,71,5818,423
58,18,40,6,10,278434,55598,260,7041,433
8,4,4,1,4,29532,2036,7,704,456
16,6,10,4,13,260398,19699,62,10167,461
32,7,25,4,13,13812,44171,107,31166,514
55,0,55,0,10,0,0,114,853,604
132,6,126,2,12,22633,259,51,728,534
14,10,4,1,5,2343623,6593,1,0,558
102,15,87,3,16,82293,14450,147,8874,483
24,6,18,4,7,22497,7198,34,4599,474
34,4,30,1,10,37555,2536,33,4413,491
9,4,5,4,13,9960,11845,41,3103,486
11,9,2,1,8,250542,970,5,970,669
40,18,22,10,12,304272,128296,71,17313,431
6,3,3,4,8,10813,10813,43,3060,447
35,10,25,7,8,522725,78226,277,3752,449
15,6,9,7,8,24791,24791,219,7749,453
10,5,5,3,9,58583,43606,36,8108,550
6,3,3,0,7,116237,0,0,0,685
25,4,21,1,14,12751,1795,7,987,504
45,10,35,9,12,243299,278882,168,160313,380
14,8,6,3,9,268975,3043,6,1028,499
58,7,51,2,17,99837,10529,362,11718,471
29,1,28,1,9,51000,5331,23,8234,595
10,6,4,2,15,271570,33720,26,32373,449
5,2,3,1,18,128679,69665,34,0,682
34,13,21,4,13,253359,14917,31,9810,476
24,6,18,5,12,84592,65218,78,3937,436
15,5,10,0,4,6188,0,2,0,632
7,2,5,0,14,23776,0,3,0,594
5,3,2,3,5,111629,120961,30,50027,477
4,1,3,2,3,23518,129221,30,23518,459
23,4,19,3,8,18528,18528,375,16600,463
21,7,14,5,15,342335,291185,165,21097,399
14,3,11,1,7,11049,1614,7,1759,478
25,13,12,10,29,330439,280178,13,2021,517
8,5,3,5,22,57823,46092,63,21582,465
5,2,3,2,11,12314,12314,33,0,547
11,4,7,1,14,76945,1699,5,0,510
26,6,20,4,14,229246,4268,69,3600,541
18,6,12,0,7,18405,0,1,0,655
12,4,8,0,12,1402896,0,16,0,541
7,4,3,4,7,13410,18750,0,0,459
8,3,5,3,8,8126,22102,19,936,429
6,0,6,0,17,0,0,3,1596,678
3,1,2,1,3,10032,10032,11,10032,478
8,4,4,6,8,9063,17178,149,4960,506
25,12,13,11,11,681781,431839,173,128966,384
16,8,8,10,10,1119227,913542,147,295232,423
13,6,7,0,11,52760,0,15,4822,421
11,8,3,1,6,23587,1385,64,1385,512
17,8,9,1,8,108669,24203,22,4036,461
8,3,5,0,15,117736,0,25,45090,629
9,5,4,1,8,215131,1139,14,1698,621
4,2,2,1,13,208163,3796,19,3796,526
8,6,2,2,8,2157,1306,43,4253,459
14,4,10,2,8,389990,33517,55,0,618
6,4,2,0,6,16914,0,0,0,620
25,9,16,10,11,104892,87224,249,33759,427
14,8,6,1,13,113022,3240,1,3510,504
2,0,2,0,8,0,0,0,0,625
10,5,5,2,12,21746,21746,8,18081,497
10,7,3,2,10,369304,16185,30,807,446
16,5,11,4,10,603629,214421,106,119365,426
113,7,106,5,16,30250,27309,242,10209,425
4,1,3,1,13,107452,107452,0,107452,582
36,14,22,4,17,345717,4521,23,7176,519
13,6,7,4,6,43414,31985,0,0,475
11,8,3,0,19,223069,0,18,312,587
19,7,12,5,13,52510,43675,156,21283,511
9,4,5,0,17,15706,0,1,1205,531
23,11,12,1,23,1131204,1873,78,3410,486
3,1,2,1,5,3338,399,5,449,603
14,5,9,4,19,214000,22974,307,16093,522
28,8,20,5,8,129955,34824,86,5448,439
12,4,8,0,22,136099,0,0,0,681
5,2,3,2,3,15619,12097,41,0,510
31,17,14,8,20,588636,80763,87,18592,429
13,9,4,3,5,154820,1779,24,0,525
18,5,13,4,16,536284,45611,35,15383,426
9,5,4,0,7,32297,0,10,154,637
10,4,6,3,4,17251,4196,35,819,488
14,2,12,0,5,18429,0,1,820,658
6,3,3,4,7,15396,15396,73,1256,438
12,7,5,2,6,161608,200,36,376,580
11,5,6,5,8,52639,15309,57,3354,447
6,3,3,3,8,15255,19426,64,6481,514
17,8,9,7,15,127355,72044,85,15144,431
5,3,2,2,5,183342,128749,9,0,452
11,8,3,6,10,283224,13434,36,4767,457
7,4,3,3,5,9203,9203,282,6264,601
16,3,13,2,7,48096,8959,34,5834,619
10,7,3,4,7,16330,2282,15,938,539
11,5,6,3,8,380677,11254,75,3700,425
3,1,2,1,6,484,484,19,484,526
6,4,2,4,25,38334,48317,158,13556,564
5,3,2,1,13,259379,24299,23,24299,524
7,4,3,5,6,94723,49605,46,0,521
124,9,115,2,13,445381,11848,44,7170,486
20,5,15,1,24,971296,221915,14,1785,398
9,2,7,2,10,2269,2269,20,743,569
64,14,50,4,13,411469,66909,281,30475,519
10,3,7,2,14,7306,7486,44,2794,497
11,3,8,3,9,227545,68822,44,0,584
6,4,2,0,13,5787,0,0,1377,705
19,11,8,9,9,614107,109123,102,23120,516
15,2,13,0,9,69244,0,20,35,617
12,3,9,0,8,319476,0,18,0,554
21,12,9,10,7,256455,83322,109,23429,408
16,5,11,1,15,148725,32523,32,330,475
13,5,8,0,9,17564,0,15,0,625
5,2,3,0,6,11457,0,8,581,633
27,11,16,9,15,255876,107476,0,0,446
12,3,9,3,14,55553,52297,53,47745,516
29,6,23,3,9,959208,11472,97,2357,636
10,6,4,5,12,529632,108735,36,31001,403
22,13,9,3,6,204103,498,24,430,548
29,17,12,8,21,2124372,105611,0,0,476
27,4,23,0,8,15285,0,0,0,529
11,4,7,5,6,80375,67465,0,0,478
17,5,12,0,15,913429,0,0,0,473
6,4,2,0,8,8303,0,14,0,696
13,3,10,2,6,40925,7838,124,2256,450
6,2,4,4,10,11372,29075,21,0,484
15,8,7,6,8,257202,222451,70,7139,495
7,5,2,3,10,13917,14776,73,1210,424
22,10,12,9,24,57247,55747,112,19224,388
21,9,12,2,11,702730,46175,42,22365,518
3,1,2,2,6,7261,18483,41,0,490
31,6,25,6,9,413506,67525,34,47594,440
18,3,15,0,16,2594,0,1,2222,510
13,5,8,0,3,14964,0,1,1386,590
34,10,24,5,11,145676,62556,95,28200,444
18,6,12,0,6,14817,0,4,960,648
6,4,2,4,23,72109,21274,205,10906,517
12,4,8,0,11,0,0,1,209,585
8,6,2,0,4,397096,0,60,612,585
11,5,6,3,8,122952,21711,206,20145,469
17,5,12,4,12,885175,65372,17,35785,436
35,5,30,3,9,29791,7219,57,1535,440
29,5,24,4,12,42038,30987,58,21967,447
19,8,11,9,26,145514,174144,407,17557,515
7,4,3,2,13,15830,1983,49,2270,534
17,4,13,4,14,26839,16823,133,3090,474
9,7,2,0,9,783533,0,0,0,691
10,5,5,0,19,75239,0,24,0,640
4,2,2,1,5,6195,2780,25,0,557
9,1,8,0,20,432759,0,0,0,719
22,14,8,18,17,228753,237666,122,75082,465
23,11,12,4,10,210231,10592,105,9100,529
29,13,16,8,8,425255,32441,119,9483,419
30,10,20,1,11,1169917,305,9,0,577
16,9,7,9,14,129769,74512,0,0,457
32,8,24,4,14,739839,178569,114,1495,539
19,9,10,5,10,235104,75075,40,1893,513
16,8,8,0,14,79187,0,0,0,597
8,3,5,3,14,4111,4111,47,1941,545
9,6,3,2,16,47166,29554,20,24990,498
20,4,16,3,14,12491,14066,57,0,528
13,6,7,2,10,322149,14081,6,0,546
44,9,35,5,12,253979,235046,131,13313,467
21,4,17,4,7,25661,9766,100,2520,507
18,5,13,4,14,265749,9012,41,2950,504
6,4,2,1,15,473639,1795,0,0,623
3,1,2,0,6,5807,0,0,0,679
19,8,11,10,10,78453,111119,213,25920,407
10,5,5,2,7,305259,2203,22,1520,523
9,6,3,5,17,253508,85445,95,28959,465
21,11,10,4,7,124822,23708,26,4893,611
41,15,26,3,12,66198,8156,47,1696,552
9,2,7,2,13,24419,23454,32,0,548
29,9,20,7,12,769494,239993,173,15360,456
8,1,7,1,2,5444,5444,2,5444,533
15,10,5,0,11,214040,0,0,0,560
25,15,10,2,12,32364,91738,29,0,517
36,6,30,1,7,213638,21106,16,1505,468
37,16,21,0,13,5199227,0,2,0,590
30,14,16,11,16,470150,52768,209,7287,409
10,7,3,4,7,20628,19127,281,9822,417
6,4,2,5,14,34795,30799,75,8452,444
13,8,5,6,4,38980,33239,161,9800,522
9,6,3,1,15,121842,4168,1,4168,667
20,6,14,3,9,45396,21608,52,10738,462
14,7,7,3,6,185109,2768,156,16436,475
7,4,3,4,5,15777,13775,36,4989,437
34,8,26,3,11,104226,52439,91,2182,497
10,4,6,0,9,2857,0,0,658,652
8,6,2,3,9,41105,4724,18,2987,440
101,4,97,3,11,159625,149740,41,57756,481
11,6,5,0,10,539355,0,0,0,695
10,4,6,5,9,5881,13339,40,7079,438
4,2,2,1,3,15472,5471,0,0,421
21,12,9,1,18,634132,2962,19,3586,491
8,5,3,6,6,32148,19361,351,5754,500
7,5,2,5,8,23777,23777,405,11704,514
10,4,6,0,15,42817,0,0,334,644
5,3,2,0,7,536530,0,10,0,577
24,16,8,0,22,211160,0,0,0,682
5,3,2,2,14,19677,19677,0,0,553
9,6,3,0,5,149715,0,0,0,571
19,9,10,4,69,418361,12763,37,3419,470
12,9,3,2,6,329537,26636,0,0,427
29,6,23,4,10,20826,20826,57,4970,504
13,4,9,4,18,64124,25744,22,4513,556
17,13,4,0,19,813894,0,6,0,514
53,15,38,0,18,872378,0,3,0,659
33,11,22,5,15,507093,193514,3,123175,455
15,6,9,1,29,92976,27461,90,850,477
9,7,2,0,7,33007,0,25,0,580
12,4,8,2,16,69813,32004,1,6138,415
11,8,3,4,10,21947,9846,174,2403,506
24,4,20,3,15,6411,6411,202,4543,529
9,0,9,0,13,0,0,0,0,631
19,9,10,8,12,481722,43885,139,31508,471
20,8,12,0,21,282243,0,0,2008,704
36,18,18,0,14,120616,0,79,2906,581
5,2,3,1,8,3111,3111,17,6222,663
12,4,8,4,35,20895,7574,150,4016,546
24,14,10,7,16,480528,168124,93,0,480
18,9,9,4,13,465460,52139,50,43785,526
31,8,23,2,12,62394,12390,101,35162,448
20,13,7,0,11,164016,0,1,1244,646
4,1,3,1,4,64763,64763,15,64763,572
12,6,6,5,8,33805,24142,151,17722,479
11,5,6,0,11,913,0,7,27078,617
16,7,9,1,6,88563,881,2,0,585
10,8,2,0,6,58248,0,3,0,458
16,7,9,5,12,163578,163411,53,93078,444
13,4,9,3,20,526840,37209,33,17913,547
12,4,8,0,7,792160,0,2,1,585
19,3,16,0,14,157193,0,0,0,545
7,5,2,4,7,17503,16363,66,7431,494
22,8,14,3,6,51332,7362,56,22931,518
3,1,2,1,13,12379,2431,30,0,520
6,4,2,3,9,27541,5288,24,2813,496
17,5,12,2,14,26896,19844,86,14456,697
38,18,20,4,13,670063,25473,61,17216,446
11,7,4,5,9,363508,356084,98,102354,501
11,6,5,3,15,475327,63877,22,1400,532
11,3,8,0,11,5097,0,1,0,695
109,11,98,9,6,46846,39133,257,10687,426
6,4,2,0,11,289307,0,8,0,626
13,4,9,2,11,17482,4942,17,4895,539
67,16,51,11,13,70156,68744,591,25237,442
25,9,16,1,13,472366,178854,7,10,470
4,2,2,2,7,2539,3530,0,0,520
9,5,4,5,18,53092,15093,43,19035,522
14,9,5,1,23,246062,1730,9,125,586
20,6,14,3,8,217771,11728,78,2455,451
19,7,12,2,7,517145,11029,7,107,458
11,5,6,0,21,197011,0,0,0,694
8,2,6,2,7,282123,19099,37,18228,532
137,17,120,7,13,371883,15298,95,0,492
5,3,2,3,6,10889,17773,0,0,596
14,5,9,2,11,285920,2744,51,3158,391
9,3,6,2,7,42501,38211,45,23449,670
17,7,10,5,13,193194,128038,79,11230,446
3,1,2,2,5,485,4242,37,485,594
8,5,3,7,16,552512,97270,0,0,459
13,3,10,1,8,44888,97,1,1118,596
22,6,16,2,14,93952,12569,41,4498,432
39,12,27,4,9,201923,13083,100,11145,492
21,13,8,8,11,520012,38411,44,1813,474
4,0,4,1,12,1400,1400,13,2358,540
10,6,4,7,17,56528,63331,92,1666,460
4,2,2,2,4,25361,8634,38,4814,445
33,15,18,1,26,260128,1005,55,2166,509
11,8,3,2,9,67388,4019,11,1895,493
10,3,7,3,26,4705,1384,47,0,560
14,2,12,0,7,0,0,27,0,505
4,1,3,2,10,18874,17833,47,7430,577
5,2,3,0,4,2990,0,0,0,698
7,3,4,0,10,369604,0,1,0,638
8,3,5,2,4,30455,14628,40,14330,476
36,8,28,5,7,57583,31764,54,21248,439
13,7,6,3,12,243092,12178,3,2500,552
35,7,28,0,23,897135,0,4,3654,652
13,6,7,2,13,228945,2065,7,39888,485
13,8,5,3,6,259853,8116,73,4032,419
6,4,2,1,4,302160,1,3,0,584
7,3,4,1,10,18320,2785,25,0,597
6,4,2,1,10,424939,610,0,0,591
12,7,5,2,13,1209729,7980,2,33746,460
48,16,32,15,11,166493,157550,415,26426,369
7,4,3,2,9,3282,555,22,415,512
70,8,62,1,12,175036,8463,11,8463,525
13,5,8,4,6,91714,33381,191,16330,539
16,6,10,5,18,87619,68615,96,21985,400
13,5,8,5,8,53261,34302,78,0,518
74,15,59,10,12,93749,58634,385,20040,447
15,5,10,5,11,79662,22272,10,3906,466
21,5,16,0,13,34614,0,4,9578,640
10,3,7,1,16,5973,42749,1,0,638
23,14,9,17,10,820037,913422,292,181500,470
21,12,9,2,15,427120,332,27,3273,470
7,3,4,4,5,101579,77527,64,788,445
13,10,3,4,6,292715,10708,13,1859,428
13,5,8,4,11,91474,8208,38,9725,449
20,12,8,3,17,408317,65906,65,63414,477
35,15,20,12,7,92419,77903,184,11329,407
11,6,5,4,10,7546,7125,96,1800,445
15,10,5,2,9,69200,40350,120,95427,407
26,9,17,1,19,89731,423,39,940,592
33,14,19,3,14,153453,11023,46,6073,522
10,6,4,5,18,132703,143386,48,88810,427
6,4,2,1,11,6980,2864,0,0,651
38,15,23,10,16,853322,69354,144,15774,431
6,2,4,0,8,29792,0,0,0,718
26,5,21,0,7,192548,0,2,11999,580
16,12,4,2,10,2379018,10703,12,0,547
8,5,3,4,8,57911,16078,107,1155,534
10,6,4,5,6,31322,45113,94,21036,452
7,5,2,2,6,110859,14743,28,109910,442
16,9,7,1,69,200248,2293,31,1110,476
11,4,7,4,8,11249,16371,44,6926,496
5,1,4,1,15,243954,8763,11,8763,617
8,6,2,3,14,21525,10088,90,7176,659
8,3,5,0,14,19208,0,8,0,658
25,6,19,1,8,27495,432,119,2785,535
28,10,18,6,11,330217,34585,146,12435,411
21,12,9,11,20,343700,360478,143,2796,421
8,4,4,2,11,459839,12961,33,3938,496
7,5,2,5,6,41698,21883,28,8808,464
6,1,5,1,8,2696,2696,9,3021,660
18,14,4,1,27,931177,19582,0,0,510
41,9,32,4,14,101306,26933,347,7660,454
18,7,11,7,14,122028,109110,0,0,470
12,10,2,7,6,282386,51868,55,12994,427
13,2,11,2,11,10933,6351,0,0,606
55,9,46,9,10,88768,97550,312,28565,390
14,9,5,0,13,661648,0,9,0,595
4,2,2,0,7,335016,0,0,0,675
30,12,18,7,14,258474,232564,128,72591,537
22,14,8,3,4,440896,6200,18,2480,497
6,2,4,3,15,27101,30168,24,10517,560
18,8,10,8,7,43458,26666,125,4644,440
31,7,24,5,10,17123,8580,97,5484,438
77,14,63,1,9,238083,1968,54,540,597
15,4,11,2,10,214958,2185,15,480,465
14,6,8,0,5,133018,0,7,0,575
17,10,7,0,13,142152,0,0,0,695
11,4,7,1,9,32395,17641,7,17641,568
27,4,23,1,12,442949,2318,36,2835,512
98,15,83,10,13,137499,92551,202,27406,414
34,9,25,1,10,86510,6394,12,6394,541
3,0,3,0,6,0,0,1,86,509
12,5,7,5,11,7150,16818,61,836,500
4,1,3,1,4,2215,2215,5,2215,449
31,7,24,9,8,142858,110249,43,27559,477
21,4,17,1,12,167821,1900,168,6017,533
8,4,4,2,9,40602,1586,13,1050,647
17,2,15,0,4,4723,0,5,1694,601
11,5,6,3,11,377205,34670,65,18437,522
9,4,5,1,5,26663,11007,26,0,646
22,8,14,7,17,109836,117415,164,35513,525
2,0,2,0,9,0,0,0,0,523
11,7,4,1,17,16093,12844,12,12844,565
10,7,3,2,3,22914,650,48,4759,459
18,5,13,0,6,56315,0,3,1473,650
11,3,8,0,4,10339,0,1,18,668
12,9,3,3,5,124199,68169,35,41005,409
38,11,27,7,14,714813,76279,204,13723,434
14,7,7,4,14,32545,12891,49,7501,439
11,8,3,5,8,37911,17283,22,281,464
6,4,2,2,8,22429,21277,28,19522,409
3,1,2,1,6,5390,2103,8,41,458
10,5,5,2,17,1138833,69338,94,64639,471
18,4,14,1,8,3645,1312,27,1776,574
16,7,9,0,6,88103,0,5,0,623
11,7,4,6,7,40227,35835,61,3662,440
34,10,24,0,12,205196,0,3,1486,659
10,6,4,3,8,161951,28447,67,15731,483
14,9,5,0,6,96310,0,53,380,543
23,10,13,5,23,152795,16125,71,221,530
15,12,3,12,10,198755,205024,172,63720,504
21,5,16,1,17,15083,6435,20,7524,507
20,5,15,4,21,713659,136245,76,89705,640
14,7,7,0,8,396001,0,0,0,557
12,10,2,1,15,31437,296,7,0,556
4,1,3,3,5,20610,28179,40,20610,571
16,5,11,2,22,959173,56191,104,18439,520
6,2,4,3,6,40992,59786,74,37589,459
41,7,34,0,12,477367,0,183,1945,595
8,2,6,3,7,13979,28800,57,3583,465
23,7,16,0,14,537420,0,5,5744,533
8,4,4,0,26,563978,0,1,10407,535
7,5,2,2,5,7016,1001,2,877,456
5,3,2,2,12,2068,2068,45,27126,497
12,6,6,7,9,77724,67930,110,22334,480
19,8,11,2,10,307524,70707,66,5528,463
39,11,28,1,10,361260,95,331,3868,449
13,7,6,3,8,31544,27485,106,7312,394
43,12,31,5,13,59033,7897,75,3435,516
19,13,6,6,10,203288,176089,144,36566,497
10,6,4,2,11,342092,129265,45,78872,451
16,11,5,1,6,111914,490,2,0,576
8,5,3,2,7,637052,1540,54,5679,459
3,1,2,1,17,42309,42309,22,42309,653
17,6,11,4,18,68204,8701,13,4376,601
15,9,6,1,18,100295,2403,0,0,529
9,1,8,0,12,39971,0,1,0,667
19,8,11,7,17,51510,87964,137,21859,425
8,6,2,1,6,282539,700,0,0,590
41,10,31,8,17,275737,27329,76,5896,400
7,5,2,3,9,23474,20307,42,0,519
50,12,38,1,14,670144,8043,11,8043,584
28,13,15,2,15,1013408,29788,40,28789,545
20,12,8,6,13,54586,11512,107,2951,462
4,2,2,2,10,538323,71507,21,67717,463
30,4,26,4,10,18495,18495,0,0,439
10,8,2,6,13,45527,48930,121,17398,458
19,6,13,3,19,378606,62572,55,4781,498
21,10,11,0,18,201486,0,13,831,558
14,8,6,3,18,495998,55900,0,0,549
77,8,69,5,19,116328,51561,93,28183,506
8,3,5,5,6,37713,50504,98,0,536
53,14,39,3,22,502062,1367,26,2345,542
36,4,32,2,26,0,37443,64,751,497
10,1,9,0,9,0,0,2,1310,684
11,3,8,0,24,8630,0,1,0,612
7,5,2,0,8,49190,0,26,3251,581
16,6,10,8,11,58179,107075,152,13837,404
25,8,17,3,69,47345,20020,233,10397,413
77,6,71,3,13,74148,68830,52,61509,466
8,5,3,3,9,17298,17298,147,11851,428
12,5,7,0,7,11543,0,68,5310,597
11,5,6,3,27,350025,51027,28,0,542
6,3,3,4,11,80544,82439,78,29761,453
25,7,18,3,18,58261,16299,26,4092,480
5,3,2,3,8,14420,20644,177,12967,582
20,5,15,0,11,19641,0,2,0,559
11,9,2,2,12,527286,26114,10,479,474
11,3,8,7,7,110983,294010,115,0,583
21,8,13,0,25,494987,0,7,0,649
32,7,25,0,11,225552,0,3,806,626
7,3,4,3,6,18887,26823,51,16414,638
6,3,3,0,3,422376,0,18,232,624
8,3,5,3,11,44837,58068,46,620,527
72,21,51,19,38,171912,167229,434,28663,387
27,12,15,11,16,668059,236816,206,25491,440
32,5,27,2,19,58328,329,168,31577,480
24,11,13,7,6,36019,18412,126,6005,408
10,4,6,0,12,320,0,17,349,599
13,3,10,1,12,9183,9183,22,9183,531
4,1,3,2,4,23183,23183,28,16073,535
13,5,8,0,21,283,0,17,0,598
12,6,6,4,8,490801,82595,97,3724,453
11,5,6,6,7,14712,21137,96,11838,440
12,7,5,2,9,29765,16081,41,2375,498
10,3,7,1,11,14697,5210,20,5210,626
28,4,24,0,8,115217,0,0,0,606
8,6,2,5,7,18126,20494,61,8028,619
4,2,2,0,6,10741,0,1,0,594
33,10,23,10,12,215497,168912,90,6242,442
10,8,2,8,6,56789,53862,121,13094,413
18,6,12,1,15,2744,2744,250,4211,424
25,9,16,0,9,68951,0,29,202,537
54,26,28,1,27,2222609,14166,28,14166,520
20,3,17,4,8,42404,75462,65,1000,508
4,2,2,1,8,1598,1598,50,6540,471
13,7,6,0,10,750051,0,6,0,673
10,5,5,1,2,23217,764,2,398,577
28,15,13,7,12,308895,75945,154,4352,414
15,9,6,7,9,94776,82135,87,519,401
10,5,5,5,11,120093,128566,112,0,526
17,8,9,3,9,31879,6623,34,4640,451
14,10,4,6,13,46177,42082,128,15117,471
55,12,43,1,10,127181,2428,23,2158,500
31,22,9,14,32,576138,550625,278,20291,449
52,28,24,0,13,1604341,0,49,5177,516
21,12,9,13,7,127354,125370,127,26062,406
16,6,10,7,14,23155,35553,124,12729,485
8,3,5,2,14,1500,4231,59,0,656
14,9,5,5,7,8935,1764,27,448,617
20,14,6,2,15,1451783,32805,36,28083,418
9,4,5,0,8,197316,0,0,0,614
29,8,21,4,12,121839,8404,65,6813,462
12,8,4,7,14,157288,219670,138,16078,443
38,9,29,5,11,106312,85203,95,2182,501
5,1,4,1,8,1541,1541,41,1541,550
16,4,12,3,19,8498,224075,0,0,528
24,8,16,5,12,322758,41401,55,3059,451
13,5,8,1,8,21964,18736,25,0,504
8,6,2,4,8,213149,5450,81,3855,443
17,1,16,0,16,0,0,342,8330,462
17,12,5,9,10,137925,98423,202,5413,435
19,12,7,8,7,273886,18128,81,5350,425
18,6,12,0,3,47404,0,0,0,476
22,9,13,1,15,63633,13121,10,13121,583
3,1,2,0,2,6796,0,0,0,677
15,7,8,0,8,262272,0,3,0,650
20,3,17,0,7,29211,0,46,2918,487
33,5,28,2,16,377474,1867,18,5116,475
12,10,2,3,18,596292,24245,13,5251,481
11,3,8,2,11,17903,17903,50,4890,549
19,9,10,5,13,393061,76585,133,15349,459
22,5,17,1,18,310668,4052,3,453,466
4,2,2,0,3,0,0,0,820,635
18,9,9,9,18,104893,102836,214,17695,366
23,10,13,4,9,468055,59980,73,272,506
24,9,15,10,6,916272,439999,144,96538,437
16,7,9,0,13,209235,0,26,310,536
13,9,4,2,5,36992,1307,5,1249,392
26,7,19,0,16,52579,0,10,1215,486
35,8,27,2,7,21253,1872,115,1267,513
6,3,3,0,13,271370,0,2,3860,645
22,5,17,1,5,34560,186,13,4807,498
6,3,3,1,11,36087,9709,14,9709,619
15,8,7,5,8,50146,33020,89,15438,382
16,7,9,5,5,19704,4898,90,4023,452
22,10,12,1,12,972374,800,14,1968,494
12,7,5,1,13,46723,12313,48,8794,424
7,4,3,4,15,35854,35854,237,3666,506
10,3,7,2,8,9576,7277,28,959,479
6,4,2,0,10,148072,0,3,0,673
4,2,2,3,8,7904,7184,108,5692,444
13,4,9,0,18,10200,0,9,423,600
8,6,2,4,10,621628,9839,44,997,446
20,8,12,1,6,165236,2310,36,969,480
12,5,7,1,8,32590,1318,34,0,447
108,16,92,5,13,58341,16558,42,6412,497
12,7,5,9,9,31975,29852,67,9419,394
11,5,6,0,12,224467,0,0,0,659
8,4,4,4,8,259132,65200,0,0,451
22,7,15,3,5,43752,17676,6,11816,404
36,11,25,9,7,185604,176911,132,37947,452
20,13,7,1,9,401946,3098,34,2325,463
5,3,2,3,9,12198,7139,95,5474,495
17,5,12,2,13,30769,23836,113,15742,506
6,3,3,2,5,90605,90605,9,0,468
6,3,3,1,13,1434,450,0,0,635
16,9,7,3,9,63386,37514,9,6128,537
8,3,5,2,4,33316,13610,0,0,440
25,6,19,5,6,52739,45644,100,3000,465
23,9,14,7,6,73128,48260,72,11105,477
6,2,4,1,3,10141,9721,17,2109,520
15,11,4,11,14,1135868,1134664,172,227439,494
20,10,10,1,13,121001,1250,45,2093,619
8,5,3,4,10,33529,24326,59,0,471
21,13,8,14,8,130302,136190,182,45737,434
25,5,20,0,20,218179,0,25,1550,639
25,10,15,8,16,508525,119725,48,43401,419
25,18,7,13,20,242323,83247,128,13288,465
23,8,15,3,21,349968,2179,13,727,549
6,2,4,2,8,13446,7706,0,0,571
9,5,4,0,8,340344,0,23,697,669
6,4,2,3,9,17919,11525,48,0,504
6,3,3,4,7,8301,17342,291,7010,515
13,6,7,7,13,1222745,440147,87,143937,489
11,5,6,3,11,287649,10554,68,5085,500
5,3,2,3,6,17674,17674,27,13174,530
55,5,50,4,19,148313,110727,1,274,624
14,10,4,1,7,50986,587,3,1500,542
5,3,2,1,9,1258,1258,95,2304,571
5,2,3,4,8,266797,377497,48,1870,606
27,14,13,5,25,195132,169707,158,0,501
11,3,8,0,10,0,0,14,1703,672
6,3,3,0,4,57120,0,9,1950,563
10,3,7,1,14,238252,4170,4,4170,562
15,9,6,12,14,139487,94979,109,11929,426
23,6,17,6,14,156161,123522,130,7040,481
22,13,9,0,33,1968714,0,1,2777,675
17,12,5,14,19,436504,240632,12,164788,453
60,8,52,1,8,71231,6699,33,0,517
14,8,6,8,10,67956,67956,43,2095263,423
8,5,3,4,14,551211,102916,72,37816,418
15,10,5,0,13,47461,0,31,581,549
6,4,2,3,8,291097,79860,0,0,564
6,4,2,2,4,16597,10825,19,5246,431
5,3,2,0,17,7732,0,0,0,672
16,12,4,9,17,127509,127509,202,35013,424
8,2,6,0,9,289613,0,0,0,672
31,5,26,1,19,14126,7580,95,7580,645
12,5,7,1,10,287510,2512,23,0,473
8,6,2,6,5,65028,39671,33,15310,403
12,3,9,4,9,60938,82820,0,0,611
22,5,17,2,7,29407,15268,157,5330,439
4,2,2,3,7,16584,18552,32,8705,458
48,19,29,10,11,417962,133133,283,39010,410
35,20,15,0,17,1297449,0,0,0,624
10,4,6,3,19,542468,87347,40,25922,562
10,4,6,1,12,28635,1472,32,3915,455
7,1,6,1,10,13106,13106,22,0,481
74,1,73,1,9,2956,43883,51,43882,557
27,14,13,11,12,487957,46024,48,6574,402
12,10,2,6,10,79556,73742,90,25881,435
3,1,2,0,6,9246,0,0,0,699
12,7,5,0,8,179742,0,3,0,614
7,3,4,3,8,638839,56423,56,32342,459
13,5,8,0,11,268521,0,35,4652,448
20,11,9,4,10,289710,9465,66,5079,447
16,1,15,1,19,1220,1220,12,1220,550
36,9,27,6,12,408820,51754,197,13807,433
15,6,9,3,18,82927,21899,70,1132,438
6,4,2,0,7,60271,0,0,693,571
4,1,3,1,8,26837,26837,10,0,604
8,5,3,3,12,12966,12097,102,6902,474
4,2,2,0,14,0,0,0,0,642
14,3,11,3,15,283080,44901,41,1403,644
16,7,9,8,14,308253,28363,96,5157,464
19,10,9,6,11,399310,19250,19,8218,427
12,3,9,0,9,35577,0,0,0,696
10,6,4,1,16,127850,1565,0,0,490
18,4,14,5,15,88806,63628,124,0,489
9,5,4,3,4,48713,24856,18,0,464
15,10,5,5,15,477071,404616,18,313531,451
18,13,5,0,11,869844,0,12,0,552
10,6,4,3,9,172616,41823,25,32277,544
5,2,3,3,5,10048,20809,0,0,502
13,6,7,3,8,39848,8944,87,0,497
38,17,21,5,10,148932,29551,132,19137,480
20,7,13,0,17,627332,0,1,162,647
17,5,12,1,13,31939,4091,35,7037,534
29,10,19,4,6,555547,73844,34,39443,452
16,5,11,5,8,35155,35155,328,16720,427
7,4,3,0,7,49152,0,0,0,655
12,6,6,0,10,140513,0,1,902,569
21,8,13,6,10,207999,52585,450,2350,446
9,5,4,2,13,121800,60828,50,0,557
17,9,8,2,13,101424,7154,39,3778,567
17,6,11,2,18,112757,30486,47,21702,497
9,2,7,1,6,91682,62465,0,0,510
60,2,58,0,10,23777,0,0,2707,585
80,4,76,1,13,6346,3547,55,16072,582
14,8,6,1,7,300176,214,2,0,549
40,7,33,3,15,135880,3643,39,9411,533
17,3,14,1,9,6421,5193,14,5193,522
27,8,19,0,11,348455,0,2,0,628
15,9,6,0,12,670260,0,2,0,623
11,7,4,2,10,355943,37327,22,0,460
5,1,4,2,9,50755,45283,2,7081,643
16,7,9,4,12,110582,50902,33,1480,586
20,7,13,6,10,39538,28820,105,5466,395
12,5,7,0,17,226789,0,0,1634,670
14,1,13,0,6,20396,0,0,0,617
12,4,8,5,9,128457,132625,122,7806,493
40,20,20,13,19,203037,180949,326,76440,499
13,8,5,0,9,1340497,0,0,170,672
24,17,7,10,14,54905,45599,110,18718,352
2,0,2,2,3,7209,10108,12,7209,597
61,11,50,2,19,123196,52623,98,12017,433
21,6,15,2,6,209519,43954,19,8328,444
19,14,5,6,12,27000,46047,31,7209,528
47,7,40,10,14,56208,96536,220,27718,451
8,6,2,6,5,29760,29760,70,0,545
22,6,16,7,15,78003,102448,120,4728,432
4,1,3,2,8,9149,16234,27,7085,545
35,5,30,2,16,198017,1649,293,4611,577
21,11,10,12,19,294547,362592,205,86747,429
8,3,5,1,13,60196,16013,12,16013,439
14,6,8,5,12,141083,57703,0,0,470
20,10,10,5,13,782126,912501,77,547654,471
38,6,32,3,14,217751,3125,267,3218,490
17,4,13,1,16,32576,4192,35,2350,633
11,6,5,4,13,227144,232181,20,8902,463
28,8,20,7,9,43865,28105,156,6234,433
15,7,8,2,7,79377,7771,19,4843,465
16,13,3,8,15,223015,7472,53,318,427
18,10,8,0,8,152169,0,4,0,549
9,6,3,6,12,17969,17969,89,5712,494
9,5,4,4,18,397903,211699,89,140789,467
6,3,3,5,7,49061,65308,105,0,598
19,6,13,3,8,73719,10152,87,6307,484
33,9,24,8,12,58075,58075,89,15486,437
11,6,5,6,8,172327,168432,71,7506,428
36,4,32,1,13,5938,6368,169,8156,540
11,5,6,1,9,67045,1800,4,1718,527
33,10,23,4,10,66715,60977,53,51350,435
4,2,2,0,10,5323,0,1,0,596
6,0,6,0,6,0,0,8,4190,621
10,7,3,3,8,592327,12034,15,2033,452
7,4,3,0,7,44346,0,1,0,539
5,3,2,0,3,5394,0,0,0,590
23,7,16,2,9,460919,7202,23,5300,471
15,9,6,8,6,91521,74874,190,33217,408
11,5,6,1,5,30230,1604,0,0,552
3,1,2,2,6,5551,5551,37,4361,623
38,11,27,8,24,204315,87911,252,47005,488
22,3,19,3,16,14280,18002,345,5947,464
25,5,20,3,6,21956,1929,7,3202,546
7,4,3,3,12,8196,17311,1,850,459
23,3,20,2,12,7835,1530,51,790,528
21,3,18,1,9,22944,2285,12,5658,606
15,5,10,0,11,125673,0,6,370,718
9,6,3,6,6,10368,13507,278,5681,449
6,3,3,0,14,221829,0,6,0,675
18,9,9,0,16,463072,0,14,0,617
11,5,6,5,15,351541,351541,89,164669,480
9,5,4,1,9,429195,8199,21,8199,597
3,1,2,0,11,1087,0,7,313,638
5,2,3,2,8,105749,105749,0,0,469
11,2,9,1,8,8297,7950,23,7950,604
10,3,7,2,12,79127,35168,0,0,488
25,15,10,3,15,324637,16023,63,12936,450
54,9,45,5,12,136953,20542,110,8025,470
10,8,2,4,5,344213,30105,51,24041,449
17,14,3,1,8,583743,2147,22,0,488
9,6,3,2,15,294608,25143,43,0,513
10,7,3,0,13,699504,0,0,0,525
10,5,5,5,6,13894,29649,70,921,574
12,2,10,2,7,15059,15059,21,12428,592
8,2,6,0,16,2113490,0,8,940,588
40,16,24,1,9,4697589,410500,130,7438,541
52,12,40,9,12,106274,143976,239,97960,442
21,5,16,5,10,18983,18983,308,11575,453
40,14,26,3,9,55471,8682,17,7674,454
12,8,4,0,10,1129099,0,79,2028,467
67,29,38,2,21,3765788,86066,30,83400,683
7,2,5,2,10,26174,46095,45,0,466
6,4,2,0,4,28377,0,0,0,509
7,5,2,0,6,19577,0,0,0,515
107,10,97,2,14,199453,22692,69,11767,447
11,8,3,1,7,73519,18320,37,18320,466
19,11,8,10,9,546094,89894,91,38943,438
11,9,2,4,8,97717,78799,27,0,432
17,9,8,2,26,640898,86767,26,60905,503
9,4,5,6,8,50629,45587,10,539,524
21,9,12,4,15,319275,44579,111,20588,505
58,5,53,1,17,83073,18154,31,22353,609
12,8,4,1,14,109056,63293,15,0,493
10,7,3,1,18,48872,755,28,1346,450
9,7,2,0,15,606012,0,8,3188,632
7,5,2,3,4,9260,3275,25,1406,513
5,3,2,3,13,51267,51267,49,21420,456
7,5,2,0,3,40301,0,0,0,654
24,9,15,8,12,199817,198778,364,18200,473
16,4,12,2,10,10493,10493,0,350,485
14,6,8,7,9,50331,102203,106,11549,517
15,4,11,2,7,367866,21075,19,0,621
10,5,5,4,11,56303,53062,134,2489,492
23,7,16,7,13,85423,75621,191,6033,521
4,2,2,0,3,7510,0,0,371,623
8,1,7,1,13,38348,38348,20,38348,567
31,4,27,2,18,23644,16031,39,10767,436
22,8,14,1,9,114054,380,137,1665,569
5,3,2,2,12,51152,10443,47,5733,441
8,4,4,0,12,388011,0,0,0,697
20,3,17,3,5,5651,5651,30,2073,427
9,7,2,0,9,435794,0,0,0,712
7,2,5,1,6,4281,4281,0,0,661
11,8,3,0,11,96830,0,0,3762,584
46,30,16,29,18,136811,112833,449,15624,422
17,7,10,7,8,29002,29002,489,12985,433
19,4,15,2,18,5455,2203,20,2403,466
38,12,26,9,12,214614,47892,158,25949,423
36,9,27,7,7,60225,57981,142,21048,369
7,5,2,3,7,21119,14091,40,1499,568
21,13,8,7,14,640392,83824,54,0,484
10,2,8,1,7,41524,41524,25,41525,538
6,4,2,0,21,10970,0,1,442,542
21,14,7,0,7,393609,0,0,0,634
13,5,8,2,15,35998,8535,24,7602,600
16,13,3,0,11,224181,0,24,1385,604
13,7,6,7,12,103941,92738,173,26980,518
22,9,13,6,12,152514,150455,96,19323,455
22,3,19,2,15,126533,21022,46,5122,418
14,9,5,5,8,244055,60444,123,12645,442
16,9,7,1,9,333682,5603,0,0,547
6,4,2,4,4,140801,36148,13,20081,464
13,8,5,0,11,9730,0,0,0,678
5,2,3,0,4,5415,0,3,0,665
16,4,12,2,7,23156,23156,34,2590,422
9,5,4,0,7,273026,0,21,1673,636
18,11,7,10,8,148337,124645,32,66018,487
8,5,3,0,6,0,0,8,0,476
7,5,2,4,18,179096,83604,57,54665,433
14,3,11,1,6,50837,9935,9,0,600
12,6,6,7,6,231189,206484,157,0,477
23,4,19,2,8,54834,45424,23,24016,460
10,7,3,5,8,380758,139821,93,0,524
7,5,2,5,5,16152,16152,121,8417,455
63,5,58,3,20,237695,9854,26,556,538
11,9,2,8,7,35134,31805,170,15153,446
23,10,13,4,14,296165,9037,166,3887,459
13,8,5,0,17,2140760,0,2,5768,596
27,7,20,1,17,22101,1546,63,560,397
4,1,3,0,10,0,0,4,2000,702
12,7,5,5,9,2540071,2136931,79,6684,361
10,3,7,0,8,47693,0,33,0,543
9,4,5,0,10,216354,0,20,4882,455
35,12,23,6,12,492210,22382,68,3536,411
5,3,2,2,15,12849,12849,0,3843,546
11,9,2,10,8,49244,49244,254,11628,432
29,8,21,2,10,200594,18440,38,12790,459
12,4,8,2,13,717203,29125,45,0,505
13,9,4,6,12,241119,20927,104,2550,459
9,6,3,4,5,80146,77546,51,0,448
19,7,12,6,14,195866,209928,58,61644,477
19,4,15,3,8,348527,9498,180,2919,442
24,5,19,1,12,672646,266384,12,266384,497
15,9,6,0,7,38771,0,15,0,646
7,3,4,4,14,618910,717650,42,547236,509
11,8,3,2,10,42579,9792,55,0,458
15,6,9,4,14,22505,15176,0,0,529
17,5,12,3,7,341827,179224,46,6205,466
7,3,4,4,20,46579,38984,0,0,548
5,3,2,2,6,8125,8125,57,4860,510
14,7,7,8,18,41294,56390,159,14280,465
12,6,6,6,7,55304,54711,308,5501,415
18,8,10,6,18,59144,61232,11,33154,404
10,5,5,0,9,8028,0,11,0,619
21,11,10,0,21,3299348,0,13,0,633
13,3,10,0,13,9411,0,5,7812,645
20,6,14,3,5,31767,2736,21,14055,526
4,2,2,1,17,383681,129246,7,129246,467
6,4,2,3,5,58813,25966,78,0,525
46,10,36,4,15,406064,642155,70,125,588
17,5,12,2,9,180534,21090,60,2101,635
11,6,5,4,7,345772,27644,154,15039,471
6,3,3,4,6,178959,214807,51,174346,580
28,13,15,3,15,2215546,14473,40,1188,486
16,3,13,2,13,19349,10819,54,19334,478
4,1,3,1,10,2982,2982,17,2982,566
26,10,16,3,8,31064,3262,268,10250,492
13,6,7,0,11,184838,0,16,0,635
15,7,8,6,14,109639,47124,77,2691,474
9,2,7,0,13,0,0,56,1584,661
39,3,36,2,10,62043,11079,119,7458,510
4,1,3,1,8,16114,16114,31,0,504
3,1,2,1,9,3892,3892,6,10829,389
10,6,4,3,6,21383,3302,39,2758,407
18,12,6,13,14,228708,346977,204,99042,394
12,7,5,0,25,1423276,0,26,1295,674
13,8,5,1,7,46391,118,8,118,495
19,11,8,1,13,134583,690,51,439,533
13,4,9,3,9,212650,27094,60,14166,450
33,10,23,0,6,28702,0,16,7197,504
6,4,2,2,14,112387,85818,34,85768,504
123,6,117,3,27,226009,126029,60,41412,628
9,6,3,6,25,70648,61316,45,25163,431
30,8,22,4,6,425368,35702,49,12309,438
9,3,6,1,22,880842,1422,27,0,643
17,8,9,2,14,150518,43777,27,0,522
13,9,4,2,49,146032,3057,8,3026,461
19,6,13,2,5,93970,1473,13,3649,547
8,2,6,2,5,6796,6796,4,3984,479
19,12,7,9,12,142066,139875,388,54243,426
11,8,3,2,15,90114,41079,12,20970,677
10,3,7,3,6,63663,63663,42,0,472
17,6,11,1,7,354778,1786,160,3278,478
31,11,20,6,15,250800,62819,78,350,458
17,10,7,2,7,63355,7634,10,537,508
14,10,4,11,11,210913,166630,0,0,453
16,8,8,4,10,491455,20430,20,9380,436
8,1,7,0,12,7954,0,3,4506,552
7,4,3,1,12,566070,30537,21,22727,525
7,3,4,1,10,21816,14216,22,14216,661
57,9,48,0,15,372677,0,17,9973,560
58,11,47,1,14,529401,397,84,9490,542
26,5,21,1,14,173396,762,19,2695,505
11,7,4,5,8,17272,8494,34,4284,385
10,1,9,1,11,212107,8857,9,8857,475
10,6,4,2,13,366506,7895,25,4484,618
6,3,3,3,19,5118,6711,29,6266,511
11,6,5,0,5,40303,0,0,0,601
8,6,2,0,12,17258,0,110,17296,542
3,0,3,0,2,0,0,90,2115,522
15,8,7,1,18,331362,10390,16,0,545
10,7,3,3,15,86040,27547,61,18546,502
6,4,2,5,7,30126,54115,17,9903,490
16,6,10,2,19,446090,18247,161,556,606
5,3,2,0,9,0,0,0,0,648
9,4,5,5,11,59149,50561,103,0,538
12,7,5,2,14,365729,63571,62,23744,529
67,12,55,0,6,547280,0,91,13036,539
3,1,2,0,12,220592,0,0,0,602
52,12,40,8,15,190975,29626,290,8081,425
27,9,18,8,13,99153,99153,374,23030,410
13,6,7,4,14,44717,36312,69,13646,462
8,4,4,3,12,8486,7735,9,4307,487
9,4,5,4,7,28317,18321,131,12335,578
17,11,6,0,5,193286,0,3,0,528
19,7,12,4,10,19542,6406,27,3529,432
10,3,7,1,19,348627,6914,24,6914,575
8,6,2,0,9,373762,0,5,375,637
8,6,2,6,4,338651,310180,13,5995,410
16,9,7,0,11,1130043,0,6,0,539
26,3,23,1,13,3634,3634,20,3634,464
25,12,13,10,10,705391,86207,110,40935,427
43,5,38,1,10,84904,2204,47,5480,442
6,4,2,5,5,18848,17818,23,6071,445
9,5,4,3,13,10024,10024,207,8340,417
7,3,4,0,26,25542,0,1,642,549
10,3,7,2,16,105823,148100,50,0,529
13,5,8,1,11,29777,824,23,1385,675
2,0,2,1,4,1550,1550,3,1550,604
10,7,3,8,4,70449,67672,117,15685,421
17,9,8,9,16,504378,219583,124,4421,552
20,3,17,1,7,12863,8006,35,8006,501
17,8,9,8,6,42216,47997,118,12324,391
11,8,3,7,4,15700,14498,43,2696,401
14,0,14,0,14,0,0,0,4681,524
25,9,16,8,11,837135,70584,169,16202,416
14,9,5,0,8,520880,0,0,0,662
11,6,5,4,15,10018,7708,162,5907,483
8,3,5,2,11,20624,20624,23,2150,443
7,5,2,1,12,47831,5786,21,0,496
6,3,3,3,6,9622,8872,66,4025,560
8,4,4,3,11,10410,12629,53,9708,579
17,7,10,4,19,507763,9129,68,1635,489
5,0,5,1,5,0,2248,0,0,624
17,10,7,7,12,384160,28185,148,7665,439
17,10,7,10,12,313142,98793,172,23016,432
13,4,9,3,12,9072,9072,41,8297,514
11,4,7,2,14,27558,8369,14,0,446
14,4,10,3,7,8822,6776,64,3068,550
17,5,12,4,6,38872,42836,39,22160,521
22,4,18,0,16,41762,0,11,6733,535
7,4,3,3,4,286293,84756,34,0,491
23,9,14,9,6,69298,70701,158,12500,437
19,11,8,9,9,187389,228317,156,430,439
5,2,3,1,13,14716,14716,101,14716,652
15,3,12,0,8,34268,0,2,2153,634
8,2,6,3,7,32911,41078,47,2407,560
14,7,7,4,10,340388,3155,198,1496,500
9,6,3,0,6,570304,0,11,595,508
12,7,5,0,10,238964,0,6,0,606
30,10,20,7,8,96180,95799,95,6329,458
6,2,4,0,6,13875,0,7,188,591
29,10,19,8,13,76244,55665,228,28640,446
16,8,8,6,12,79605,73079,19,10991,439
10,7,3,9,10,35300,225814,0,0,465
31,11,20,5,12,296352,43025,125,55918,432
15,6,9,2,5,18772,2335,6,5880,525
9,6,3,0,6,47066,0,12,3180,667
7,3,4,2,9,313588,19255,0,0,473
3,1,2,1,6,4092,2793,0,0,451
12,3,9,1,14,81129,1154,19,29016,542
6,3,3,1,13,26683,13630,27,13630,502
13,4,9,1,4,49238,11490,87,11490,458
4,1,3,1,6,580,7558,0,0,634
11,4,7,3,15,66201,155957,62,969,559
9,5,4,3,13,414592,17354,30,9332,438
16,9,7,3,7,52741,14139,33,6523,434
4,2,2,0,2,4136,0,0,0,611
6,3,3,1,6,32802,169,0,0,647
4,2,2,1,11,603099,6458,3,1390,688
27,9,18,8,11,244475,59664,55,1200,478
8,5,3,3,20,150115,6035,17,4050,482
22,8,14,5,15,313411,367618,110,157567,453
18,9,9,2,7,19856,7223,17,4492,505
11,5,6,2,10,606211,14716,17,7153,505
6,2,4,1,7,498,498,29,868,569
14,9,5,0,16,478994,0,3,0,522
21,3,18,4,8,16503,16148,114,11721,467
12,10,2,3,4,331411,3795,32,2832,403
5,2,3,0,12,1240,0,0,0,647
22,4,18,4,9,21428,14235,4,5374,466
17,8,9,1,11,84993,1998,26,5003,427
9,1,8,0,3,18092,0,4,0,669
10,4,6,5,19,11629,37529,109,26385,459
37,9,28,7,8,77904,28621,425,15489,455
19,5,14,2,8,213877,40232,16,25845,528
62,13,49,9,16,177389,153707,166,2124,422
15,10,5,0,4,251995,0,6,0,600
9,2,7,2,14,230374,23358,28,12936,491
13,7,6,0,19,39856,0,0,0,675
22,15,7,12,20,540476,131157,208,3129,435
14,10,4,6,8,153366,57328,89,6351,497
2,0,2,0,4,0,0,0,0,613
37,16,21,10,8,616706,420841,175,377,488
16,7,9,1,6,227519,5187,0,0,450
4,2,2,0,5,35394,0,32,0,566
9,5,4,3,11,236851,4841,119,8800,463
15,6,9,0,8,51780,0,0,0,624
20,6,14,1,14,26601,300,0,1034,674
7,5,2,0,7,105113,0,0,0,658
22,8,14,8,6,104997,102495,115,9273,437
63,18,45,7,8,56799,81985,290,12974,475
14,10,4,5,19,1101718,72085,74,5902,494
29,13,16,7,24,231537,231572,391,78524,437
7,2,5,0,7,3948,0,57,1452,583
3,0,3,0,9,0,0,2,0,648
15,7,8,0,11,32501,0,11,0,687
9,6,3,1,6,51058,2005,12,2005,522
14,8,6,0,6,103419,0,7,0,526
9,3,6,1,10,6959,65,27,4449,418
11,8,3,4,69,390756,20671,30,14389,438
22,12,10,1,27,878904,1115,2,1115,519
204,11,193,3,11,612778,23734,161,9222,523
20,6,14,0,8,124803,0,6,1250,675
8,3,5,0,9,381193,0,27,79,543
12,3,9,3,14,14931,14930,128,12526,466
11,5,6,1,5,14354,1122,14,1122,471
94,15,79,12,13,165777,118900,186,70726,463
8,1,7,1,8,13112,430,10,2200,646
9,2,7,4,14,18232,27046,21,14529,401
11,6,5,4,11,437733,6568,112,1238,481
60,9,51,2,14,91776,5333,30,3906,530
28,10,18,0,17,652956,0,0,0,715
13,4,9,4,8,15750,23657,74,11962,520
5,3,2,4,4,43086,43086,167,26863,496
13,6,7,1,11,94641,1017,0,0,576
6,4,2,2,9,436630,124317,39,1142,525
4,2,2,2,8,7169,7169,106,9698,463
23,5,18,2,4,58890,21881,29,17119,459
13,3,10,5,8,20052,29917,16,6762,472
37,24,13,3,14,535328,6425,103,2857,466
10,3,7,3,9,53710,53710,76,615,513
16,7,9,1,13,985334,8786,8,8786,491
4,0,4,0,17,0,0,0,1505,666
30,3,27,2,13,2992,58515,240,4974,518
36,13,23,4,14,292459,4315,195,2501,528
24,12,12,9,11,190472,145857,101,5608,414
5,3,2,3,14,16948,16948,16,13339,395
3,1,2,0,4,0,0,16,0,492
8,5,3,2,3,28087,17388,74,4544,472
17,1,16,2,8,1119,3293,0,0,585
44,4,40,4,14,20834,20834,63,15690,525
11,3,8,0,6,10586,0,35,0,521
28,12,16,12,9,1159213,1055339,93,0,524
33,13,20,10,11,743799,101534,219,9667,376
19,10,9,7,3,120007,44217,84,11306,472
6,3,3,0,14,26435,0,0,1877,595
2,0,2,0,7,0,0,0,0,680
30,15,15,2,6,106402,2826,44,7097,553
16,4,12,0,14,431272,0,6,0,583
8,3,5,3,8,21805,21805,51,11755,546
23,19,4,17,12,140182,57124,98,23486,449
18,8,10,6,17,45120,62909,133,17727,480
5,3,2,1,7,6139,6139,25,900,575
12,4,8,2,8,24547,18560,236,14607,516
17,7,10,2,11,391215,1240,74,1083,480
65,11,54,10,13,90488,78538,197,18746,419
25,4,21,0,13,77646,0,11,0,658
7,1,6,1,4,3453,3453,8,3453,483
6,3,3,2,13,31255,31255,36,14326,536
4,2,2,2,4,3771,3771,4,3078,516
43,32,11,10,8,348490,14663,116,4109,411
28,7,21,3,15,260493,44201,46,33546,479
21,7,14,6,12,143134,35780,188,15130,476
23,13,10,4,18,62314,19472,112,15147,482
6,4,2,1,12,55975,3251,1,0,511
8,2,6,5,14,324090,546777,77,0,576
48,19,29,8,12,325624,93423,29,1100,475
10,5,5,2,5,246805,1467,135,660,459
16,6,10,6,20,876382,269887,128,0,532
19,6,13,2,9,74160,5508,0,0,450
12,4,8,3,10,93970,22743,60,3180,510
18,4,14,0,19,90840,0,13,13548,662
6,2,4,4,8,38333,78093,17,27243,458
17,12,5,11,16,80204,78381,171,57057,448
7,1,6,1,3,1154,732,16,732,654
2,0,2,1,9,16360,16360,7,0,630
24,5,19,5,10,79747,63524,21,13534,465
12,5,7,5,6,25961,23257,82,11919,576
115,12,103,8,14,71334,43035,232,28829,414
9,6,3,6,10,329532,114013,57,9559,370
22,4,18,2,19,8578,8252,0,2735,630
13,7,6,0,5,328281,0,2,0,395
12,4,8,3,14,16154,20661,57,10491,461
6,3,3,2,8,17862,17862,18,8931,625
25,9,16,1,9,865069,17461,36,17461,525
8,6,2,7,16,21538,20799,105,8166,493
25,8,17,0,7,45360,0,46,4696,594
6,3,3,2,14,29707,23002,51,687,468
20,3,17,3,12,15571,2670,70,908,500
18,7,11,5,4,78410,38800,145,11964,426
11,5,6,5,13,73894,117904,48,27077,690
10,4,6,2,16,466563,143784,29,0,540
27,9,18,3,9,43217,13154,59,11580,520
14,10,4,9,3,1577188,836307,93,0,437
12,2,10,3,5,14110,14110,8,4422,417
10,2,8,0,6,0,0,72,6664,504
11,2,9,1,18,230276,5335,40,0,491
13,6,7,2,15,297103,78249,29,49087,466
12,8,4,4,18,184220,15482,66,48644,451
33,3,30,3,6,33650,1957,160,1412,559
11,5,6,1,3,13003,710,21,2670,537
42,9,33,6,7,54937,19351,23,10315,498
4,2,2,1,5,12424,2758,3,0,533
13,11,2,9,6,149329,24882,0,0,464
17,10,7,9,9,54831,54829,155,10258,468
15,11,4,9,15,68332,32215,45,2802,415
3,1,2,1,8,14183,7603,35,0,522
41,9,32,3,15,74637,24444,44,20607,532
5,1,4,0,14,8938,0,9,3229,592
19,14,5,9,7,151052,126549,309,6240,410
12,4,8,1,18,64637,18749,0,2585,575
19,8,11,1,5,242048,140,12,0,606
6,3,3,0,5,13967,0,0,0,682
10,6,4,3,6,28275,13784,21,7549,460
38,10,28,0,17,121407,0,11,34296,480
11,5,6,5,9,65658,128441,76,3389,443
6,3,3,1,8,34288,7447,16,0,484
15,2,13,0,12,18022,0,0,2168,632
25,14,11,10,9,118848,69637,210,28657,445
3,1,2,0,3,18209,0,1,0,568
24,10,14,5,12,295601,17888,110,10023,436
8,4,4,3,9,96261,96260,60,4084,619
26,2,24,0,5,17318,0,4,3194,541
6,3,3,2,6,137778,7195,14,2955,473
19,10,9,11,6,32450,42615,199,12021,382
10,5,5,1,19,453385,511,2,511,589
5,3,2,2,13,73598,4570,20,3806,575
7,5,2,5,7,11304,11304,388,11044,548
22,10,12,10,9,811638,538914,253,26916,451
5,2,3,1,7,8618,8618,66,2003,641
11,5,6,4,5,21168,11377,77,4416,472
9,4,5,3,9,32969,32969,68,17379,479
17,8,9,5,14,27845,25230,116,7244,433
44,14,30,1,12,561468,428,30,2271,508
5,2,3,1,6,9051,9051,96,9051,619
20,13,7,6,20,258829,58033,135,13466,507
7,5,2,5,9,22671,22671,35,11298,451
8,2,6,5,6,122966,154569,36,41734,559
13,5,8,4,10,455989,32100,60,2200,505
31,7,24,6,7,37614,25887,0,0,441
56,2,54,2,14,45033,17516,29,20387,617
30,9,21,2,11,64744,32449,86,4790,532
9,4,5,5,8,109791,164950,70,75121,533
14,11,3,6,6,27063,31091,120,7430,437
6,0,6,1,7,0,8896,19,8896,607
8,3,5,2,7,17004,17004,134,15054,477
6,4,2,3,4,25970,40033,23,0,493
36,14,22,12,14,1053304,917023,318,348825,372
4,2,2,0,10,9087,0,0,1055,632
13,4,9,0,11,700905,0,0,0,672
9,5,4,1,17,525571,2800,13,305704,598
27,15,12,0,19,277863,0,8,23161,491
13,8,5,2,15,240065,1761,9,2554,496
10,8,2,3,11,525789,36141,49,27425,546
16,5,11,7,6,41329,47624,7,7158,461
15,7,8,3,13,173558,69565,62,0,517
31,13,18,0,13,585446,0,24,2351,647
28,10,18,2,14,234725,1525,10,1285,421
18,7,11,1,20,148625,3800,49,1580,480
27,14,13,7,11,83284,72251,103,42865,422
15,12,3,10,11,211392,51140,174,8951,384
6,4,2,1,9,382517,32,10,69,501
16,10,6,7,9,113421,74235,297,13104,439
14,6,8,2,14,278584,13306,0,2634,532
15,8,7,10,10,641903,526200,194,0,495
25,9,16,9,9,69975,61936,123,10913,431
17,4,13,2,13,6666,2786,14,4130,494
11,5,6,4,18,334394,24242,169,10192,498
48,7,41,6,13,117715,50879,188,16300,412
9,7,2,6,23,30993,29078,125,15913,483
5,3,2,2,11,36185,19362,24,13974,519
7,3,4,1,13,5523,5523,24,5523,634
31,8,23,3,11,285271,1442,175,1494,439
4,1,3,0,6,0,0,0,0,740
10,4,6,4,8,64606,64602,51,61137,437
28,10,18,6,8,237220,27909,45,14206,474
8,5,3,2,6,9318,6658,42,6401,618
12,4,8,1,6,6010,45603,14,447,565
7,2,5,1,9,2190,2190,22,2190,479
16,4,12,0,14,224320,0,7,0,495
51,13,38,7,18,548631,17409,57,8883,483
6,2,4,2,8,3997,3997,28,2405,497
8,3,5,3,8,39196,55349,42,0,467
82,3,79,0,16,4535,0,7,986,696
16,6,10,3,13,76070,70247,81,0,509
4,1,3,1,25,350912,9128,5,0,650
27,6,21,5,12,66685,66535,112,23722,518
10,3,7,0,8,923811,0,51,12876,608
14,8,6,0,14,1541727,0,53,0,589
21,6,15,5,7,55394,42789,38,2372,441
6,4,2,0,4,26110,0,1,3849,626
4,2,2,1,11,6150,6150,25,0,507
13,9,4,6,22,48404,28022,58,9919,461
28,9,19,6,8,217193,210164,165,77500,427
41,7,34,6,8,11232,10436,337,21695,444
60,12,48,0,15,344982,0,18,9973,560
7,5,2,0,2,44474,0,1,0,606
4,1,3,1,11,7682,6013,25,0,661
16,3,13,2,16,246177,6904,37,5274,511
8,2,6,4,10,0,289637,0,0,624
16,8,8,2,17,877059,2320,14,1192,483
9,3,6,1,19,78290,3672,8,1380,652
28,7,21,5,8,31096,25239,155,8427,412
7,4,3,0,8,51168,0,21,3621,513
16,8,8,1,12,435687,7330,2,504,432
9,4,5,2,13,17351,14453,29,10719,617
6,4,2,4,3,401469,70670,18,0,487
13,8,5,5,17,338331,120019,110,46501,530
13,7,6,1,5,77339,993,71,432,575
16,11,5,6,7,54393,33183,46,20018,453
17,5,12,6,11,9980,11000,76,2562,483
9,5,4,2,13,511399,40493,48,22615,631
50,5,45,0,19,62759,0,0,1898,603
15,6,9,6,8,14027,43648,63,4395,572
50,16,34,9,30,180429,87797,144,19034,387
17,8,9,8,9,36486,20429,63,0,486
33,13,20,10,11,433705,46020,62,3812,433
5,2,3,0,6,4431,0,27,1929,613
14,4,10,7,18,182824,218278,168,85120,511
15,9,6,0,22,664224,0,1,5373,529
5,3,2,4,7,15714,24543,190,13478,467
30,6,24,3,8,625731,64880,120,22893,478
28,9,19,15,16,957956,1193956,101,16052,438
5,3,2,2,9,10774,7798,17,5942,536
16,8,8,2,11,106969,21657,69,0,458
8,5,3,3,2,27005,366,80,2969,578
5,3,2,0,13,23286,0,2,3874,608
8,2,6,3,13,35455,45134,22,19286,482
29,10,19,10,14,2042713,588687,102,2018,509
9,6,3,4,11,92043,17074,29,72256,454
10,5,5,5,10,305792,287498,179,2940,557
13,2,11,2,6,4326,4326,27,2266,496
12,6,6,1,19,20889,4999,24,4999,531
18,9,9,5,9,119137,43747,161,19452,466
8,6,2,6,14,60090,51544,15,5882,430
8,3,5,6,7,61585,63102,94,40295,548
27,6,21,4,11,25244,3954,53,7122,488
14,10,4,8,15,383208,208394,80,79377,449
3,1,2,1,8,89845,89845,33,0,507
6,4,2,2,14,25450,20741,35,0,474
8,6,2,0,12,33297,0,23,806,565
9,6,3,0,13,76689,0,12,9888,568
5,3,2,2,5,10636,1113,3,616,482
16,14,2,13,7,95308,92716,469,20989,400
14,9,5,0,6,104421,0,3,277,620
8,5,3,0,10,411346,0,22,2862,579
41,11,30,8,14,226331,134078,221,20822,478
21,7,14,2,28,54954,157560,32,0,658
25,13,12,0,8,4084672,0,1,0,628
23,7,16,3,31,395991,283880,0,0,503
7,2,5,2,5,22251,18295,40,0,532
16,9,7,8,17,280399,204819,90,2541,445
27,6,21,3,10,101882,14719,151,4259,609
12,4,8,2,7,76949,76949,20,9559,599
20,5,15,0,15,68417,0,4,1063,552
10,5,5,1,9,115171,14140,13,4132,660
2,0,2,0,4,0,0,0,0,639
40,4,36,4,7,37710,18204,21,8263,460
6,3,3,2,9,14834,599,38,936,524
21,11,10,3,18,623025,44244,53,50525,445
8,5,3,0,17,13655,0,0,1361,658
11,4,7,1,13,60342,379,0,0,578
10,7,3,2,6,100455,25180,15,0,464
4,2,2,1,18,375056,4490,19,15593,645
12,5,7,2,18,24820,10487,0,756,480
22,2,20,1,17,11415,11415,24,11415,575
20,9,11,5,12,622126,32629,49,10922,428
15,6,9,2,11,50824,18317,46,14857,459
9,2,7,1,12,452348,2405,9,2231,594
3,1,2,0,5,14951,0,2,912,544
11,4,7,2,9,100489,11075,33,6640,531
25,11,14,8,13,408399,84866,71,5896,427
19,8,11,4,6,280565,4787,74,2600,423
4,2,2,0,9,346884,0,1,4541,637
15,11,4,4,10,63428,13588,42,5492,527
19,8,11,3,15,434758,66263,53,21840,613
32,11,21,11,11,63475,58986,262,18374,459
14,9,5,0,10,1388743,0,50,0,569
4,0,4,3,6,400,22382,55,0,562
6,4,2,4,6,5881,5881,44,2488,479
9,6,3,5,13,135769,78992,157,21623,485
49,7,42,2,7,38947,5954,28,5138,624
21,7,14,2,20,336747,19788,32,870,497
6,4,2,0,10,26748,0,4,0,596
11,8,3,4,11,24220,24220,141,3244,475
29,14,15,8,16,201962,192484,171,47105,430
205,18,187,1,19,651477,36001,147,8030,518
13,8,5,1,22,762880,29638,18,0,503
23,6,17,2,11,17408,512,275,3098,577
26,10,16,1,7,36640,1126,8,6031,442
4,0,4,1,12,0,4647,8,4647,596
10,3,7,3,10,18555,41403,0,0,517
8,3,5,0,5,21534,0,28,728,545
17,6,11,5,11,46209,27245,42,7709,443
9,2,7,0,6,64889,0,0,0,666
38,13,25,12,11,289087,274113,227,6028,415
9,5,4,1,5,57018,14832,29,0,542
21,6,15,0,4,40655,0,2,3903,574
18,2,16,2,14,17625,17625,58,15896,500
15,5,10,5,9,78783,52648,106,16643,469
20,4,16,2,10,299408,5723,101,4591,504
11,3,8,0,14,36129,0,37,1560,498
23,6,17,5,25,1156468,145965,229,102334,449
34,21,13,0,22,1194121,0,16,34262,517
11,6,5,8,8,45696,52649,165,12951,434
9,6,3,2,4,114488,5223,0,0,512
9,1,8,5,10,28001,116314,80,244,579
14,7,7,4,19,87809,40007,81,6353,435
11,6,5,0,9,92055,0,2,0,491
17,4,13,0,15,30974,0,13,25502,529
15,1,14,0,18,0,0,0,409,783
10,5,5,1,8,19880,19880,77,19880,566
21,9,12,3,11,368808,2116,179,6264,417
16,5,11,0,10,346230,0,26,3982,513
38,16,22,8,12,194922,104541,90,19425,475
45,24,21,4,26,941769,9762,15,4878,599
24,4,20,3,11,27344,24123,27,10631,482
9,3,6,1,12,7445,3836,24,24636,496
27,6,21,0,6,130196,0,0,0,609
22,8,14,3,12,259807,60412,44,4686,474
64,14,50,5,13,1088125,38485,15,11467,458
8,2,6,2,9,54560,54560,55,0,473
41,9,32,0,10,641734,0,50,1177,584
19,7,12,0,15,333008,0,63,1424,496
16,10,6,7,7,130309,64354,88,2204,469
17,6,11,1,19,41680,5209,13,5209,585
12,9,3,0,7,79764,0,0,0,649
7,5,2,5,12,33136,46433,3,18047,458
33,8,25,1,69,11640,1280,106,3049,549
9,2,7,0,13,11861,0,7,995,607
19,13,6,2,12,571676,3776,37,427,474
12,8,4,4,14,1722558,53268,6,0,475
16,8,8,9,11,202194,200300,80,7359,466
11,4,7,3,12,27770,50826,65,0,562
4,2,2,0,8,9970,0,0,0,594
15,3,12,0,5,909797,0,12,125,712
15,3,12,4,8,39978,15724,4,9830,462
16,2,14,1,9,2645,2645,18,5180,540
43,11,32,7,16,511604,56905,110,14275,411
8,3,5,2,7,7791,5735,46,6840,513
14,3,11,4,8,47877,52297,0,0,487
8,4,4,6,8,23728,42535,82,8272,434
22,13,9,10,9,121239,120291,367,25917,443
8,4,4,0,8,28484,0,4,0,666
7,3,4,0,8,1378,0,1,2821,613
15,7,8,8,6,220237,165455,114,34996,458
6,4,2,1,6,94564,10601,35,10601,555
27,5,22,0,9,446151,0,36,860,523
11,6,5,3,5,52659,17093,30,6597,448
38,18,20,15,15,325645,143733,177,59857,373
20,11,9,4,9,153147,58808,149,1670,461
23,7,16,4,8,51712,27923,184,9286,467
14,6,8,7,8,199902,163592,125,49877,451
9,2,7,2,9,159947,5588,208,1496,625
6,3,3,3,4,8147,7407,18,4443,512
18,4,14,1,2,31770,7849,5,7849,515
15,7,8,5,13,23666,25574,46,34397,439
5,3,2,2,9,204292,6549,35,1875,500
9,3,6,0,4,31706,0,0,0,639
58,12,46,5,16,344088,51240,43,19419,437
11,7,4,2,13,384441,4323,69,3726,469
4,0,4,0,10,0,0,5,7672,579
19,10,9,7,11,59552,68405,302,36806,378
16,11,5,6,14,664977,82005,62,8827,506
8,6,2,6,5,24790,19736,17,185,488
27,8,19,4,14,134664,10287,99,5022,449
12,6,6,0,7,344770,0,0,0,665
7,2,5,0,9,53328,0,11,0,669
28,10,18,8,15,39576,22731,69,6866,457
5,3,2,2,7,128086,19963,25,15236,473
18,11,7,4,20,337037,58053,76,24058,474
37,3,34,1,14,13888,3764,5,3764,550
49,16,33,0,15,387417,0,0,0,609
5,3,2,2,5,6344,729,22,589,480
12,7,5,3,10,72029,458,65,1263,477
8,2,6,1,6,49856,38743,27,0,517
18,7,11,0,7,204567,0,143,654,563
21,11,10,5,8,83381,123531,80,5339,460
11,6,5,4,22,400525,388995,104,286065,493
14,7,7,3,8,96771,30276,20,14352,465
10,7,3,4,9,343248,90435,0,0,439
8,6,2,0,6,514686,0,0,0,631
11,6,5,0,14,60829,0,13,0,630
9,7,2,3,16,33947,22136,25,43036,474
36,4,32,0,8,24531,0,20,2145,638
7,4,3,3,16,280308,506974,0,0,583
4,2,2,0,7,0,0,0,0,686
80,7,73,4,18,319005,39919,307,18860,459
7,5,2,0,3,20275,0,0,0,635
100,9,91,3,11,172654,475,316,3564,504
11,6,5,6,5,28707,39844,279,13225,446
21,6,15,3,22,54651,78923,68,33202,676
8,3,5,3,4,31215,31215,69,0,546
7,5,2,1,11,25236,2245,8,2246,525
6,2,4,0,4,23055,0,40,0,638
18,12,6,8,69,666569,193388,172,60961,490
3,1,2,1,11,1454,1454,9,2450,633
25,9,16,1,12,290541,854,16,854,437
5,3,2,0,4,7390,0,1,0,639
10,6,4,0,3,3648,0,6,0,559
4,2,2,0,11,5897,0,0,1528,652
9,3,6,1,12,26161,2490,8,0,478
13,8,5,8,14,55922,52758,125,2872,459
10,4,6,3,4,21735,9586,52,176,523
18,13,5,7,18,411508,44450,88,0,453
10,8,2,5,5,31535,27565,285,10528,474
10,3,7,2,19,296932,7522,8,1505,553
24,10,14,3,19,285481,35383,0,0,501
42,3,39,1,11,24648,308,10,3086,684
8,6,2,6,10,232774,72709,289,4327,455
12,5,7,2,7,35508,35508,44,10485,491
7,5,2,3,10,445073,4563,53,2988,462
10,3,7,0,5,21956,0,0,0,650
23,7,16,2,12,49921,6642,33,5659,523
20,2,18,3,5,7705,7705,64,0,504
58,4,54,1,9,140337,320,95,2205,466
36,3,33,1,10,20122,98,9,728,526
6,4,2,2,7,70534,30270,0,0,520
4,2,2,2,8,7638,1884,20,569,475
29,19,10,0,21,3194719,0,2,3317,586
11,5,6,4,15,122255,78373,17,17613,504
45,17,28,6,24,581706,56348,227,2472,452
5,3,2,3,8,21312,5688,35,693,604
3,1,2,2,5,7322,16660,19,7322,521
5,3,2,0,15,240607,0,0,0,658
43,9,34,2,13,547758,47999,106,20180,625
17,9,8,4,13,147774,15094,88,6596,499
13,11,2,5,14,396529,283232,59,194434,459
13,2,11,3,6,49640,49640,57,19721,549
15,4,11,5,19,63948,342213,122,0,520
12,4,8,1,12,370040,14048,46,14048,560
27,9,18,8,12,204902,92249,60,5000,469
26,15,11,16,7,579584,581817,172,19470,382
12,7,5,4,11,15247,13329,247,11987,470
8,1,7,2,8,5393,10786,182,5393,476
6,4,2,0,6,97601,0,4,0,578
10,7,3,1,7,234687,14429,11,1330,511
18,3,15,1,19,8130,541,0,0,438
7,5,2,5,9,71704,44443,114,31978,458
4,1,3,0,7,1827,0,3,0,662
70,12,58,0,33,437003,0,16,890,493
31,13,18,0,25,599890,0,0,0,746
18,8,10,0,22,171376,0,7,0,674
4,1,3,1,26,20148,75051,30,0,532
10,8,2,1,3,54638,1749,5,1749,454
24,6,18,4,16,202946,80492,59,95492,476
11,0,11,2,8,0,24810,31,0,605
23,3,20,3,11,683127,35451,80,10533,525
27,15,12,0,12,2242271,0,0,0,682
22,1,21,1,7,27000,5400,27,6930,542
14,8,6,6,9,37733,36568,55,15668,419
12,1,11,3,12,1689,7323,153,3970,489
29,11,18,0,12,1232995,0,0,0,678
66,15,51,10,11,79787,33146,166,17961,439
34,6,28,5,6,175794,39524,59,5362,501
10,6,4,5,12,13862,9977,57,3678,470
9,6,3,1,4,266323,225,0,0,497
4,2,2,3,4,27264,27264,32,4313,452
30,12,18,4,10,158101,16041,131,9540,526
13,8,5,7,19,64625,100476,58,21766,495
7,5,2,7,4,78557,69568,80,13468,429
12,2,10,3,4,4277,8942,37,3207,466
144,17,127,5,13,227942,36578,112,7295,503
39,10,29,0,5,326327,0,0,299,616
2,0,2,0,4,0,0,0,0,506
7,5,2,5,8,21248,30076,103,10293,539
32,20,12,1,20,553130,1639,5,2867,572
12,6,6,10,14,309073,200362,180,16480,418
19,12,7,11,16,217864,242075,271,5470,501
11,5,6,4,8,41780,748,92,1250,525
36,3,33,2,14,183294,32907,142,31642,537
12,9,3,0,6,30571,0,0,0,671
21,8,13,4,12,32767,24500,61,7340,440
26,3,23,0,13,28574,0,32,4046,600
3,1,2,1,18,0,582,0,0,645
8,1,7,1,12,6297,6297,23,6297,469
5,2,3,3,8,50064,53098,72,0,522
10,8,2,0,7,7968,0,0,0,639
5,3,2,0,22,887265,0,0,0,502
20,12,8,10,10,903600,523411,118,162215,396
7,5,2,1,20,109355,11441,14,11441,552
7,5,2,0,9,20474,0,0,0,677
26,9,17,10,29,957946,324339,204,0,453
6,2,4,1,5,14022,4579,21,4579,599
11,4,7,0,7,50705,0,126,1197,525
26,6,20,4,12,86735,29328,264,14442,587
12,6,6,4,5,87461,88914,47,68382,472
20,6,14,1,15,396432,31573,19,760,545
5,1,4,0,10,0,0,2,0,687
26,14,12,12,9,476041,169313,141,76950,417
9,5,4,3,11,37511,8054,50,5379,444
6,2,4,2,8,1385,1385,24,1181,456
31,1,30,2,15,10946,21892,0,0,601
4,2,2,1,7,18214,11250,23,11250,696
6,3,3,0,9,250074,0,5,0,555
23,14,9,0,5,188902,0,8,216,596
11,5,6,4,18,43519,184609,70,9683,576
39,10,29,5,15,476232,44413,34,19471,462
13,7,6,6,8,26171,18504,100,6063,480
9,1,8,1,10,582,515,0,0,499
41,7,34,2,7,279167,19611,18,13525,426
8,5,3,4,7,394750,175429,121,28402,440
20,6,14,5,13,30543,28277,60,23551,479
23,16,7,2,11,109144,4205,22,723,456
5,3,2,2,8,11792,1838,8,1701,514
5,1,4,1,7,250,250,6,385,444
9,6,3,5,4,22933,16487,0,0,440
8,5,3,3,14,451973,38657,53,6181,436
10,7,3,1,5,169355,340,5,340,483
5,1,4,1,8,10433,10433,25,10433,479
7,3,4,0,9,106793,0,27,28137,544
6,1,5,0,6,12245,0,0,0,539
10,1,9,1,8,86016,86016,74,11317,563
13,5,8,6,9,130886,75786,143,0,495
6,4,2,0,8,24787,0,0,0,629
15,8,7,1,19,149111,238,7,911,465
15,4,11,1,7,27637,13101,15,13101,478
18,12,6,0,9,88168,0,11,241,618
94,18,76,6,16,745841,35124,28,9279,513
11,5,6,5,7,21320,29948,68,18635,460
30,10,20,3,10,261544,4548,201,5029,455
31,8,23,1,17,133271,14671,22,14671,559
9,7,2,3,12,102827,101535,34,90087,617
18,2,16,1,15,2741,1341,25,0,584
3,1,2,0,4,269491,0,0,0,612
17,12,5,0,11,694455,0,0,0,591
22,7,15,2,8,136347,2997,11,2138,547
11,4,7,4,14,7954,18592,42,0,553
9,6,3,6,8,519601,61487,112,13503,471
17,4,13,0,10,64516,0,0,0,710
52,13,39,8,19,307754,105582,179,36475,453
9,6,3,0,13,53824,0,1,0,687
17,12,5,0,11,406204,0,3,0,705
9,3,6,4,7,19118,19118,293,13349,476
19,8,11,7,7,25964,38471,90,14285,496
5,3,2,1,4,20259,7897,0,0,537
12,6,6,6,18,1358960,96132,27,90053,527
43,28,15,33,15,1097157,1199182,749,113902,500
22,1,21,0,18,155,0,25,1248,659
16,7,9,4,11,20688,8997,36,5392,459
39,4,35,4,7,60811,58888,132,26909,467
12,7,5,3,12,139208,12672,6,971,460
6,4,2,2,14,298032,22935,34,19175,556
19,5,14,2,16,200385,1667,163,2328,484
22,12,10,7,12,282732,110159,97,52918,414
339,6,333,4,13,632092,149633,80,0,418
42,3,39,3,8,26930,26930,62,7529,470
16,6,10,1,8,385200,7623,96,7623,536
53,15,38,6,28,230938,11758,69,4417,459
133,4,129,1,15,76063,547,0,2112,686
34,7,27,5,11,25258,12835,278,23643,425
33,16,17,3,11,519885,1994,18,6367,397
35,8,27,1,13,391546,7130,9,3731,470
6,3,3,3,8,180000,152759,53,0,492
7,2,5,3,7,22533,33138,46,0,507
15,7,8,6,7,375472,11357,285,2898,461
7,3,4,1,8,2008,7996,0,0,554
25,6,19,0,10,123505,0,0,0,648
5,3,2,3,13,53392,53093,72,33887,464
16,2,14,1,16,4170,1970,42,1696,501
27,6,21,6,11,25186,25186,188,14209,481
32,10,22,13,10,130368,182742,85,15661,435
19,5,14,3,9,21005,25088,166,17265,427
18,9,9,1,6,47162,275,12,357,532
25,4,21,3,8,39246,9857,1,1565,459
20,8,12,1,9,367173,9566,107,0,599
9,6,3,0,11,151452,0,0,0,586
6,3,3,3,6,7817,7817,51,2459,469
7,5,2,1,8,15503,6057,4,6057,483
8,4,4,3,8,8199,8199,53,5293,527
26,2,24,2,12,11970,2277,25,1289,584
10,4,6,3,8,27651,25254,262,17568,507
30,7,23,8,12,59569,69896,118,21633,410
10,3,7,4,15,16348,29297,63,9599,649
8,4,4,5,15,107815,57155,74,10223,436
12,10,2,6,6,30907,22431,266,6031,451
12,6,6,2,12,26146,11131,59,10838,527
101,10,91,1,8,266841,363,37,13790,421
18,7,11,6,8,64873,28797,133,9674,403
3,1,2,0,6,0,0,1,0,713
19,8,11,7,26,723321,63308,257,5228,466
13,5,8,6,18,155819,180719,1,20143,523
3,1,2,0,10,0,0,0,0,674
10,7,3,1,7,26791,1607,6,1643,491
18,8,10,4,13,242517,84884,71,3300,509
49,8,41,1,14,298590,16911,14,1540,528
3,1,2,1,3,3432,3432,32,3432,478
17,6,11,0,11,43664,0,0,0,641
15,8,7,0,13,290985,0,0,0,705
17,5,12,1,9,51690,848,71,174,455
29,11,18,2,21,796970,993,35,38541,480
12,6,6,5,18,333914,45969,69,16623,475
74,5,69,1,4,630170,14224,143,14225,495
30,9,21,9,11,50616,47069,110,11763,458
16,12,4,0,11,346245,0,8,1100,613
47,19,28,7,9,96212,13247,63,3725,419
31,11,20,11,31,1630275,436569,209,779,508
20,10,10,7,13,82846,27057,20,4683,463
25,12,13,1,69,237861,16,53,5387,495
9,3,6,4,15,115440,198452,0,0,548
17,7,10,7,10,328975,145248,0,0,465
9,3,6,5,17,106005,102964,39,57086,453
15,6,9,4,28,52605,34500,34,1557,467
15,6,9,2,8,21080,1395,13,693,586
11,7,4,6,10,84921,52604,122,0,548
13,5,8,2,14,184363,1104,4,2784,592
9,3,6,0,9,448989,0,2,0,615
9,5,4,2,10,1320761,57889,24,0,479
22,11,11,5,9,1573438,24984,25,4283,524
10,0,10,0,5,0,0,24,0,587
7,5,2,4,8,20340,13289,0,0,481
17,10,7,0,15,639125,0,3,980,628
9,6,3,0,9,142313,0,0,218,691
32,8,24,4,13,84728,36376,65,12068,427
8,5,3,0,23,55333,0,0,0,713
9,6,3,7,5,331385,54132,106,10377,511
10,6,4,4,10,484440,145606,90,0,457
85,11,74,11,17,99547,107365,285,37184,432
10,5,5,4,12,60244,7569,35,2748,541
30,4,26,1,12,80952,2280,27,7763,606
38,7,31,2,5,29788,1818,116,32074,539
27,11,16,4,10,67477,11172,71,5912,527
9,4,5,1,14,114146,9015,24,9015,532
24,9,15,0,13,3062464,0,1,6139,693
4,2,2,2,5,3585,3585,13,1845,499
10,3,7,2,7,8236,15020,2,1506,484
17,12,5,0,10,1542175,0,15,0,597
36,11,25,0,9,99126,0,85,369,474
60,4,56,1,9,10781,7009,4,11099,565
11,5,6,5,7,419658,26710,41,5272,473
12,6,6,5,17,211755,97785,25,45336,468
31,7,24,1,6,64758,1537,2,0,540
16,9,7,5,7,269678,40255,68,6139,465
4,2,2,3,3,7200,10785,35,3586,446
40,25,15,22,14,748459,414215,262,185677,414
7,5,2,1,6,20890,2372,66,2372,519
63,13,50,7,13,287679,54078,215,19565,419
26,4,22,0,7,48425,0,4,3519,594
29,9,20,0,14,527023,0,1,0,721
7,1,6,1,8,241679,50437,20,0,632
31,10,21,9,17,449201,120425,102,6332,511
16,4,12,3,9,303120,15808,92,8676,522
6,3,3,0,17,179314,0,14,0,629
9,7,2,4,12,11595,11025,35,3969,486
9,4,5,1,16,335481,10684,37,10684,581
13,6,7,2,12,40223,13517,39,7757,581
6,3,3,2,7,69690,2332,67,1200,511
18,7,11,1,15,409066,23712,7,914,679
22,3,19,0,13,45164,0,17,7426,545
7,2,5,2,16,5973,9648,12,5973,483
12,6,6,4,15,640366,11442,61,0,496
9,5,4,5,14,185497,209616,74,66666,472
17,11,6,7,11,419990,48822,187,18135,477
6,2,4,0,12,41511,0,1,4374,585
11,5,6,0,3,51464,0,1,0,579
15,9,6,8,11,465763,46349,0,0,415
10,7,3,5,6,109421,85721,89,62447,471
31,9,22,7,9,345170,67447,147,25841,470
29,14,15,1,9,1069392,12361,3,12361,535
34,6,28,0,14,180520,0,4,364,661
5,2,3,1,12,10418,2730,19,775,573
11,6,5,7,7,48959,39248,109,3412,364
15,3,12,0,8,5666,0,1,2142,681
36,8,28,5,18,204254,37405,104,15567,484
17,11,6,8,11,86244,16295,143,7420,455
11,7,4,0,11,718765,0,21,0,625
44,10,34,3,13,49885,39244,46,28674,419
10,6,4,3,6,254247,5361,19,4555,507
6,2,4,2,4,4353,3838,11,3835,621
17,7,10,4,16,196952,275918,87,140572,439
19,17,2,2,19,7245855,775344,10,775178,517
8,3,5,1,16,219327,576,14,1955,486
6,4,2,4,5,5187,5186,44,3004,534
10,7,3,2,8,105207,36982,29,35966,597
6,1,5,0,11,5862,0,0,0,652
35,10,25,11,17,373805,268182,223,18875,467
6,3,3,5,7,23173,22391,122,9045,395
14,8,6,3,8,232162,3437,30,0,454
16,3,13,3,18,14684,14684,15,7473,488
28,7,21,5,13,192897,132320,42,39501,459
30,15,15,18,22,913527,1294777,325,21703,506
8,6,2,0,7,469176,0,2,0,585
13,10,3,2,5,537481,537,6,0,589
15,6,9,3,11,21252,17019,68,9370,499
5,3,2,2,6,1659,1659,25,963,566
10,8,2,5,19,577078,72462,78,22554,441
8,2,6,2,12,9706,5244,31,0,518
33,28,5,1,11,509457,7360,34,7360,446
7,4,3,4,7,16770,22081,68,9765,489
7,3,4,2,9,5386,4651,35,3938,516
7,5,2,1,14,97240,3438,4,0,676
15,7,8,1,8,179851,5148,25,0,495
8,5,3,3,8,490582,48805,56,0,486
17,5,12,0,13,0,0,4,1580,662
6,4,2,4,4,250620,38768,0,0,415
24,7,17,7,17,434382,430617,60,4350,438
61,6,55,0,12,54971,0,33,2083,637
4,1,3,1,5,6044,6044,4,324,605
36,15,21,13,19,441689,342944,319,23351,434
24,12,12,3,17,154522,64725,185,3478,541
9,5,4,5,11,105590,103433,41,65879,447
28,13,15,11,12,787387,176104,491,51871,425
17,13,4,0,8,2299118,0,0,0,677
6,3,3,2,11,727589,63670,13,58194,500
19,15,4,10,8,50954,50409,118,15670,452
14,3,11,1,6,18885,2520,26,2520,601
9,6,3,3,14,86314,85329,146,26948,544
27,7,20,6,20,107367,24815,182,8284,465
38,7,31,1,13,32623,8370,31,737,521
17,12,5,2,17,692145,2988,59,0,530
7,2,5,1,11,702,326,7,2848,501
15,9,6,4,12,104843,45637,78,8230,443
6,4,2,0,2,34067,0,4,239,641
11,3,8,0,6,13047,0,2,0,689
6,4,2,0,15,27378,0,16,753,600
55,7,48,0,6,1593204,0,0,0,626
13,9,4,0,14,8617,0,6,1512,608
9,4,5,1,18,6328,6328,62,2116,516
11,5,6,1,5,17600,2678,14,2678,478
21,11,10,0,17,1889491,0,12,0,610
43,6,37,1,13,51861,2286,37,4837,517
3,1,2,0,11,1443,0,0,0,614
31,14,17,8,10,214930,137199,175,30284,524
41,5,36,1,9,49974,5743,13,5743,502
9,4,5,1,16,89057,1107,27,6098,579
8,2,6,2,9,3348,34845,36,31497,541
22,13,9,9,20,390969,39648,199,8882,503
6,1,5,4,11,51057,77515,19,2898,506
28,17,11,7,13,164385,36322,33,6900,466
24,6,18,4,20,239211,45605,66,26155,506
13,4,9,3,12,155107,153226,80,136865,434
15,13,2,8,9,300844,284701,87,4192,445
17,12,5,1,19,301530,9732,2,9732,465
22,13,9,2,9,1109281,27923,29,1477,466
28,7,21,4,8,14751,10982,164,9106,508
25,8,17,10,8,95857,60262,144,165818,472
45,12,33,9,11,1024367,274272,288,260240,380
32,7,25,6,9,114147,92154,362,37608,454
52,17,35,7,10,246260,99864,36,3000,476
22,4,18,0,7,31316,0,5,226,650
5,2,3,1,9,8875,8315,34,9740,682
15,3,12,1,36,13006,13006,14,13006,570
30,14,16,13,17,417876,111443,245,23465,450
8,6,2,4,7,5204,1844,16,856,499
29,16,13,6,11,246682,40077,116,31294,471
47,12,35,0,7,327341,0,6,131,593
10,7,3,0,4,129001,0,1,0,665
10,6,4,6,7,19278,16658,149,4960,427
69,9,60,7,11,86850,51799,199,35822,474
19,9,10,9,10,513538,60660,32,10559,439
4,2,2,2,13,10455,10455,75,8615,499
15,11,4,4,13,393890,29270,84,12329,486
36,16,20,2,13,791767,297,5,160,486
27,15,12,0,17,875212,0,6,24,664
11,4,7,0,16,466909,0,5,17136,606
14,8,6,8,6,36073,36073,255,5176,452
14,5,9,4,17,204268,112621,39,0,445
8,4,4,1,11,17971,1208,23,914,475
9,3,6,4,6,61028,72406,0,0,502
21,6,15,0,9,68035,0,4,570,581
30,18,12,2,12,3383460,21048,46,0,566
28,7,21,0,17,3992199,0,1,0,616
15,2,13,0,10,110163,0,49,1689,613
7,5,2,3,10,15875,14668,60,5446,601
21,10,11,7,14,156119,121641,123,3865,466
14,3,11,2,13,812911,78300,46,34867,467
51,8,43,4,13,172811,16400,113,2727,469
21,6,15,0,9,13305,0,28,339,616
8,4,4,3,19,440984,33254,53,1374,502
10,5,5,4,8,104111,89906,75,39051,492
15,8,7,0,18,791186,0,7,0,701
12,5,7,2,20,44988,6246,36,0,540
25,7,18,3,7,198260,8920,184,1614,623
16,14,2,10,4,63665,51896,109,5521,411
12,10,2,1,6,998557,1323,0,0,511
21,11,10,7,16,260633,119469,14,38812,459
11,5,6,2,9,307220,5958,35,5427,461
12,6,6,2,5,50541,1645,59,910,447
17,1,16,2,17,13431,13431,96,13275,543
27,15,12,4,15,132939,7453,238,1602,506
13,7,6,5,23,53518,81282,87,23880,529
25,7,18,4,19,708105,52945,94,34243,526
5,3,2,3,8,16873,20155,43,16873,527
13,9,4,0,12,148923,0,0,304,560
10,6,4,6,7,143628,22780,38,6917,426
53,16,37,6,11,139264,12883,96,8880,487
4,2,2,1,7,4245,4245,0,0,520
5,3,2,0,11,19979,0,0,702,668
26,9,17,11,8,545827,745252,221,8793,492
9,6,3,0,14,51630,0,10,0,587
5,2,3,3,9,36541,42043,54,11158,473
27,15,12,0,8,398728,0,24,0,571
16,7,9,0,13,351727,0,10,458,543
6,4,2,3,13,43309,41019,66,1026,479
28,7,21,0,7,72301,0,11,0,529
18,11,7,0,6,37679,0,96,1660,596
26,10,16,3,8,337130,1911,53,1500,436
4,0,4,0,10,0,0,16,874,536
8,5,3,3,7,32696,5904,1,1270,464
14,4,10,2,12,37146,17034,68,980,449
28,6,22,4,11,47342,9684,55,4234,540
5,3,2,4,4,6581,12434,0,0,515
6,1,5,3,9,17189,30309,0,0,495
15,8,7,2,13,230937,16614,24,3527,496
3,1,2,2,19,18584,28207,26,18584,455
5,3,2,3,6,13806,13806,50,9428,590
11,5,6,3,16,19170,19170,41,11240,518
10,5,5,0,12,33753,0,6,0,531
39,8,31,3,8,321894,307,78,2162,435
12,8,4,4,12,379911,47008,65,21145,410
23,13,10,0,7,242675,0,10,0,529
11,7,4,1,10,136818,703,28,703,517
11,5,6,3,13,434260,75838,26,4545,507
25,16,9,0,15,1169158,0,0,0,668
6,3,3,4,8,108937,108937,98,0,506
5,2,3,3,7,27416,49203,26,26698,459
17,8,9,8,20,199653,164606,30,66685,453
5,2,3,2,10,46800,46800,23,508,669
8,4,4,0,3,721700,0,13,224,534
8,5,3,1,5,25630,23051,39,1273,582
20,9,11,3,7,43861,30803,186,16535,497
32,10,22,1,22,397117,2479,290,13455,456
41,7,34,9,13,459174,227813,118,96339,423
6,2,4,1,15,12340,577,8,913,489
32,8,24,8,12,148289,131589,256,32794,504
16,8,8,1,11,2487336,84454,12,0,494
23,9,14,0,10,8037,0,2,0,650
20,7,13,5,14,373300,84949,119,25426,433
25,10,15,7,8,50722,35422,73,35419,425
6,4,2,0,8,14565,0,3,1328,639
22,9,13,8,10,172703,26789,56,8592,488
65,11,54,5,13,458957,61924,176,83399,450
12,10,2,0,5,133531,0,20,0,528
11,3,8,4,9,23790,31831,0,0,541
5,3,2,3,5,36861,36861,79,2046,613
18,9,9,11,8,61306,72786,271,22872,462
32,15,17,1,7,62195,1620,49,5788,646
9,3,6,5,8,27896,55710,83,18407,585
5,2,3,1,9,15702,15702,0,0,500
58,5,53,1,18,510930,12481,257,13811,478
19,10,9,12,21,40866,77111,262,9173,426
7,1,6,1,7,4635,4635,21,8988,540
25,6,19,8,13,24473,54198,43,11665,419
24,5,19,0,14,269642,0,65,2800,474
9,6,3,0,5,64310,0,1,197,625
6,2,4,1,6,40106,36198,28,36198,559
5,3,2,1,12,11349,11349,117,11349,575
4,2,2,1,11,333808,597,23,597,521
12,5,7,2,18,56099,34028,36,27140,573
5,1,4,0,5,0,0,70,1228,648
7,3,4,0,14,2385,0,1,1365,617
26,14,12,1,11,1293091,8735,36,0,485
15,3,12,4,20,8349,13604,26,4979,463
25,8,17,3,12,47097,30322,49,13997,490
4,1,3,1,11,1253,1142,1,1142,541
12,6,6,0,20,106056,0,0,0,685
17,11,6,11,9,106391,119081,221,38326,451
24,6,18,7,15,83266,69283,116,8068,448
9,3,6,1,7,10367,5183,31,5183,572
18,7,11,4,20,72081,52458,324,35741,483
67,5,62,3,8,83508,43541,105,40117,482
7,3,4,6,8,128230,146201,92,309,504
20,15,5,7,16,2029423,197175,60,5709,444
17,2,15,0,13,36456,0,28,1985,634
9,6,3,5,7,21732,21732,246,11650,415
9,6,3,6,14,17640,18462,94,4960,503
16,5,11,5,10,114848,77324,56,30769,422
9,7,2,0,17,8246,0,2,222,638
28,11,17,0,7,1340457,0,6,0,593
11,2,9,1,6,1939,577,0,0,623
49,0,49,0,16,0,0,1,675,673
35,5,30,3,16,11955,9808,73,9529,515
17,9,8,2,7,164207,3382,15,3819,455
18,9,9,7,17,627777,866059,126,158013,480
7,3,4,1,11,25766,25766,27,3810,549
30,12,18,2,20,1371964,47905,77,5800,549
17,10,7,8,7,213388,229562,128,69326,437
6,2,4,1,6,9001,1983,40,1154,431
41,0,41,0,2,0,0,0,0,660
26,10,16,7,8,36755,29114,95,7370,497
33,6,27,2,13,251798,5501,27,3053,508
7,2,5,2,8,8756,8756,228,8536,482
14,10,4,3,5,764344,37945,100,2395,467
24,9,15,3,11,237516,11356,8,0,494
5,3,2,5,4,15286,19112,58,8263,558
8,3,5,2,19,42004,16131,53,6528,457
9,2,7,1,13,18070,259,5,1260,629
22,16,6,0,21,722133,0,10,1710,517
14,4,10,0,15,40528,0,21,5484,515
10,6,4,1,9,53769,4733,0,500,508
12,9,3,0,9,460308,0,19,8342,614
10,4,6,2,18,402880,97900,44,14807,517
31,13,18,9,14,59072,33925,176,8907,455
8,5,3,4,12,42831,38169,25,14366,486
8,5,3,3,7,242398,14366,53,8374,514
9,6,3,0,2,21628,0,1,1773,657
11,2,9,0,12,0,0,0,0,601
15,5,10,4,19,373837,58594,207,41046,433
10,4,6,4,6,21260,18156,50,10082,494
13,7,6,7,8,89763,89763,138,31292,438
7,2,5,1,5,17209,17179,25,0,506
11,6,5,7,8,25134,25134,398,12354,426
13,9,4,0,7,36519,0,114,278,523
12,7,5,3,9,110633,34460,116,1424,478
18,9,9,2,12,207936,9507,47,1662,461
29,2,27,3,19,99607,24410,57,11713,550
11,9,2,6,14,69877,20376,57,6321,513
22,9,13,0,11,301435,0,26,12939,477
23,12,11,0,8,31052,0,15,310,642
23,3,20,0,19,12531,0,5,4235,604
13,10,3,4,9,61983,3022,100,2180,492
10,5,5,2,13,256299,8799,28,0,515
8,5,3,2,10,302,69284,22,986,579
10,6,4,5,8,12101,12324,24,8967,475
7,2,5,1,7,22163,14549,5,0,567
17,12,5,5,20,693932,68540,82,13150,498
21,5,16,4,13,274596,30398,31,9974,464
34,4,30,3,19,132635,60709,78,40749,598
7,3,4,3,17,10604,10604,205,9309,495
7,5,2,2,5,35061,206,53,1052,528
11,6,5,5,6,365287,18119,250,5321,475
16,6,10,0,8,1124323,0,0,0,620
16,9,7,0,15,183338,0,9,0,522
8,6,2,0,5,17557,0,2,0,627
9,1,8,3,7,1458,22042,311,19964,571
47,7,40,8,15,873015,241237,154,14787,415
26,11,15,0,11,656416,0,26,980,539
5,3,2,4,5,16109,33847,41,1780,514
14,3,11,1,13,7738,4595,1,4595,613
29,9,20,4,25,410145,63178,26,5261,534
6,2,4,0,6,413,0,2,898,549
7,4,3,4,6,17482,23672,63,5031,486
25,8,17,4,9,946335,26646,92,0,609
9,4,5,2,18,400007,149955,4,137067,565
8,4,4,5,9,9920,11982,43,2480,555
27,16,11,1,9,482305,1659,18,3361,595
11,5,6,3,12,20339,8594,96,40000,477
3,1,2,0,7,41033,0,1,0,622
9,7,2,1,11,115710,6074,13,6074,539
17,8,9,8,11,61534,29645,131,3024,414
35,8,27,4,16,152328,17087,54,1504,450
4,2,2,0,5,30052,0,0,0,608
12,1,11,2,9,5152,8600,33,5152,531
26,9,17,2,9,87274,8113,19,8019,560
68,11,57,4,8,29297,6492,26,4265,439
15,10,5,7,8,115434,35931,226,6639,475
13,2,11,0,11,0,0,8,4302,706
13,2,11,0,6,10456,0,6,3146,576
12,5,7,7,11,43748,52038,132,12369,479
11,8,3,5,11,472927,35512,42,7328,403
12,4,8,4,8,21295,18295,45,9898,391
49,14,35,13,19,876143,288740,161,28317,420
28,10,18,10,11,1609143,760399,187,17667,417
40,5,35,3,7,70574,37810,3,10279,456
3,1,2,0,16,0,0,4,0,590
18,7,11,5,9,57780,19469,135,8105,514
21,7,14,4,16,65253,10178,75,4452,483
10,6,4,7,12,40886,40561,159,10474,485
21,11,10,7,8,68983,26703,74,2316,462
129,21,108,4,14,95930,23281,206,8185,427
5,2,3,1,9,5090,5090,11,5090,660
11,7,4,5,16,428727,444422,34,129428,492
29,6,23,1,20,966260,3929,4,3569,492
6,2,4,2,7,38957,1484,28,118,551
10,3,7,2,3,203263,4222,36,10634,510
6,4,2,2,12,271263,244192,47,4141,571
9,2,7,6,17,164751,357142,172,148300,533
5,2,3,1,13,198,198,24,198,635
14,11,3,1,10,295013,5920,26,5920,624
16,3,13,1,14,7376,7376,40,8671,520
33,16,17,8,11,100098,35249,19,13551,413
14,9,5,7,9,94983,29359,93,6849,439
18,12,6,7,6,431954,169063,47,128422,522
4,2,2,0,11,18884,0,5,189,496
4,2,2,1,3,55210,24995,18,911,555
6,3,3,4,15,131966,131017,54,32876,501
11,3,8,2,7,9236,449,42,3375,491
34,8,26,2,11,718766,10681,344,18932,465
18,6,12,11,6,683025,1666264,133,238110,375
93,8,85,3,17,401469,34166,273,13490,463
7,4,3,2,6,277757,10326,72,6838,469
10,7,3,5,11,54840,54840,103,23826,426
35,12,23,2,16,1292449,7440,38,10428,523
11,5,6,6,10,360361,57557,83,34835,459
9,4,5,4,8,255726,97405,76,41877,497
12,4,8,5,7,33796,37780,23,6633,484
31,9,22,4,9,428548,202563,34,0,586
6,3,3,1,11,16040,822,1,822,606
9,5,4,2,3,20191,1332,22,1169,494
5,3,2,1,4,13911,9995,24,9995,561
370,10,360,3,12,52080,4851,125,4498,470
7,5,2,3,5,302847,37747,36,2260,453
8,3,5,4,5,66330,71486,0,0,449
11,6,5,2,7,28869,27701,10,17683,474
15,10,5,11,10,141144,102677,184,28298,425
15,12,3,11,8,71507,65682,273,12041,374
20,9,11,0,9,534840,0,0,0,471
31,10,21,0,14,278877,0,7,0,582
25,7,18,5,10,364514,4983,42,1530,451
12,8,4,0,8,146414,0,0,0,585
8,6,2,6,4,21976,14415,133,9670,428
85,12,73,13,14,241355,257491,106,5771,437
11,3,8,2,13,75257,74957,36,0,688
4,1,3,3,10,9080,15176,29,9080,496
14,4,10,4,9,51905,79865,4,545,495
21,8,13,2,8,374442,15570,111,1122,539
33,8,25,4,6,183728,2677,22,1777,516
11,2,9,2,7,13421,18378,9,13145,612
34,10,24,7,9,275923,45389,366,10977,426
25,7,18,5,14,40093,35452,61,38855,520
17,9,8,4,16,282663,56532,48,20537,472
4,1,3,1,12,67909,6814,0,0,653
4,2,2,0,14,246690,0,0,0,614
12,6,6,5,14,119229,223741,117,4090,486
24,8,16,3,12,76564,51983,56,5150,509
21,6,15,0,19,351602,0,0,0,649
12,3,9,2,6,22088,2044,41,4488,596
9,6,3,3,5,37468,286,27,221,516
15,7,8,5,23,633807,50496,154,63421,417
47,14,33,6,9,829907,153770,111,1728,442
27,10,17,5,27,727436,266933,92,43779,466
26,8,18,7,16,235035,320388,126,6401,534
21,8,13,3,8,1503853,221527,6,305,592
27,11,16,6,15,1200503,44240,196,15668,474
7,4,3,2,14,438401,3765,39,0,545
10,8,2,2,8,105701,3306,25,2120,517
4,2,2,0,15,5072,0,0,1152,577
22,8,14,1,9,358319,350,17,0,549
8,1,7,1,14,7457,6698,0,6698,623
15,8,7,2,15,553105,15442,31,20847,514
4,2,2,0,1,5793,0,0,0,609
3,1,2,1,1,1284,1284,5,2700,421
22,6,16,0,69,104019,0,5,258,609
28,7,21,6,10,63207,40116,215,18445,432
12,8,4,2,17,360415,25818,8,12909,585
12,6,6,1,11,29751,902,28,1394,491
5,3,2,5,9,318139,522752,116,225841,477
8,6,2,3,14,67484,10756,3,2480,450
30,16,14,2,11,213618,82120,84,73987,504
26,6,20,3,19,614119,9699,112,110762,418
57,17,40,14,69,169477,135761,338,21178,475
8,5,3,5,4,24898,24232,69,4044,462
5,3,2,3,6,42241,41548,24,2711,540
13,7,6,0,3,206204,0,2,1843,546
11,6,5,3,17,2440288,145939,66,1543,419
15,10,5,8,14,124833,90850,18,57846,448
47,7,40,3,9,407288,24360,37,11091,570
15,3,12,1,10,19720,9607,14,9607,580
12,8,4,1,10,351772,2178,19,5121,547
63,8,55,1,3,125545,34181,6,0,451
5,2,3,2,10,8782,1941,25,1501,553
7,2,5,1,8,5504,5504,93,5504,554
10,4,6,6,11,18812,19478,43,10746,480
17,10,7,1,8,234649,149,5,0,579
7,5,2,4,19,170916,190488,78,0,464
20,9,11,7,26,705714,35140,148,5228,438
9,3,6,1,4,4812,512,25,0,514
23,15,8,7,8,545589,572707,70,12453,487
12,8,4,4,19,590225,12883,54,1485,454
354,9,345,5,11,100845,42479,102,8432,444
20,15,5,7,11,483410,57721,16,1269,465
27,15,12,9,23,1564891,1372604,194,525101,410
23,12,11,1,19,192101,2264,17,0,539
25,7,18,4,19,41746,31086,28,12483,430
8,5,3,0,7,174637,0,0,0,712
56,29,27,0,8,9360738,0,14,15166,641
8,2,6,3,5,21572,21075,0,0,514
12,9,3,3,13,390198,46800,50,31107,514
35,11,24,1,16,723743,4525,28,8402,540
20,6,14,3,10,34486,45430,89,2400,447
22,13,9,0,9,3372569,0,8,11314,585
10,2,8,1,13,1482,1000,1,1000,568
74,24,50,0,33,5614216,0,5,0,661
11,7,4,1,18,201349,765,25,0,485
17,1,16,0,11,0,0,47,249,741
23,8,15,0,7,210479,0,11,400,589
12,9,3,5,7,22641,6194,35,2980,429
12,7,5,8,6,20049,20747,204,9097,440
5,1,4,1,17,1010,1009,0,1080,709
12,10,2,5,11,30559,25593,61,16680,419
8,4,4,3,4,12905,3391,34,761,472
29,16,13,6,10,822956,251031,42,7953,450
23,2,21,2,7,12484,1417,162,2415,480
15,9,6,0,9,251544,0,0,0,688
50,14,36,0,4,433688,0,50,390,511
27,6,21,3,12,1439,32561,63,20339,497
11,6,5,2,9,500635,51365,54,22413,474
26,10,16,7,15,356643,84622,202,11181,419
34,13,21,1,7,85655,1342,32,5846,437
23,5,18,4,8,18886,3438,99,2812,491
11,1,10,1,9,6805,6805,7,6805,566
8,4,4,2,9,205107,15074,0,0,466
32,19,13,22,10,400047,317302,94,56239,415
9,3,6,3,15,3699,6762,22,7799,430
29,8,21,1,21,834103,332418,4,332418,477
25,12,13,9,29,1064657,524969,146,14805,426
12,3,9,0,11,266627,0,116,0,621
11,7,4,2,12,579203,1244,6,0,559
3,1,2,2,3,1281,18562,40,0,490
10,5,5,6,8,28057,15718,33,5154,523
21,9,12,2,29,102355,11280,7,1269,458
15,12,3,10,16,396454,77690,353,32490,465
21,4,17,5,7,105684,105684,97,0,573
14,10,4,7,14,522476,133431,67,55613,435
8,3,5,4,7,190096,177922,0,0,485
22,7,15,4,25,97027,22807,123,8929,475
40,14,26,6,12,704313,32072,71,4934,498
18,6,12,4,5,17477,34043,102,1776,449
36,8,28,0,9,174001,0,1,255,641
6,2,4,2,5,13357,13357,60,7427,466
16,12,4,0,15,98287,0,0,0,681
15,8,7,1,3,116696,3269,2,0,527
31,10,21,5,9,223129,197576,103,2488,469
34,15,19,1,13,1403313,7121,27,0,556
16,13,3,0,5,332157,0,0,0,647
8,5,3,4,17,733920,275096,0,1479,466
7,3,4,1,9,368763,15539,0,0,485
9,7,2,5,11,342053,29127,98,9101,453
6,4,2,4,2,10163,31302,15,22604,487
8,6,2,2,6,5475,3060,39,1150,534
9,7,2,2,7,38598,10693,17,3553,466
11,4,7,3,19,730624,282805,67,21416,560
11,4,7,1,14,16640,5480,123,0,523
9,6,3,3,7,28598,11854,36,17308,491
7,2,5,2,5,5508,5440,167,3864,489
16,1,15,0,15,0,0,0,1410,740
13,7,6,2,8,63251,197,85,428,569
9,3,6,2,13,4607,2661,4,2052,443
26,4,22,5,15,49419,19937,96,7154,525
10,6,4,2,9,36172,2058,11,1568,467
14,6,8,3,5,71923,36306,42,1250,520
17,2,15,3,8,9212,9212,53,2712,497
10,6,4,0,4,901762,0,7,10121,482
63,11,52,5,11,40956,35225,45,26396,492
15,6,9,4,17,425778,88288,72,64798,430
14,9,5,0,21,1947129,0,11,777,587
17,5,12,0,13,67738,0,0,1115,580
24,7,17,6,12,61054,33109,173,10974,471
4,2,2,1,6,1813,1813,21,0,465
5,3,2,1,8,9006,3636,2,3636,540
25,14,11,6,14,522435,75241,6,1884,492
7,3,4,1,9,470287,4054,0,0,520
5,1,4,1,11,12113,12113,6,0,638
13,5,8,0,8,29086,0,9,0,522
8,6,2,2,7,84323,29692,38,0,553
13,6,7,1,14,188399,37579,20,37579,621
8,5,3,1,14,51125,18460,46,18460,376
6,2,4,2,8,483,14794,42,322,580
8,4,4,2,16,26322,26322,14,21551,512
19,9,10,8,4,93472,64220,131,5200,465
22,7,15,5,15,45079,14216,63,2032,459
13,9,4,6,12,158863,242652,107,136151,458
14,9,5,3,9,227043,3576,17,378,463
21,6,15,4,12,2573457,50456,47,2664,493
6,4,2,1,4,48597,1410,9,1410,486
33,4,29,2,6,19947,11239,17,10224,501
17,7,10,0,19,318281,0,3,890,562
14,8,6,2,19,496797,27028,64,0,662
21,6,15,3,10,60890,37029,11,17054,497
17,11,6,2,9,2569479,21922,25,0,573
17,8,9,9,15,754271,623361,5,3266,458
12,4,8,2,14,13214,6199,75,40454,560
19,7,12,4,10,13036,6659,77,3021,434
10,6,4,8,4,52021,55978,90,12000,420
6,3,3,1,14,2650,2650,34,2650,539
7,3,4,2,6,14690,2121,16,476,487
14,6,8,2,35,5669,13569,23,2490,569
47,7,40,0,8,200962,0,14,207,686
7,5,2,7,5,23891,38295,121,11430,442
12,5,7,6,15,48267,60905,79,0,537
10,7,3,5,12,352426,92908,22,1112,430
9,4,5,5,10,38547,87168,63,7596,414
7,4,3,2,7,90500,71609,2,512,459
43,9,34,7,12,172927,99073,151,18975,433
9,7,2,1,4,119787,3493,0,0,563
11,5,6,1,6,283012,172,2,2190,496
17,3,14,0,7,22933,0,5,1003,587
3,1,2,0,6,40368,0,1,507,666
6,4,2,2,6,6364,5926,31,5588,537
111,10,101,1,12,299994,59789,22,3138,529
8,2,6,3,7,8651,1831,67,2468,539
12,8,4,5,9,89992,102341,46,25877,477
31,7,24,5,12,339611,69954,45,20388,446
11,4,7,3,6,29984,4814,32,5610,407
5,3,2,0,10,39297,0,1,0,683
9,5,4,3,14,20677,11650,116,9080,517
55,11,44,0,7,661383,0,2,6715,544
18,12,6,9,20,500779,21123,181,7196,417
8,5,3,4,16,401402,18460,66,7905,526
49,9,40,6,17,35368,29832,92,13648,436
6,2,4,1,8,399345,1331,21,0,663
33,11,22,0,13,1055536,0,11,0,675
45,9,36,8,15,297932,159260,207,24570,486
53,17,36,10,10,370766,45931,179,11583,412
10,7,3,6,3,29422,14702,17,4980,473
14,4,10,4,10,16982,16982,39,5070,430
35,11,24,0,69,579682,0,9,735,561
18,11,7,7,39,98162,97649,209,19372,433
23,8,15,5,9,82975,57717,127,19378,414
11,4,7,2,6,12908,9820,50,5520,614
23,8,15,6,9,77687,31100,131,12891,485
6,3,3,0,8,18764,0,11,0,612
18,1,17,2,8,6024,6024,0,0,597
23,2,21,0,6,192232,0,0,0,614
10,4,6,2,9,5577,4825,89,4092,398
4,2,2,2,5,8421,8421,10,2895,497
28,16,12,17,9,205871,169123,402,21849,369
39,9,30,2,13,113146,1390,6,1079,418
22,12,10,0,69,460194,0,17,561,483
8,4,4,1,11,263416,16,2,106,547
6,3,3,3,7,255985,8970,56,3240,451
20,9,11,10,16,30199,33631,108,7453,427
6,1,5,0,17,0,0,10,23389,640
23,13,10,1,15,203277,14676,12,0,528
20,8,12,8,8,209763,67910,110,1484,493
5,2,3,0,5,168683,0,0,0,608
13,2,11,2,19,12113,12113,107,5904,544
15,3,12,2,8,7976,13724,110,4069,641
7,5,2,4,5,35975,20619,3,1556,487
69,10,59,4,13,45519,17884,73,7033,470
5,3,2,1,12,11246,3607,0,0,516
5,3,2,4,14,29282,39271,20,29177,504
9,7,2,5,2,58112,10010,15,3544,367
26,14,12,13,15,974437,498412,340,31261,504
10,7,3,1,29,23894,23002,21,23002,697
23,8,15,3,9,70008,13283,414,3424,424
14,8,6,1,18,260617,2550,5,4707,689
6,3,3,1,8,7815,1313,79,1400,486
28,5,23,6,11,48466,48731,67,28380,506
57,8,49,5,14,55545,14651,88,5473,526
9,7,2,7,6,29600,29600,246,7389,508
5,3,2,0,17,14508,0,0,0,711
57,7,50,1,9,183227,36840,16,0,627
38,9,29,1,7,86919,14731,111,14731,415
13,5,8,1,5,5056,182,8,1464,520
14,5,9,4,20,170102,142261,86,3241,458
15,6,9,6,13,46020,102246,65,10323,436
33,11,22,0,19,157259,0,19,4120,665
31,14,17,7,9,446817,207760,184,3403,403
43,25,18,5,12,444674,19409,111,314,536
38,5,33,5,9,232904,24198,220,6270,507
9,6,3,1,8,18099,12185,24,0,575
12,5,7,11,8,160267,259116,166,0,445
10,5,5,2,21,20136,32967,79,0,561
11,4,7,4,10,150844,41131,51,16129,606
21,10,11,0,8,581236,0,22,0,563
20,10,10,5,8,106708,15897,89,7926,404
25,9,16,8,18,303915,27429,137,5539,481
4,1,3,2,13,2330,32867,33,2330,559
13,8,5,0,13,194702,0,27,0,660
9,4,5,0,5,107970,0,2,0,622
22,7,15,6,9,485918,73993,47,1471,439
30,4,26,4,13,286274,76489,62,13005,460
26,2,24,0,21,0,0,317,13862,587
7,2,5,0,8,13962,0,16,0,479
41,10,31,7,21,486885,37847,87,9338,437
63,26,37,21,10,943313,392729,406,139097,410
4,2,2,2,3,19053,261,6,241,567
65,10,55,2,17,121099,14495,4,11434,445
32,2,30,2,6,10861,10861,193,9620,627
63,7,56,0,13,222062,0,4,14153,640
12,7,5,5,10,520028,25837,91,11136,420
8,2,6,0,18,35616,0,5,6426,531
7,5,2,2,8,10168,158,75,249,537
10,7,3,9,10,250109,445716,58,35984,468
4,1,3,0,3,1246,0,1,697,607
24,6,18,2,30,137981,1391,142,7204,521
4,2,2,3,10,2376,26108,37,23732,567
13,7,6,2,16,587970,10781,8,14171,475
3,1,2,2,6,8775,10952,23,0,451
50,10,40,1,6,54597,1015,58,1128,495
19,17,2,13,12,390761,77341,115,99303,474
28,6,22,0,7,52696,0,4,2105,659
11,7,4,7,14,233128,181548,174,5014,533
16,7,9,8,9,76609,82792,105,9794,491
5,2,3,3,13,22107,29359,40,13801,429
19,9,10,4,18,230709,230369,73,147117,394
18,6,12,3,14,107720,1330,105,1189,507
55,6,49,2,12,153607,42842,46,1508,500
23,6,17,7,12,529121,41747,279,17152,399
14,8,6,1,6,181790,2043,1,0,580
19,8,11,6,12,453340,42716,90,17032,430
14,6,8,1,7,90153,1848,9,1848,624
12,7,5,0,13,542650,0,0,0,616
10,6,4,0,14,179288,0,1,81,563
13,5,8,2,13,57551,14559,43,179,503
20,10,10,8,19,498928,37547,140,11810,387
6,3,3,2,16,31829,31829,53,31317,466
21,9,12,3,8,73299,35668,120,3415,449
10,4,6,2,9,11832,10286,7,3890,489
3,1,2,1,5,730,730,10,979,608
19,9,10,7,9,48226,44038,80,10777,427
6,4,2,4,5,43747,25237,3,911,417
13,6,7,1,15,819632,79110,12,436,540
22,4,18,4,6,25348,21050,143,12958,417
42,11,31,4,15,76796,46315,248,21521,501
6,3,3,1,8,137412,11410,64,14790,556
7,4,3,0,11,21293,0,0,0,510
24,6,18,9,11,100920,348058,9,8306,473
5,2,3,3,42,31052,38225,40,0,494
11,5,6,5,9,115479,45447,65,7897,462
4,2,2,2,7,11297,3003,15,3993,441
24,9,15,4,13,294110,15583,30,2821,471
23,5,18,3,17,60091,38163,62,4980,526
13,1,12,0,7,17972,0,6,0,603
13,8,5,10,10,41882,75544,426,4585,454
58,13,45,11,8,291133,51314,346,12849,383
19,9,10,0,15,123441,0,0,0,667
12,4,8,2,12,14931,11360,38,28418,526
12,8,4,9,13,104111,134807,84,3204790,432
7,1,6,1,8,5105,5105,139,5105,571
6,2,4,2,8,13390,12482,13,11923,414
24,2,22,1,9,5436,831,1,1089,529
39,6,33,3,8,207597,131785,0,0,424
15,4,11,4,13,35108,20508,35,11410,524
38,8,30,6,22,45004,42553,100,1282,492
7,4,3,3,13,84175,31099,56,12931,495
21,4,17,3,16,266726,26612,43,22400,589
18,14,4,0,8,510704,0,6,2889,503
8,4,4,3,16,46402,40486,17,36447,392
24,4,20,2,10,25846,14686,116,24382,556
14,4,10,3,6,45470,507,3,302,601
11,9,2,2,14,98404,1404,26,0,486
17,4,13,3,18,499683,11329,33,10569,459
15,4,11,2,8,704,704,42,1048,466
4,1,3,2,5,9542,21625,33,0,504
6,4,2,3,13,40146,3309,35,561,494
18,7,11,2,9,117949,35369,96,33110,450
11,7,4,6,15,208438,66276,83,23604,455
31,4,27,3,12,14740,13660,76,11614,466
14,6,8,3,9,423927,12778,66,0,455
15,8,7,6,7,43280,43018,141,17869,407
19,12,7,4,8,1267352,62922,35,52257,512
14,7,7,6,12,27733,10565,14,2523,536
3,0,3,0,3,0,0,1,2556,617
13,11,2,0,17,453534,0,0,0,704
74,8,66,3,7,79238,20177,121,12098,510
9,4,5,0,13,26473,0,3,14121,668
11,3,8,2,11,28070,14570,99,12022,537
7,2,5,1,10,43857,43857,24,43857,501
6,3,3,1,19,13398,6898,96,6898,591
5,3,2,1,9,280872,2270,30,2270,549
4,1,3,0,14,8146,0,2,787,672
13,7,6,6,16,67415,62916,119,11548,453
55,13,42,0,15,325137,0,107,1829,668
31,8,23,6,33,55024,20376,131,7357,453
26,18,8,10,12,716689,105590,94,28709,439
15,7,8,6,13,17715,20531,41,5455,431
9,5,4,5,11,82426,28509,63,14341,462
16,11,5,0,8,112343,0,1,715,531
11,3,8,2,5,11399,3147,9,1699,545
10,4,6,3,14,48805,2668,11,5530,469
43,8,35,4,18,62326,20808,42,5460,444
8,4,4,4,12,44727,20054,61,4803,417
12,6,6,1,9,51874,3695,8,246,516
6,3,3,3,10,9643,8765,43,0,462
23,10,13,7,18,364181,34861,156,19446,421
27,3,24,1,8,10810,545,270,5490,449
3,1,2,0,2,7654,0,1,0,505
16,6,10,9,17,54330,74407,128,12146,440
28,2,26,2,8,35479,7831,38,739,621
11,2,9,3,8,17059,13982,43,6770,637
12,9,3,6,12,92889,51805,97,7142,407
8,3,5,1,3,18699,8806,19,8806,455
12,8,4,1,12,390382,11868,191,5616,397
22,5,17,2,24,29720,1767,42,1983,452
18,11,7,9,15,181343,80300,95,51368,424
23,3,20,0,14,0,0,0,0,734
124,11,113,1,16,457473,10403,36,10403,443
11,6,5,6,9,64828,60747,89,0,486
8,4,4,1,9,295326,3325,5,1640,595
12,8,4,5,8,80016,9467,256,1365,462
11,3,8,2,9,16851,16225,83,1956,506
10,3,7,5,11,124390,164020,64,48191,465
9,3,6,3,8,2467,2467,5,1780,437
14,9,5,6,21,747322,302999,52,35196,556
6,4,2,2,9,5589,5049,51,27820,425
12,4,8,4,9,7858,7858,61,4376,503
10,7,3,2,8,412836,42498,16,1595,449
4,1,3,1,12,5584,1564,0,767,509
9,6,3,2,10,78644,13262,24,3855,419
4,2,2,2,12,1699,8137,119,3249,474
71,15,56,5,18,369618,54697,73,15270,398
13,5,8,3,9,31363,5755,53,4206,436
6,3,3,1,10,74973,31882,25,0,597
7,2,5,3,3,32378,55994,24,35318,518
13,9,4,7,4,183578,42380,67,13884,412
13,7,6,4,15,66180,32771,9,16485,423
5,2,3,1,7,4136,4134,25,4134,466
15,9,6,7,8,31767,28323,51,8416,421
13,6,7,1,29,519272,82093,24,2155,530
15,5,10,3,12,104361,81181,27,0,677
12,7,5,7,8,35253,34351,81,12234,442
7,5,2,2,3,51683,4091,31,3813,474
50,5,45,3,15,1051369,39832,0,0,489
16,5,11,3,30,118264,118264,16,71726,512
13,8,5,4,12,252805,17599,214,7956,401
7,3,4,0,23,294297,0,5,6086,508
12,6,6,1,13,176490,4597,0,0,510
14,8,6,1,8,26005,8333,110,16666,547
16,10,6,4,11,330557,49569,65,18134,455
11,9,2,0,18,218576,0,0,0,674
6,4,2,0,7,3402,0,0,0,519
17,5,12,4,8,38979,62081,67,753,513
12,9,3,7,10,48885,48186,140,14381,444
6,2,4,1,8,8652,9159,46,0,513
9,5,4,4,8,30639,8205,80,549,517
28,21,7,20,9,309633,2616,0,0,501
10,6,4,4,20,317779,24365,0,0,513
11,1,10,1,10,1777,11725,18,0,629
10,6,4,4,6,91150,15248,59,2382,433
23,4,19,4,20,43717,41910,55,33442,511
27,1,26,1,9,6969,2907,14,2907,541
6,3,3,2,9,24449,14968,145,12886,529
35,13,22,13,9,1438743,539899,293,152155,486
2,0,2,0,9,0,0,0,0,656
40,13,27,9,24,268483,667260,160,0,499
20,10,10,3,11,97353,11405,0,0,510
45,11,34,0,19,360996,0,36,1957,470
11,8,3,3,9,67309,27606,47,10997,467
32,16,16,0,13,256137,0,11,0,696
42,12,30,3,18,20129,3977,264,2716,587
22,12,10,2,9,95580,606,35,3961,514
18,14,4,2,21,772281,35517,38,0,447
11,4,7,4,9,35756,20635,126,16597,416
11,8,3,5,25,5870031,5861395,77,9039,488
7,3,4,3,11,9414,9414,49,4762,559
9,7,2,0,2,23528,0,0,0,594
10,5,5,7,14,143225,103400,113,29501,454
21,9,12,10,18,321249,371310,162,167776,448
20,7,13,7,9,29636,27809,108,13589,436
6,2,4,0,4,13992,0,2,2953,625
10,5,5,0,8,22582,0,1,448,605
10,3,7,4,7,2872,14717,50,12224,478
45,6,39,0,18,0,0,1,604,652
8,3,5,1,8,55816,2853,40,0,547
47,16,31,13,10,109028,88775,181,19880,410
22,4,18,3,8,16557,10566,41,2599,419
14,7,7,4,28,577018,80507,90,160,689
10,6,4,1,12,1411856,3667,21,0,583
32,14,18,7,9,159273,57464,159,26372,457
15,12,3,11,5,80302,75019,56,12820,391
8,3,5,0,7,6510,0,0,0,649
17,10,7,0,9,1966219,0,3,1033,512
18,3,15,1,17,4290,4290,3,4290,711
9,6,3,1,9,24386,597,6,477,468
27,11,16,10,13,136298,156142,438,21133,529
7,2,5,2,6,9857,9857,0,0,516
34,18,16,0,69,775776,0,151,2377,551
30,16,14,2,13,997402,1201,8,728,519
11,6,5,4,14,39689,25726,35,9855,471
9,3,6,3,12,47063,36877,25,146,424
4,2,2,1,8,3065,2850,0,0,628
8,1,7,1,9,1848,1848,2,1848,498
30,12,18,14,10,413809,417453,161,24518,417
17,6,11,3,11,41258,35604,66,11887,432
36,11,25,5,16,306281,68528,65,9101,431
36,7,29,4,8,469199,152029,202,28200,491
8,4,4,1,8,104275,38421,48,38421,490
10,8,2,6,11,77132,71458,63,11917,424
33,9,24,4,13,185433,27808,76,14643,471
13,9,4,3,11,198396,3665,17,1651,449
25,14,11,8,9,1030767,180545,61,43835,528
10,3,7,3,8,6148,17209,57,2774,502
6,1,5,3,7,5673,28500,0,0,607
13,3,10,2,25,2994,7075,64,3703,556
13,4,9,6,7,21490,51293,163,17052,494
5,1,4,1,8,15265,15265,0,0,485
11,9,2,6,6,73739,9020,16,10691,437
11,4,7,0,9,32351,0,7,263,655
6,2,4,4,7,14181,55302,14,10000,453
11,7,4,4,10,21308,21308,107,6991,458
17,6,11,4,21,281906,243140,74,3295,476
41,7,34,3,15,1229084,85406,27,10756,555
27,4,23,3,10,99606,19145,45,15065,457
9,7,2,3,10,443849,13199,47,0,469
9,5,4,1,7,36021,2840,53,4646,517
33,4,29,5,17,47584,322651,0,1060,543
27,13,14,7,18,332660,25805,162,22844,421
20,6,14,5,19,36205,17679,40,9354,496
12,3,9,3,11,26375,12206,59,313,580
15,6,9,2,3,112644,2436,18,2297,515
8,3,5,2,13,13910,12480,8,31600,534
8,5,3,0,14,154585,0,0,0,730
22,7,15,7,14,50415,38984,74,27380,460
28,15,13,2,7,1365214,644,29,575,469
17,10,7,5,13,97851,129883,103,0,575
11,3,8,6,8,9473,58302,72,23762,416
20,14,6,0,10,252671,0,6,246,601
43,2,41,0,8,5822,0,72,7760,641
9,3,6,6,8,55664,87296,116,27141,454
27,9,18,0,11,988670,0,38,0,564
3,1,2,2,8,5707,5707,30,4054,493
21,10,11,2,69,353414,4566,5,3602,399
35,9,26,0,9,120252,0,37,719,580
26,1,25,0,15,0,0,25,2442,588
12,6,6,7,18,135509,178053,46,85655,465
29,8,21,3,13,597423,198404,265,25926,492
14,6,8,1,7,515748,760,3,0,614
8,4,4,2,8,59220,8025,45,1679,536
30,5,25,1,8,41797,9412,23,7105,436
23,8,15,4,5,43599,11889,65,7882,481
9,4,5,3,8,32772,21834,207,19572,443
5,2,3,0,4,2530,0,0,0,621
26,15,11,11,9,354977,27756,125,8150,461
10,2,8,4,10,8270,10011,35,5315,538
26,7,19,0,33,82524,0,1,2299,650
19,9,10,1,17,440580,6849,16,6849,590
32,10,22,5,20,364806,180502,60,17481,480
28,8,20,2,6,155883,1922,26,1624,476
13,5,8,0,15,0,0,104,7068,524
19,8,11,2,18,359277,1400,64,6108,468
4,2,2,1,7,16735,4150,24,4500,532
62,9,53,5,8,50951,28813,186,11830,422
9,2,7,4,13,27210,53894,78,0,501
13,6,7,6,9,77659,77659,25,42766,393
29,15,14,9,10,155430,71063,0,0,442
19,9,10,8,12,29938,24001,107,11019,471
6,3,3,1,8,14297,5050,14,5050,617
8,5,3,4,16,403521,14985,63,1539,459
219,10,209,8,15,95677,95676,255,38031,387
10,5,5,0,6,16736,0,4,559,586
26,9,17,1,11,36676,1596,24,1596,485
8,2,6,2,4,366683,7075,37,0,517
14,5,9,4,8,60790,40013,59,2741,447
21,12,9,6,16,22969,9404,65,3120,391
37,22,15,4,26,1807737,97855,30,6,480
8,5,3,0,8,28477,0,0,0,682
18,8,10,5,34,194956,35582,267,31511,418
5,3,2,4,9,78326,37250,7,7319,439
12,4,8,5,13,665564,162644,66,87905,452
19,9,10,0,3,61226,0,1,153,550
23,6,17,1,11,153643,2660,22,2660,492
10,1,9,1,17,2249,2249,11,8586,448
20,7,13,4,5,92124,65746,0,0,453
13,7,6,2,18,294768,160695,34,1000,538
30,12,18,1,23,568675,21705,13,21705,513
20,10,10,2,8,85551,1621,5,2556,545
28,11,17,4,12,760592,59303,95,29355,495
16,13,3,12,11,120494,116560,237,26997,407
27,12,15,1,14,235633,17084,37,17084,451
23,4,19,1,20,385517,572,23,3675,495
23,8,15,12,8,367208,574720,142,118755,455
13,4,9,0,15,193312,0,4,15299,640
5,3,2,1,9,8643,3069,12,1808,474
12,7,5,4,8,34913,3272,106,1030,381
20,7,13,8,6,37378,29342,150,5950,460
7,5,2,0,13,147165,0,7,619,599
52,24,28,1,23,12825137,1822,32,3750,608
19,8,11,3,4,24168,3344,101,2298,499
8,6,2,0,4,83735,0,8,0,505
9,5,4,1,9,36464,15230,36,0,522
7,2,5,1,10,12614,2943,26,8744,496
2,0,2,0,8,0,0,0,1824,667
6,1,5,0,14,0,0,0,0,683
7,0,7,2,8,0,25268,51,260,598
11,5,6,2,4,257365,20747,87,870,486
28,8,20,10,13,955556,889175,453,22304,498
12,7,5,1,18,17590,18780,23,32840,601
9,4,5,0,69,2,0,32,3083,652
22,7,15,3,4,129325,35071,52,17700,409
11,7,4,0,16,369662,0,3,364,611
25,6,19,1,4,118693,24079,1,24079,542
7,3,4,3,10,49454,29349,0,0,519
13,8,5,2,21,91376,90400,47,82524,518
51,12,39,10,8,102711,64101,403,48671,475
4,1,3,1,14,7115,7115,25,0,494
22,10,12,6,26,111050,88900,378,27767,538
8,6,2,4,12,20534,36374,138,24781,404
18,5,13,3,10,37704,27376,128,14088,453
11,8,3,3,21,253105,2138,18,927,439
15,10,5,7,16,358857,62750,114,86044,415
3,0,3,1,6,0,1774,16,0,616
10,7,3,6,8,460980,180293,117,0,540
12,1,11,2,13,0,36301,49,0,542
10,3,7,4,11,131938,114054,117,1377,474
3,1,2,2,8,6196,15427,0,0,490
8,6,2,6,6,26876,31062,85,12378,559
15,8,7,0,11,373464,0,1,8547,679
6,2,4,3,7,8308,12507,39,7530,471
9,2,7,0,69,0,0,1,3811,643
20,8,12,6,14,187371,84757,30,2261,469
48,11,37,8,19,1059122,482239,317,13486,517
37,11,26,7,13,277830,221606,186,7656,447
20,5,15,5,10,37842,30847,123,20210,469
12,4,8,2,10,113242,15398,48,15200,447
7,5,2,0,10,17842,0,0,0,550
4,2,2,2,4,22325,3722,3,3361,392
15,6,9,3,16,14883,12322,62,7370,540
13,6,7,0,6,60815,0,1,0,596
13,5,8,1,31,59698,1068,5,3523,430
16,6,10,4,16,244558,169233,63,2200,453
12,4,8,1,11,196432,55706,0,0,476
7,4,3,2,4,22770,10673,24,4421,499
31,15,16,15,11,1270140,1105032,0,0,501
26,17,9,6,27,1052016,98776,126,5689,434
78,9,69,4,18,366481,37115,62,930,480
6,1,5,1,16,1483,1483,24,5500,620
10,5,5,2,9,235782,18652,190,17658,543
6,3,3,2,14,29001,26234,51,1200,502
11,6,5,1,8,201893,14966,0,0,623
14,5,9,7,14,61124,71731,104,28095,470
44,17,27,12,12,198141,118395,193,23080,426
5,3,2,1,14,23129,6289,95,12578,522
8,5,3,3,15,569152,52576,45,3146,477
11,2,9,2,11,3850,1580,14,1551,472
11,3,8,0,8,43751,0,1,6520,612
18,3,15,2,17,16199,16199,32,5763,454
11,8,3,8,4,27711,23516,43,7757,481
18,3,15,2,12,197905,156983,86,2083,463
18,2,16,2,7,1146,915,11,477,535
22,11,11,4,9,249642,25101,57,1012,503
20,16,4,9,9,66010,21921,42,6209,407
19,7,12,2,11,449772,10051,30,7396,649
39,14,25,8,11,75702,50688,100,11785,419
35,7,28,6,10,50816,27252,325,12638,501
7,4,3,0,2,16164,0,6,0,558
10,5,5,2,6,30047,6794,67,3874,475
10,5,5,5,7,12865,12763,205,5755,437
6,4,2,3,7,29052,29052,29,2324,550
6,3,3,2,4,18388,18388,29,15838,509
18,1,17,2,11,32597,9409,23,1899,609
17,6,11,3,12,114145,63763,81,32439,513
10,8,2,3,13,370842,34031,29,29888,507
9,6,3,3,11,294262,21431,122,9744,486
22,3,19,3,8,64528,54926,28,9293,468
6,4,2,4,7,6849,6849,97,2507,596
7,3,4,0,11,235763,0,9,0,587
11,5,6,2,23,26670,24456,50,440,533
7,4,3,2,6,31199,11223,68,10507,563
11,7,4,5,12,194244,44075,77,11648,492
22,14,8,0,69,1258982,0,8,4465,578
46,17,29,14,17,236037,57789,141,51767,482
14,12,2,7,5,160825,14625,79,4502,407
6,4,2,0,4,306083,0,0,0,627
5,3,2,3,6,34905,34905,14,9523,486
17,8,9,7,8,252646,147272,113,43514,425
18,8,10,1,19,10282,1584,40,0,557
9,7,2,6,4,48728,43459,282,9510,531
14,6,8,4,13,311636,28288,89,16340,458
20,2,18,3,12,23294,23294,42,12224,457
33,5,28,1,11,37210,1982,26,1982,465
10,5,5,4,9,16108,5916,69,2174,455
9,4,5,6,9,23460,31510,43,15748,505
19,6,13,1,14,43418,12795,97,12795,617
54,19,35,0,27,1458675,0,20,5699,610
29,8,21,4,12,259248,41690,187,41021,448
16,8,8,6,14,192935,143288,103,18947,550
18,8,10,2,13,325590,11452,16,8528,500
12,4,8,4,10,22596,44350,57,4662,474
12,8,4,0,9,97116,0,1,0,637
12,7,5,5,14,224346,195169,62,97258,454
48,9,39,6,11,66623,25373,88,7580,451
28,5,23,1,13,46358,2524,0,1950,459
28,9,19,11,10,62127,76338,250,22970,370
27,7,20,1,4,362428,57332,32,57332,554
7,4,3,3,15,450143,38962,56,29389,472
23,10,13,5,16,310532,66273,131,26743,456
9,5,4,2,12,4835,4835,14,4718,444
21,15,6,6,8,383307,30993,166,13029,462
132,16,116,0,16,933681,0,12,20026,597
15,3,12,1,9,228623,5174,7,620,477
46,4,42,2,14,25680,23373,29,18233,489
4,1,3,2,8,15848,25340,44,0,623
12,9,3,4,17,136151,19569,113,10165,454
31,16,15,11,12,242416,164183,188,11169,397
17,10,7,4,28,917466,319443,79,0,531
10,3,7,0,11,571352,0,8,0,581
13,10,3,0,9,583541,0,10,0,589
11,4,7,3,9,17501,98456,64,1684,602
3,1,2,2,7,6956,15900,0,0,540
36,10,26,8,11,50252,41423,335,10234,438
7,3,4,2,7,189991,141429,64,143190,518
50,9,41,3,9,71274,4128,58,2722,585
16,10,6,4,7,94186,15824,92,13837,451
16,7,9,1,18,230369,2516,6,2382,564
6,4,2,3,11,270311,149458,65,146964,490
17,4,13,1,3,20984,603,0,0,450
18,4,14,1,13,69922,8200,0,0,623
17,3,14,4,13,579782,62129,0,3722,414
12,3,9,1,8,4018,3158,39,0,593
3,0,3,0,7,0,0,20,176,555
9,3,6,2,13,270957,20769,38,347,504
24,10,14,7,12,160102,160916,164,18594,391
8,5,3,0,12,532537,0,17,0,574
12,4,8,1,16,300317,7293,25,12392,539
25,8,17,3,12,247226,1210,101,1110,486
26,6,20,4,7,62460,3212,18,3993,537
8,5,3,2,10,677065,233,5,218,521
15,12,3,10,16,374384,301091,99,101981,429
14,7,7,7,14,252387,192232,0,0,451
14,7,7,3,18,203572,116068,48,0,486
25,15,10,0,9,2079834,0,2,0,669
5,2,3,3,6,16510,16391,46,0,541
14,10,4,2,19,1294066,116203,24,111578,480
33,16,17,5,22,1356021,30348,70,3751,452
40,8,32,5,17,183161,96012,120,31003,434
24,6,18,5,17,271964,45607,46,6198,433
10,6,4,5,9,79715,25321,24,3069,572
11,2,9,3,12,26453,26453,25,7564,546
15,9,6,7,5,331819,174638,102,0,437
12,7,5,1,16,94849,11637,0,1291,440
11,4,7,0,8,55269,0,34,0,589
5,3,2,2,7,49414,22297,21,0,540
14,3,11,1,11,6434,3330,21,0,591
10,1,9,0,5,79908,0,0,0,650
20,6,14,3,17,506917,11514,20,1944,433
16,2,14,3,8,5409,5409,60,5800,486
7,4,3,0,5,169645,0,0,0,672
19,4,15,5,11,9405,50532,74,1786,486
43,13,30,0,19,2210307,0,0,0,697
10,5,5,1,7,27854,1065,10,1758,445
6,2,4,1,9,590165,451,22,451,510
5,2,3,0,10,745,0,0,0,677
8,3,5,3,9,13810,11545,2,1734,515
15,6,9,6,11,27751,22557,56,4059,460
3,1,2,1,7,7992,7992,33,7992,556
8,4,4,3,10,13866,13102,59,6371,466
6,3,3,4,14,950241,99784,42,2660,505
31,11,20,3,14,846722,84593,30,9477,421
5,3,2,3,12,33316,33316,65,15775,486
8,2,6,2,10,27119,38607,57,25794,582
27,9,18,5,15,573549,165202,52,29477,427
24,7,17,5,9,60216,30686,117,13540,474
38,21,17,6,15,1208743,11071,42,8818,490
19,6,13,1,8,143707,3507,0,0,571
47,11,36,3,17,824595,15761,53,11250,453
8,3,5,2,16,94092,72861,31,37727,475
19,12,7,10,23,1100273,968579,213,192355,446
18,6,12,4,12,58613,37664,65,2187,460
9,1,8,2,8,5449,7976,0,0,499
38,7,31,8,16,57985,76985,105,21882,458
12,9,3,7,9,74113,74113,316,36636,439
11,5,6,3,15,29113,24775,109,8972,480
14,6,8,4,11,22047,11314,31,6300,399
11,8,3,2,15,982710,6909,22,0,580
11,2,9,0,14,5019,0,0,6351,609
31,5,26,2,8,94486,19813,189,27223,509
11,5,6,4,10,247521,149513,0,0,507
15,7,8,3,9,127727,4887,34,0,505
26,12,14,0,7,533687,0,3,386,588
8,4,4,1,8,1881,664,7,2150,544
14,3,11,5,8,83077,114682,105,3288,509
8,5,3,2,15,98606,86050,17,56050,568
24,10,14,3,6,156112,3928,8,3718,503
31,4,27,4,8,64672,63105,74,672,437
7,2,5,1,6,19538,9708,32,7696,502
19,8,11,10,9,162768,214975,164,48719,433
10,3,7,1,7,330710,37625,19,0,548
3,0,3,0,10,0,0,6,0,606
15,4,11,3,19,245115,43121,28,14282,449
12,5,7,0,28,18387,0,0,0,689
10,6,4,6,7,395379,352569,64,0,429
9,7,2,0,14,309997,0,2,1387,429
27,15,12,16,9,238078,237275,338,43455,333
15,5,10,1,8,14770,5755,1,3600,479
6,4,2,5,7,20209,30980,112,693,539
8,2,6,0,3,27349,0,0,2114,667
9,6,3,3,11,1482,906,19,573,462
11,4,7,0,12,320833,0,10,0,719
23,9,14,0,3,468995,0,0,0,641
40,17,23,4,17,334456,143321,118,448,507
18,3,15,1,8,68937,200,29,0,551
25,9,16,8,7,45997,36901,108,20383,421
16,9,7,0,15,164151,0,0,0,688
13,4,9,0,9,202531,0,6,1577,620
4,0,4,0,9,0,0,0,0,603
34,15,19,1,12,507429,552,55,3668,521
31,8,23,9,16,35246,37192,325,12136,405
7,5,2,4,4,70670,23985,31,0,500
42,17,25,3,46,1281350,3813,119,7081,380
41,11,30,0,25,1537637,0,61,743,536
11,8,3,0,8,86989,0,0,0,648
5,3,2,3,15,3737,3663,23,1530,476
5,2,3,2,3,8147,7249,21,0,402
13,8,5,4,15,243537,233886,96,0,501
12,1,11,0,11,0,0,0,0,673
12,6,6,3,11,51002,29228,44,1649,473
6,4,2,4,10,22671,8101,97,5708,454
11,5,6,1,13,205689,8393,32,8393,445
19,8,11,0,6,319128,0,49,1474,658
14,7,7,1,22,373069,1190,4,1764,493
10,3,7,3,11,5418,16265,3,582,599
20,8,12,1,8,165993,249,39,0,506
14,8,6,5,8,9010,17572,57,992,523
29,15,14,7,17,1010858,217482,76,1657,471
41,6,35,2,14,29368,3326,14,9982,512
22,8,14,4,17,631361,1223939,127,542620,522
11,6,5,7,15,48409,54743,133,13480,439
32,10,22,5,18,363806,15178,86,3105,466
17,4,13,3,9,21935,22283,52,1386,477
20,14,6,0,11,101694,0,5,0,544
62,7,55,6,13,112412,25848,168,16759,489
26,11,15,0,16,229167,0,49,0,632
6,3,3,0,8,600,0,38,0,568
5,3,2,0,7,2770,0,0,0,637
16,11,5,4,11,845277,8524,9,0,469
13,3,10,0,19,114831,0,0,786,566
565,1,564,0,5,10472,0,0,3243,689
32,14,18,15,15,810557,847103,16,332014,489
2,0,2,0,3,0,0,0,0,623
10,8,2,7,4,18432,18432,279,7184,410
40,10,30,5,13,100997,3285,55,2078,440
10,5,5,0,15,98519,0,0,0,681
72,12,60,11,17,201707,41538,200,15108,447
16,10,6,0,18,144824,0,0,0,511
19,8,11,0,14,147732,0,31,6461,527
5,3,2,3,8,9266,9266,53,7506,556
15,7,8,4,12,58921,41688,158,20423,467
13,9,4,8,10,98788,57878,75,21818,432
56,13,43,5,10,90513,24955,105,7763,413
20,5,15,0,14,331208,0,0,0,648
12,6,6,1,15,513159,6823,36,0,520
13,5,8,6,8,17563,27913,173,9227,507
9,7,2,5,10,107949,75424,91,0,450
7,5,2,2,19,197,197,12,496,543
36,9,27,4,9,224469,182918,94,108659,430
25,9,16,1,9,315849,561,118,1194,465
11,8,3,6,10,54949,54949,34,45695,415
17,4,13,4,9,19724,67862,70,8016,485
7,2,5,0,10,11777,0,6,5174,598
18,4,14,5,7,26100,30547,79,4762,438
15,8,7,0,13,622868,0,6,18890,566
23,3,20,0,6,39807,0,1,5000,598
19,9,10,1,13,113823,7890,41,0,474
26,9,17,13,7,690766,297732,373,120227,442
21,9,12,8,6,474992,98569,126,10880,433
21,5,16,7,8,41412,47070,302,21235,455
7,4,3,3,5,10040,10040,53,9084,425
13,5,8,0,9,31017,0,15,0,598
8,1,7,0,11,0,0,101,13720,495
10,7,3,7,7,906648,136598,95,0,484
13,2,11,2,15,78501,63814,55,0,522
8,4,4,0,9,66379,0,0,3422,649
5,2,3,1,12,32257,32257,24,32257,664
21,11,10,4,13,303998,57387,86,1835,544
10,6,4,3,11,672293,7233,35,1972,501
9,5,4,4,15,307948,47852,64,12329,468
25,7,18,5,14,398067,48262,98,4643,460
20,15,5,9,23,488787,206343,48,128062,501
17,12,5,5,11,278850,35178,54,7261,402
15,7,8,2,9,59255,10073,26,0,486
28,4,24,3,6,561345,58969,22,20383,508
16,9,7,5,12,60645,45235,79,9811,454
7,2,5,0,6,40498,0,2,0,714
9,5,4,4,8,57878,51424,33,11886,474
19,14,5,10,13,526597,480968,21,41548,429
18,5,13,3,9,44867,12969,240,2924,506
10,4,6,0,2,13235,0,5,9952,579
8,6,2,5,13,216665,83217,46,34399,432
18,7,11,4,19,32960,23083,63,1322,465
14,6,8,0,8,207520,0,6,61,608
17,10,7,1,7,162275,1666,11,0,497
5,3,2,0,7,31795,0,8,0,696
17,12,5,4,12,103508,1160,59,433,530
8,1,7,2,13,354,304661,3,675,490
8,3,5,2,10,46223,3264,12,4429,455
13,9,4,11,39,177484,271377,0,0,510
6,1,5,1,14,40,34296,23,745,588
11,1,10,5,11,1,87181,67,0,644
16,5,11,5,19,57651,78957,98,8726,491
18,6,12,5,13,80985,15458,35,2600,405
17,10,7,0,10,202701,0,14,420,518
11,7,4,1,6,74993,9761,32,1150,496
8,3,5,1,10,127434,10170,11,10170,612
17,14,3,10,15,528767,307481,207,43326,459
8,6,2,3,7,55206,896,13,516,527
3,1,2,1,14,757,158,0,0,736
17,11,6,2,7,270426,5541,9,0,597
23,8,15,0,13,470827,0,0,615,589
19,6,13,6,14,435482,39694,117,8541,633
10,4,6,2,20,344748,330040,2,167681,582
8,6,2,5,25,8730,5892,101,971,426
28,4,24,0,9,73652,0,1,726,647
11,4,7,0,4,21443,0,19,1322,644
12,2,10,2,8,46635,48796,0,0,469
8,6,2,3,11,173335,13007,26,6842,474
23,10,13,2,25,240150,77543,31,5315,573
34,4,30,1,9,525832,117657,14,117657,602
9,7,2,6,15,111866,51423,96,26957,441
6,3,3,4,8,10089,10089,39,4334,501
53,15,38,0,8,102785,0,11,825,542
8,6,2,5,9,19820,14242,139,8965,469
5,2,3,2,10,5668,8682,0,0,542
26,3,23,2,9,14811,12811,46,7091,511
17,2,15,1,11,1561,1561,22,218,556
12,8,4,5,6,98072,28199,96,2781,550
15,10,5,5,6,323245,35934,69,561,437
25,12,13,9,10,115820,61856,124,22156,423
21,8,13,0,21,10957,0,28,0,519
15,9,6,6,14,199956,180577,131,88773,397
9,2,7,0,7,9878,0,3,959,615
33,10,23,3,15,231491,17627,92,11821,499
22,10,12,1,14,239242,1299,17,5526,566
20,5,15,0,19,409916,0,3,0,614
20,15,5,1,25,1391764,17996,31,17996,520
20,11,9,6,18,426453,75152,34,0,453
12,4,8,3,10,422458,11427,10,9000,479
18,5,13,5,15,34258,10487,380,897,512
30,9,21,6,12,54584,35996,78,15696,430
20,14,6,4,14,708142,13518,11,0,457
23,0,23,2,6,31866,26432,10,6958,598
5,1,4,2,12,12622,12622,0,9608,614
10,3,7,3,7,12197,12197,196,12892,533
12,1,11,2,9,10168,25325,42,17282,588
9,6,3,1,8,210856,3346,9,573,451
7,3,4,2,11,16240,16240,105,8419,578
5,2,3,0,13,14048,0,1,257,640
13,3,10,0,9,123923,0,0,1501,627
23,10,13,6,18,431448,53733,77,6073,505
12,6,6,4,10,738194,180877,149,12750,420
40,8,32,0,8,198519,0,0,0,569
26,5,21,5,15,58887,460202,47,3054,472
22,4,18,5,19,33205,35158,0,0,501
7,3,4,0,13,18547,0,0,0,596
9,2,7,3,9,264371,23784,73,0,625
14,5,9,5,14,27875,41915,78,13111,461
22,9,13,0,9,147077,0,2,0,630
11,4,7,2,15,31472,7369,31,1440,475
10,5,5,5,15,17447,23181,38,11385,454
43,19,24,18,6,107620,106138,299,15177,462
13,7,6,0,14,52600,0,39,6176,400
8,6,2,0,6,68336,0,0,0,671
14,6,8,3,12,579695,8980,48,4726,560
21,12,9,5,8,280407,20794,75,2306,475
10,6,4,2,8,54522,8870,46,19481,405
16,9,7,5,8,114815,7214,41,422,469
11,8,3,3,18,40633,10717,43,8552,503
7,4,3,0,2,16164,0,6,0,592
8,2,6,3,11,1824,12901,17,11077,423
16,2,14,0,10,406725,0,8,0,706
2,0,2,0,2,0,0,0,0,597
20,16,4,5,9,321436,56397,26,13572,472
36,16,20,9,10,276084,170749,157,23753,504
22,6,16,8,7,38518,38518,0,0,535
11,3,8,1,13,22736,11120,23,11120,504
15,7,8,4,14,621393,7276,0,0,475
22,10,12,7,9,190326,93955,152,18308,419
17,10,7,8,9,244945,219560,154,8272,394
29,9,20,6,9,199576,60679,110,10858,495
14,2,12,1,20,266317,11389,97,15376,547
6,4,2,4,5,30938,11585,79,3250,422
36,12,24,6,12,295928,37817,81,15297,477
10,8,2,0,9,423867,0,0,204,599
21,15,6,5,15,101666,43003,131,8652,414
8,2,6,3,7,16087,46270,71,0,504
26,9,17,5,12,428625,16800,54,0,444
18,6,12,1,10,87849,17199,39,2238,488
13,6,7,4,11,60129,51708,66,25148,530
23,9,14,1,16,51930,1007,10,2245,532
14,7,7,2,9,425760,5561,32,1200,545
10,4,6,2,8,57455,79628,50,59363,523
4,2,2,2,14,1376,2227,11,1376,597
17,5,12,4,15,44588,10760,34,4355,432
8,4,4,1,4,139656,12817,0,0,448
8,3,5,3,8,3532,7930,49,448,455
25,15,10,0,14,444044,0,3,177,661
38,5,33,2,15,375045,45824,246,43709,472
8,5,3,6,17,752386,155416,0,0,474
8,1,7,1,13,249079,4777,0,0,546
9,3,6,0,10,166013,0,21,0,546
10,8,2,5,8,423798,84315,31,0,444
10,5,5,4,7,129704,35682,40,624,480
12,3,9,1,9,51772,3214,7,4100,615
11,6,5,4,10,377573,52320,43,12725,464
7,5,2,5,7,21660,21660,96,8786,474
9,2,7,3,6,14682,14682,41,0,511
27,4,23,1,7,15038,10105,18,0,497
7,5,2,5,8,18369,14425,79,6947,492
21,11,10,7,16,132699,146989,239,25197,454
4,0,4,0,14,0,0,6,0,678
9,4,5,4,7,8194,8194,29,2500,471
10,4,6,1,8,26119,8281,1,8281,536
22,6,16,0,14,30593,0,2,2745,489
7,4,3,3,11,23482,18422,68,3608,462
3,1,2,2,8,7413,25672,16,18259,544
9,7,2,2,2,40954,2927,6,1681,531
9,7,2,5,7,33733,19190,62,7647,411
10,4,6,3,6,12981,15016,54,0,513
17,7,10,4,3,45310,10825,19,7242,388
44,7,37,4,10,210442,9392,109,3717,477
9,7,2,0,19,445763,0,29,484,609
14,9,5,8,4,157115,64043,405,23313,429
3,1,2,1,8,7083,7083,14,7083,490
9,4,5,3,7,14200,11298,48,9340,381
7,4,3,0,13,0,0,8,3108,682
52,15,37,3,17,119623,1811,63,3538,456
33,2,31,0,13,12313,0,1,1771,539
8,3,5,1,12,348365,47333,0,1392,632
12,7,5,2,10,288893,6437,49,5031,531
41,10,31,0,10,331852,0,32,7364,524
19,9,10,3,9,663167,55386,5,4536,520
10,7,3,0,10,16322,0,2,0,551
16,6,10,6,8,51706,48778,105,13975,451
9,6,3,5,12,284811,255372,113,0,523
35,4,31,2,9,31866,27263,38,21561,557
14,9,5,8,13,788936,717665,103,10360,409
23,13,10,8,16,516570,494788,224,186412,443
8,6,2,3,12,19226,6400,28,4900,551
27,5,22,2,14,32312,11929,27,9904,503
156,9,147,0,7,334124,0,0,0,650
15,8,7,6,12,410396,57895,13,0,560
9,6,3,7,6,237771,228796,102,0,441
22,2,20,0,17,3455,0,0,220,656
32,18,14,0,12,514742,0,103,85572,597
41,19,22,15,13,115187,54044,206,9430,494
8,6,2,1,2,59004,12236,1,12236,419
5,3,2,4,8,29421,30740,73,7800,487
24,12,12,11,8,99853,112840,62,46708,382
41,21,20,11,14,500653,74447,1,920,446
28,5,23,5,14,27250,24863,38,9904,455
24,13,11,12,15,159125,157394,234,40216,443
20,8,12,5,23,272232,144411,61,70958,461
3,1,2,2,8,47115,47115,0,0,519
8,5,3,1,11,32708,1233,0,0,517
8,5,3,4,27,252594,31525,51,22164,544
34,3,31,4,7,41896,35331,127,19315,488
6,4,2,4,9,16016,16016,103,10551,427
20,13,7,0,13,491471,0,5,3170,621
10,2,8,7,7,21249,99397,1,3073,499
3,1,2,1,17,0,5634,19,0,710
18,7,11,4,15,199912,20312,0,1497,510
7,2,5,3,7,38708,38348,0,0,536
14,9,5,8,14,81619,47408,0,196,451
10,5,5,0,10,152497,0,14,27954,675
9,3,6,3,8,28501,35327,73,0,525
13,11,2,2,8,531616,18469,15,0,514
6,4,2,0,10,97813,0,0,0,564
14,5,9,4,5,44670,22924,67,11042,607
41,2,39,2,14,40373,40373,90,6693,516
10,7,3,3,7,707057,167766,33,0,453
10,2,8,1,10,5928,5928,29,583,462
17,2,15,0,11,280612,0,0,146,697
10,3,7,3,6,12583,7198,23,5337,438
33,11,22,4,16,157905,114492,53,3150,444
10,7,3,4,21,731263,107278,55,10452,503
10,6,4,4,14,78869,62259,80,0,498
87,19,68,1,40,958755,32922,19,32922,456
17,10,7,5,12,431195,29045,34,9145,418
6,3,3,1,8,162728,7262,4,2903,546
17,10,7,6,13,693957,54813,117,16791,475
9,5,4,5,6,6074,6074,16,2390,421
29,4,25,0,18,71941,0,20,352,682
16,4,12,3,18,1115200,28256,43,11463,527
13,9,4,0,10,101724,0,3,0,669
22,12,10,10,11,133665,93311,362,23605,414
11,8,3,2,11,608113,963,51,2286,403
20,12,8,2,5,273181,4998,39,3296,418
10,6,4,6,15,103206,102837,355,75035,453
39,5,34,3,12,73724,18552,37,6175,472
10,7,3,4,14,62735,55495,8,27384,439
9,7,2,4,18,52213,11818,139,5720,435
31,4,27,5,7,68467,60091,101,826,541
25,9,16,4,12,115613,3247,161,1860,501
4,2,2,0,10,0,0,0,644,554
4,2,2,1,7,4067,1284,8,0,537
12,7,5,5,9,105097,97606,111,4337,453
18,8,10,4,11,366755,71311,127,0,576
36,4,32,2,16,234986,12232,40,9927,497
3,1,2,1,13,10713,10713,7,10713,682
11,8,3,6,8,97311,81779,49,0,454
4,1,3,1,8,2304,2304,25,2304,642
8,4,4,4,7,253504,253504,86,140867,464
48,6,42,3,11,19218,12448,24,5098,478
7,2,5,5,7,62704,80070,80,0,526
7,4,3,1,9,11557,11557,10,802,553
15,8,7,2,10,76394,391,50,1916,572
20,9,11,0,20,418512,0,1,0,703
24,8,16,1,14,44144,1325,5,6670,537
8,3,5,0,13,32977,0,11,1210,578
14,9,5,6,10,268442,74151,190,16064,449
16,9,7,7,11,312129,73200,0,0,442
4,2,2,0,8,1770,0,0,0,665
34,5,29,5,16,689503,71967,124,19328,548
25,10,15,6,10,219139,17512,65,5745,451
14,4,10,4,10,32461,32839,93,10527,494
41,7,34,7,13,54133,43966,4,3236,446
7,1,6,1,9,238,238,1,238,525
20,5,15,0,9,241304,0,7,338,652
27,16,11,5,14,449135,452403,10,2030,522
9,5,4,3,11,192360,168632,65,15015,431
5,3,2,1,6,17675,1984,29,1984,635
13,5,8,0,3,58069,0,20,4270,583
6,3,3,0,1,19966,0,2,1080,540
20,12,8,5,12,1262994,8654,51,0,463
13,5,8,5,8,455407,24935,68,397,518
15,8,7,2,7,62122,41692,37,36394,387
7,5,2,1,12,289694,56739,16,56739,515
243,15,228,2,9,42509,3403,13,3103,503
14,7,7,4,7,71746,28722,39,10951,418
29,12,17,1,24,323190,856,10,0,729
76,17,59,11,18,293429,274023,286,238739,425
15,8,7,5,12,81135,50338,32,25346,397
24,9,15,4,15,325283,40604,85,20034,537
9,4,5,5,16,374585,89406,0,0,478
8,5,3,1,6,19733,1009,6,1009,535
40,14,26,10,11,157970,133876,350,37424,449
14,10,4,0,20,220414,0,18,0,510
6,3,3,1,7,5577,2788,1,2788,568
4,2,2,1,8,10839,10839,3,1038,486
14,4,10,2,6,52474,7013,33,979,486
11,6,5,0,13,395197,0,0,0,621
17,7,10,3,13,79763,7425,49,5826,427
15,9,6,8,11,134286,134242,129,15792,415
12,6,6,3,6,40258,7350,134,6590,421
63,14,49,1,14,366841,234,0,1827,546
21,7,14,1,22,500094,217942,6,217942,457
30,12,18,4,14,100136,79641,98,56356,420
7,3,4,2,13,12014,11574,12,1554,474
5,2,3,0,5,296,0,71,562,576
14,8,6,8,18,30577,25666,165,6080,497
15,7,8,6,7,68279,43431,302,16146,473
3,1,2,0,11,0,0,1,937,571
33,14,19,1,26,328415,1932,18,2898,486
13,6,7,0,27,530166,0,1,18175,553
41,5,36,2,13,51785,10734,140,10557,636
11,6,5,3,14,20012,2908,10,520,427
7,5,2,0,5,407742,0,1,0,484
12,5,7,5,6,144412,144412,75,128563,498
6,3,3,0,7,32796,0,1,3265,548
16,3,13,1,7,1155,477,15,986,443
13,8,5,3,15,142411,43132,50,19218,668
7,5,2,6,13,113748,83494,118,8939,428
30,7,23,4,15,45751,38020,199,20622,576
16,0,16,1,7,0,4409,8,1782,644
22,2,20,3,9,19050,27230,78,12751,472
15,5,10,5,7,13715,13155,67,5283,451
11,8,3,6,12,211267,111258,144,0,474
14,6,8,1,9,237612,465,1,0,597
13,7,6,6,12,435777,128393,120,31373,431
13,6,7,0,7,436452,0,1,0,700
7,4,3,4,9,68646,62774,62,855,484
25,9,16,9,19,107248,146400,0,0,479
18,10,8,2,22,170003,3385,7,924,547
17,6,11,2,18,118462,74879,8,8335,497
6,3,3,2,8,6649,6649,33,6160,640
39,32,7,4,13,435262,7861,225,21674,417
23,8,15,1,14,627610,3614,14,3614,536
8,4,4,1,10,41175,28514,46,3587,519
19,12,7,1,23,169862,6349,37,12070,483
4,2,2,0,3,35966,0,0,0,637
22,11,11,10,5,232665,142689,88,0,437
11,6,5,3,12,201235,35477,0,0,497
15,9,6,10,7,30811,40050,117,5263,439
51,14,37,3,28,617298,24387,47,11779,418
9,2,7,2,17,15629,15629,36,10647,578
20,9,11,6,15,371099,62904,69,11315,410
11,6,5,2,14,448528,22595,18,7636,535
13,8,5,8,6,65698,51374,120,8779,440
10,5,5,2,11,3437,2957,38,2525,539
7,5,2,2,4,35879,1225,7,0,542
4,2,2,1,6,359,359,35,1493,657
10,8,2,6,9,2139380,384840,120,1699,437
21,6,15,0,13,58547,0,189,2219,641
8,6,2,2,10,141111,11917,62,9946,490
11,5,6,1,9,155388,20897,89,5690,478
4,2,2,1,12,319056,6072,0,0,546
13,2,11,0,10,183396,0,4,10718,556
19,11,8,2,21,277384,310,11,297,520
10,4,6,4,13,22862,22862,49,1750,524
8,5,3,1,16,147738,21947,18,39208,566
32,9,23,1,13,77059,10631,63,10631,476
14,6,8,7,6,23381,25944,0,0,444
24,6,18,5,17,38515,24159,59,3755,433
8,5,3,5,41,114978,114978,160,29398,444
10,6,4,7,8,53888,49416,273,9271,432
10,6,4,2,10,43913,11286,5,3507,487
8,4,4,3,7,61366,7096,43,866,486
12,6,6,7,9,282387,65505,91,7888,464
23,9,14,3,16,240526,37664,95,1000,446
22,8,14,6,13,70520,21641,62,6905,427
3,1,2,2,5,1537,5438,47,1537,595
24,21,3,10,11,742757,45936,62,23062,442
5,3,2,1,9,375320,2348,22,0,485
9,3,6,2,7,17998,1168,216,1663,625
4,0,4,0,19,0,0,0,405,546
55,23,32,9,5,851086,15084,72,11304,391
23,5,18,4,15,139448,139447,20,65882,471
10,5,5,0,4,44257,0,0,0,557
25,7,18,3,5,40065,8480,31,2551,497
7,5,2,1,24,258451,20994,12,0,501
23,10,13,1,12,907145,15412,0,0,496
29,10,19,5,14,832132,544123,31,517352,426
7,1,6,1,14,138495,34360,7,0,609
15,6,9,1,8,411841,699,13,1929,474
9,1,8,2,12,12931,12931,18,7581,502
32,12,20,0,19,420484,0,60,769,512
7,4,3,4,6,3033,3033,19,1437,411
15,9,6,5,15,34615,48225,4,3355,524
18,2,16,3,12,38529,27089,76,9145,509
6,1,5,1,9,299655,2195,1,2195,628
15,7,8,6,21,375759,54991,235,18099,539
8,5,3,4,19,53000,43468,99,34386,533
10,7,3,3,7,52978,18928,26,9416,506
13,8,5,0,11,372576,0,24,0,612
15,4,11,3,11,1139453,263958,0,0,544
4,2,2,2,12,72533,58380,15,50983,462
6,4,2,1,13,307540,122,0,0,562
8,4,4,1,15,380527,120,14,120,501
20,8,12,8,9,75673,78493,293,12699,416
13,10,3,4,8,85961,52144,208,28091,375
32,5,27,4,14,39625,39624,282,27056,520
23,6,17,5,11,292174,10921,38,3245,447
6,3,3,2,11,533890,524539,30,604,462
8,5,3,0,8,89862,0,7,0,629
9,3,6,3,6,3456,3568,29,1389,443
10,6,4,7,13,390117,57974,136,12640,462
4,2,2,3,6,10392,16641,53,0,508
32,9,23,0,18,83995,0,12,350,565
23,13,10,5,15,162472,15386,92,8542,462
43,6,37,4,8,79592,30358,160,3971,607
8,6,2,1,13,2783,1866,3,1866,545
3,1,2,1,8,8644,8644,1,429,591
8,2,6,0,4,121353,0,0,0,629
21,14,7,15,12,659995,1192061,128,3266,347
13,5,8,9,5,220950,346053,122,106578,416
23,14,9,1,20,8599634,44399,17,0,558
18,5,13,3,31,33313,3878,83,4942,509
12,6,6,1,7,43452,11042,0,0,630
12,10,2,2,4,463988,901,9,725,489
11,2,9,0,10,0,0,7,1658,604
3,1,2,2,8,35154,56197,26,35154,495
27,8,19,1,25,4448643,1636,48,77480,407
4,2,2,0,3,8756,0,0,0,644
10,4,6,1,11,23688,23688,24,0,557
12,5,7,3,15,39189,36483,95,22034,641
40,5,35,1,9,2113077,11768,52,3960,422
16,5,11,3,26,14817,14397,57,6956,554
10,8,2,2,8,44124,1079,27,1385,469
8,6,2,1,4,44039,40,22,40,485
20,5,15,0,14,38098,0,84,2758,580
15,10,5,0,10,422479,0,2,101,574
50,22,28,2,16,434953,20511,42,19953,531
85,6,79,3,10,358564,42531,49,19373,532
13,1,12,0,13,62632,0,53,3368,638
16,2,14,1,8,113848,27943,31,806,495
31,15,16,0,16,324125,0,21,1276,564
8,2,6,1,2,364660,26406,7,3009,466
32,3,29,4,19,519128,28551,47,586,506
6,3,3,0,6,6678,0,25,0,564
35,9,26,5,14,84808,24811,53,24280,450
7,5,2,4,14,422866,22688,0,0,458
20,6,14,0,19,66462,0,121,3010,547
15,8,7,2,7,155290,7775,30,4900,505
31,12,19,5,13,41091,30767,91,21734,421
18,7,11,5,10,81290,21172,262,1479,477
26,11,15,3,9,103012,1845,7,936,426
8,6,2,1,12,23769,13349,24,13349,673
15,6,9,8,13,598424,69329,131,0,466
22,8,14,2,13,165218,44249,35,0,448
52,12,40,10,34,58480,57174,261,7328,419
4,2,2,2,12,249118,12824,27,0,641
10,1,9,3,8,9950,36406,81,18450,523
37,17,20,14,26,939248,137598,177,12513,425
13,9,4,6,12,412031,27383,134,7731,444
23,12,11,5,21,108526,57508,124,299,498
7,3,4,3,11,54843,72815,32,0,718
6,4,2,2,14,226491,15343,29,14957,473
31,16,15,0,14,1588798,0,45,0,530
3,1,2,1,7,1250,1250,32,1250,590
23,7,16,3,11,14857,12493,86,2550,484
9,4,5,1,8,86024,33927,16,842,466
11,9,2,7,5,45668,45468,219,14539,432
5,3,2,4,12,34446,36845,134,32309,467
7,2,5,0,10,0,0,63,0,705
8,3,5,0,8,9670,0,18,0,629
7,4,3,1,9,389728,4062,1,0,654
7,3,4,2,16,3171,6250,8,3171,486
9,3,6,3,11,24593,51967,48,13498,564
38,7,31,4,10,652140,129657,110,21910,491
9,5,4,4,7,36025,2226,65,733,481
6,4,2,3,13,61883,38406,26,20061,446
43,11,32,0,8,411958,0,12,4632,528
15,6,9,0,9,583106,0,3,0,638
6,4,2,2,14,378105,31454,24,22270,511
9,6,3,3,14,176501,11377,92,0,556
9,3,6,2,14,217124,232,32,2132,508
11,5,6,3,6,11559,15145,54,2300,521
28,12,16,3,17,57555,40647,103,17748,461
10,3,7,3,5,17614,25316,41,7702,523
7,3,4,3,4,14551,14551,278,7821,490
17,6,11,7,12,67873,86199,77,20978,453
13,5,8,3,13,7276,60798,88,10864,511
21,5,16,1,8,144944,13,65,2228,550
15,5,10,2,27,42665,41131,62,31315,479
27,7,20,4,16,1570505,141978,72,7477,504
36,5,31,1,12,29543,4434,68,23967,566
14,7,7,0,9,42883,0,9,0,539
6,3,3,2,14,8488,8067,34,5769,470
24,21,3,14,9,601246,177131,202,18665,407
15,5,10,4,11,32807,42957,266,13420,491
6,2,4,2,9,12042,12042,23,8284,422
44,2,42,3,15,4353,31043,127,9135,492
21,7,14,6,10,43590,22800,124,8537,466
9,1,8,2,12,1149,7526,45,6377,557
10,5,5,3,9,46066,17458,26,0,456
30,5,25,5,13,22449,21029,64,8195,466
12,2,10,1,13,425309,18632,0,0,544
12,6,6,0,6,23104,0,0,0,602
13,7,6,3,8,43670,37014,78,16487,522
39,3,36,2,11,5670,1741,5,1028,504
8,5,3,6,5,21889,32668,82,3383,445
7,5,2,2,12,126177,7435,44,9087,609
11,9,2,1,11,932715,8503,4,0,435
23,6,17,1,18,32459,5908,38,798,626
31,9,22,2,6,270312,769,11,5362,555
38,10,28,6,14,42046,41661,98,15437,439
12,8,4,0,6,1016373,0,21,2351,507
61,12,49,4,9,69123,2542,141,2738,442
20,9,11,7,14,103086,89912,107,15196,446
4,1,3,1,8,55177,53092,16,0,644
3,1,2,0,6,0,0,0,0,726
9,6,3,4,9,298186,14579,20,6276,405
12,8,4,1,8,89354,42600,26,1555,561
16,7,9,0,31,1139,0,3,665,698
5,1,4,1,15,211832,211832,39,0,573
10,3,7,2,6,9670,6912,27,5415,559
14,3,11,3,7,7746,28198,337,9522,446
20,9,11,8,10,466768,46913,78,16944,455
7,4,3,0,8,81272,0,11,0,666
25,10,15,0,10,315367,0,11,365,578
28,7,21,0,9,284149,0,7,0,622
13,6,7,2,14,63126,3832,1,3462,544
21,9,12,7,11,276261,165228,131,0,447
36,7,29,6,12,47795,47795,329,14982,430
13,4,9,3,8,11065,6068,61,5693,624
41,9,32,8,11,453670,68658,86,17847,420
23,11,12,6,9,658796,106063,90,11530,516
6,2,4,1,8,10544,10544,39,3559,480
42,11,31,4,9,168880,277,5,1363,539
7,3,4,3,14,426087,91907,25,2659,486
10,2,8,0,8,7199,0,26,0,568
21,7,14,5,10,251099,20915,77,5704,447
15,6,9,3,15,20061,5012,28,2453,452
16,5,11,3,9,102839,24162,64,911,470
16,9,7,9,9,49712,48452,174,20512,450
5,3,2,1,6,1000,1190,15,0,612
35,8,27,4,6,153676,30476,55,10017,566
2,0,2,0,3,0,0,8,306,608
24,15,9,0,8,521718,0,68,7855,449
12,2,10,1,8,10152,10152,111,10152,666
33,11,22,1,9,472431,7547,31,997,675
10,5,5,4,10,13506,14097,35,6584,493
7,3,4,4,9,29170,37131,24,9039,449
18,13,5,7,11,347554,38791,76,9363,426
3,1,2,0,8,0,0,4,0,687
19,5,14,5,14,34908,108813,63,0,682
13,2,11,2,7,11825,11825,92,3133,556
29,7,22,10,13,163349,240271,199,65838,425
60,9,51,8,15,47525,52996,145,135713,418
9,6,3,0,18,339118,0,0,0,673
35,6,29,4,13,66920,30750,110,5808,525
14,5,9,5,11,63412,63411,165,26981,417
45,10,35,4,14,285789,55699,251,2074,499
8,4,4,2,11,287656,10178,49,5775,481
16,3,13,4,16,677558,122300,161,23591,474
5,2,3,2,11,51210,51210,71,3060,525
18,5,13,6,7,39290,62208,48,25217,447
9,6,3,1,19,58771,17662,27,0,577
16,11,5,1,9,111240,11016,55,11016,531
11,2,9,2,11,17668,34485,0,731,504
18,15,3,5,7,575569,25180,90,2913,437
9,3,6,0,18,0,0,0,4827,591
16,10,6,4,11,296117,46275,0,0,469
10,8,2,5,5,56438,55122,161,7274,450
29,16,13,0,11,453882,0,38,11958,591
13,4,9,3,13,7735,12735,58,6125,449
46,6,40,1,10,93953,6662,106,7038,624
18,13,5,6,13,721646,10355,19,7192,548
53,12,41,1,16,482644,96,27,0,508
30,10,20,7,28,905030,478495,170,9841,515
81,18,63,12,6,67050,26913,138,6537,408
37,5,32,4,9,34371,23043,51,5121,454
21,10,11,1,9,95597,17401,9,0,663
64,6,58,2,18,66041,1306,2,1251,502
17,2,15,0,8,13931,0,27,1725,691
12,6,6,4,5,436405,31962,249,14431,500
17,9,8,4,13,224640,50693,90,3554,491
6,3,3,1,6,15033,1866,183,14454,615
9,6,3,0,6,25053,0,37,299,588
24,8,16,0,11,103653,0,32,0,539
14,8,6,0,17,784579,0,2,655,665
32,7,25,5,18,119950,118690,81,16130,461
9,3,6,0,11,58737,0,0,0,712
26,10,16,9,12,2333249,2193793,149,850,441
8,5,3,0,14,57291,0,28,0,611
13,3,10,1,2,15950,1755,18,362,500
16,10,6,0,21,3434018,0,0,999,617
18,6,12,5,13,208863,90079,61,33251,570
9,4,5,1,12,2834,1965,16,6904,508
35,9,26,5,9,40091,25294,179,9459,480
7,5,2,0,9,315031,0,0,0,637
19,3,16,3,13,136601,17469,99,13988,470
42,7,35,5,15,35561,23431,100,4888,455
65,9,56,6,12,223703,6056,134,6086,415
16,12,4,12,8,375119,315653,188,72404,481
11,1,10,0,11,23734,0,7,2442,550
29,8,21,7,13,81444,63695,118,5480,451
10,7,3,4,5,95551,62733,32,32733,409
4,1,3,2,7,6430,10658,72,0,515
20,7,13,1,15,40531,14701,127,19892,539
5,1,4,1,13,1560,1560,29,3103,505
5,3,2,1,17,36264,21848,2,0,687
6,3,3,3,4,7398,5760,33,0,476
19,12,7,11,8,139564,112901,166,55187,535
5,2,3,0,10,38621,0,1,0,618
5,1,4,2,7,5718,5718,46,462400,631
10,2,8,1,11,14848,381,5,381,595
451,14,437,4,18,880825,13307,180,8212,480
28,7,21,2,18,725587,45320,7,5276,472
9,7,2,0,4,35039,0,3,0,581
16,11,5,6,13,388853,20675,18,14156,474
29,17,12,0,11,885484,0,31,574,680
4,1,3,1,3,6030,6030,4,6030,489
8,3,5,2,12,608041,23079,35,22774,482
14,6,8,5,10,64715,34145,95,2124,469
9,4,5,1,14,49695,1358,22,5813,575
12,8,4,8,8,28376,27110,46,9405,488
18,7,11,5,9,86843,57993,108,23433,446
42,11,31,0,8,818886,0,6,6632,617
10,2,8,0,8,0,0,0,0,556
9,3,6,1,16,0,46268,32,0,642
20,7,13,0,7,152505,0,53,331,590
19,11,8,10,15,747129,148272,63,73906,490
7,3,4,0,18,26434,0,21,33430,543
20,3,17,0,6,9770,0,1,5175,635
13,7,6,9,8,381930,379363,141,106217,501
24,6,18,6,11,397240,74581,0,0,451
6,3,3,4,8,46525,67536,20,12941,451
20,11,9,0,11,109170,0,18,0,668
24,2,22,4,14,38556,38556,63,20040,489
23,3,20,0,15,0,0,83,8473,582
20,14,6,13,21,343569,542910,250,139520,423
14,4,10,0,18,538067,0,41,718,505
13,5,8,1,13,782685,8957,21,15603,474
14,6,8,3,6,695985,34518,51,4970,525
13,6,7,2,8,244811,14794,73,9356,526
5,2,3,3,5,19850,22996,34,14310,497
7,2,5,1,8,10313,2146,23,2751,625
5,2,3,1,12,20902,20260,0,0,491
11,8,3,3,20,318464,94803,30,0,578
13,3,10,2,11,1055365,14987,30,10754,559
33,15,18,15,13,165695,167128,293,971000,449
12,8,4,8,4,43212,17628,210,2570,416
25,5,20,5,11,152518,84338,58,4333,412
9,7,2,4,13,37088,47069,4,1213,491
47,5,42,4,14,40670,37521,58,16447,604
6,4,2,3,9,32957,32957,0,0,530
8,5,3,2,8,21570,3161,26,0,634
18,11,7,13,12,572263,354607,11,4506,458
7,5,2,1,3,49892,1044,0,0,645
12,5,7,6,14,173782,142004,105,6137,465
10,1,9,1,17,11000,11000,94,16074,504
24,5,19,3,7,382377,85573,38,51744,485
16,7,9,0,13,122917,0,1,0,701
13,3,10,0,10,28862,0,1,24,617
15,7,8,5,9,87373,73249,103,12324,490
14,11,3,12,5,147057,101466,163,40237,388
5,3,2,2,10,32022,11206,30,4375,492
12,3,9,0,10,16475,0,0,728,594
51,5,46,3,5,25853,20740,164,10980,630
23,5,18,2,7,30545,2207,60,257300,587
19,7,12,0,13,117413,0,1,0,635
19,3,16,0,13,25282,0,0,0,652
25,6,19,7,8,24203,39144,102,4584,569
14,8,6,3,8,170268,102842,63,1008,451
11,7,4,5,11,456072,33348,74,7637,419
9,4,5,3,9,18639,26799,190,8997,506
8,3,5,0,10,30453,0,6,638,683
16,8,8,1,8,240287,360,3,0,600
16,2,14,4,9,23055,21675,38,9227,516
8,3,5,1,5,29492,5777,29,10123,447
27,10,17,1,13,906410,532,22,3674,414
21,9,12,3,13,77080,11773,31,6747,462
21,11,10,5,28,439824,166256,110,20273,472
22,4,18,1,9,308540,278587,21,0,602
15,8,7,0,6,113333,0,4,129,668
10,5,5,0,12,58164,0,8,239,488
28,17,11,13,10,294451,170746,281,51681,417
16,2,14,2,8,29780,22571,112,13443,641
15,10,5,0,12,540861,0,1,1190,665
13,5,8,6,11,72890,38698,84,2493,489
11,3,8,3,7,36006,45009,40,0,496
14,7,7,6,11,24358,24358,107,13734,559
10,7,3,6,15,69336,69132,113,5215,414
16,7,9,2,8,69927,3028,10,2988,451
10,5,5,4,8,65619,51947,133,5757,473
11,4,7,8,6,141388,251811,159,0,542
7,5,2,4,11,258305,17191,79,2402,486
8,5,3,0,23,29133,0,10,1054,505
3,1,2,1,6,5338,5314,16,0,644
19,8,11,4,9,22885,11699,83,5125,534
15,4,11,1,10,380452,14297,40,3190,502
18,7,11,0,15,431188,0,9,0,662
18,9,9,9,13,78832,104644,127,14761,596
8,2,6,0,6,26763,0,14,1560,642
5,2,3,1,10,57730,10281,35,0,616
17,9,8,6,10,151332,91980,112,57616,429
15,4,11,4,7,43481,43104,73,12783,494
5,3,2,1,4,29995,20993,8,20993,523
5,3,2,0,11,0,0,0,1026,629
7,4,3,2,8,22859,12841,97,14459,491
5,3,2,4,3,192958,31098,23,25374,520
8,4,4,3,7,34856,20817,19,2089,500
7,5,2,3,14,20098,16798,55,5972,521
7,2,5,2,13,5300,5300,9,4529,506
12,3,9,1,7,137492,3329,0,0,535
41,11,30,10,17,913219,245253,435,62722,436
7,4,3,5,5,51405,48704,44,15882,412
4,1,3,1,5,693,462,3,750,537
6,4,2,1,6,225245,1566,12,0,635
12,9,3,6,19,1202586,1155136,54,296069,544
10,7,3,1,10,67669,1329,21,0,495
14,5,9,0,11,141860,0,0,0,686
14,8,6,7,14,16924,13940,160,19347,451
8,6,2,1,13,311373,778,9,778,551
25,5,20,5,5,269018,25448,149,13100,487
13,2,11,3,7,8214,8214,50,3136,538
12,8,4,2,15,585210,4364,44,17293,525
25,16,9,1,8,376102,1503,53,1503,544
2,0,2,0,3,0,0,2,4482,692
25,8,17,8,16,41487,26037,225,10777,490
7,5,2,2,11,379064,2667,0,2606,490
7,5,2,1,6,29796,775,13,0,603
7,4,3,5,8,22326,22326,61,0,528
5,3,2,1,9,50349,26071,11,0,459
25,11,14,8,12,37819,37679,146,9071,450
12,8,4,4,7,540904,20380,0,0,467
19,11,8,0,6,199637,0,4,0,491
16,6,10,5,11,47732,40147,135,18752,430
19,11,8,11,7,97504,91410,246,17659,476
4,2,2,1,11,436544,4284,45,2418,542
6,2,4,2,9,11540,7113,0,0,514
23,14,9,3,13,120055,3473,28,531,545
12,4,8,0,8,13293,0,0,0,580
6,3,3,0,9,1064,0,0,0,690
10,6,4,5,9,11145,8967,65,2920,416
15,7,8,1,10,312128,5932,0,0,604
4,2,2,2,5,23526,23526,0,0,522
16,7,9,0,10,155005,0,3,0,629
33,12,21,11,21,392742,191236,501,23845,495
11,4,7,1,8,55690,1030,4,1030,435
4,2,2,0,6,12668,0,6,423,696
27,12,15,8,10,528224,24367,67,0,486
31,5,26,1,13,39136,7569,1,7569,512
22,4,18,0,5,36818,0,13,766,619
13,9,4,6,30,50555,33271,89,75789,492
7,2,5,5,7,33473,33473,73,6863,482
19,3,16,0,8,117090,0,71,350,520
5,2,3,3,6,13944,24139,64,5300,520
5,2,3,1,9,15397,15397,0,0,572
42,8,34,5,17,53578,22540,93,7080,469
14,7,7,5,10,242673,51253,0,0,523
6,2,4,2,18,13232,13232,31,4420,491
4,2,2,1,7,32445,13710,21,0,634
22,7,15,6,8,198816,110547,43,2266,486
9,5,4,4,10,26587,24570,68,1351,519
35,14,21,4,9,154485,70048,116,613,520
22,10,12,12,16,361554,382219,269,89121,460
11,6,5,1,17,15373,4098,20,45458,484
17,7,10,0,7,694448,0,10,2969,516
18,16,2,15,12,103665,169457,265,65948,441
9,5,4,2,7,10369,3896,36,2987,525
5,0,5,3,6,0,44484,61,600,605
11,3,8,0,8,331784,0,143,1239,605
6,4,2,2,6,13219,8597,0,0,610
12,6,6,5,11,53128,51293,164,14497,411
7,3,4,2,7,24207,8277,36,1897,529
17,8,9,7,14,41677,141299,47,1050,430
57,8,49,3,14,73302,8136,51,10445,444
12,4,8,2,9,207435,101944,45,0,567
22,11,11,9,11,335901,81830,147,13346,415
8,5,3,6,69,72552,113706,89,48530,483
14,4,10,3,13,552583,71924,51,6332,431
24,18,6,0,11,3114512,0,4,8056,524
40,19,21,4,10,1139556,136624,50,1037,520
23,16,7,15,7,1398328,305811,46,45811,440
65,10,55,3,18,30885,8507,45,6863,488
33,17,16,12,19,550794,203017,330,30889,469
26,6,20,5,12,429565,50805,57,13048,443
10,7,3,3,7,23521,4534,220,2640,494
19,4,15,2,9,77651,39971,36,38469,482
26,9,17,1,21,1605071,2995,0,0,619
11,4,7,1,31,577717,698,1,698,609
19,6,13,0,5,8957,0,17,2774,598
8,6,2,7,12,616036,616036,59,129104,470
9,6,3,4,19,30285,23644,122,0,589
23,9,14,6,9,44911,36041,53,3731,440
23,9,14,4,17,587085,45125,70,1244,689
18,7,11,4,7,108676,89684,106,14997,480
9,6,3,4,10,47945,47625,33,15480,517
8,4,4,4,5,22068,19476,153,8750,479
17,9,8,10,7,60837,65560,203,18144,446
20,8,12,5,36,264848,229593,101,119656,459
26,6,20,4,8,144116,60679,80,775,620
19,8,11,2,9,305709,21267,72,1336,432
67,9,58,0,25,460605,0,3,200,659
20,5,15,9,12,53184,73163,53,15175,423
8,5,3,1,12,19851,10308,98,12603,532
20,7,13,5,16,200493,202969,67,130132,489
27,5,22,4,7,59280,50664,188,23416,454
11,4,7,2,8,60794,14731,66,22072,586
28,8,20,0,18,457856,0,2,144,650
10,7,3,4,8,589693,16193,55,0,511
19,11,8,10,8,54249,28638,47,17850,393
9,5,4,8,9,358501,620197,0,0,477
21,5,16,6,13,54509,77549,82,18567,582
16,9,7,10,7,73371,93018,432,19647,473
36,11,25,1,14,154366,325,38,3767,495
10,6,4,0,8,5572,0,1,0,625
20,6,14,6,9,116149,159843,109,3494,471
31,6,25,1,8,28288,231,51,22800,566
6,3,3,0,9,137294,0,0,0,704
24,13,11,0,18,1007031,0,20,2612,493
11,7,4,7,8,15999,15999,253,4511,401
19,8,11,5,13,10160,10160,71,5006,444
13,10,3,6,10,567323,22240,41,41705,469
34,11,23,8,9,94763,82402,110,39170,412
10,6,4,3,11,50362,17408,0,0,481
8,5,3,1,11,297757,7654,16,9290,548
4,0,4,0,8,0,0,2,0,599
12,1,11,3,8,33565,49705,50,19414,540
10,2,8,0,4,7835,0,0,0,624
52,9,43,5,16,126338,118863,95,4071,543
16,8,8,4,15,312543,19175,34,55396,530
42,10,32,4,9,236470,49386,46,15836,449
100,5,95,3,8,37457,6226,280,27749,472
11,6,5,1,12,102804,11678,83,11678,539
35,3,32,0,23,0,0,14,71210,582
9,2,7,2,10,18166,18166,24,9083,462
10,5,5,3,12,10006,2600,46,5286,529
7,3,4,0,6,720226,0,0,0,668
44,11,33,3,35,102136,63737,100,41837,440
42,15,27,11,12,1233370,64779,107,17102,447
62,7,55,5,10,153037,41511,68,21405,507
24,10,14,4,17,79745,48065,56,25119,509
9,7,2,7,8,24160,24160,107,14129,591
23,13,10,6,23,118307,38279,91,2550,530
10,3,7,3,9,6582,10382,52,3801,520
22,13,9,8,9,117968,61540,103,49675,460
16,7,9,3,19,501293,17904,13,6136,449
12,7,5,4,7,605186,13673,28,0,465
6,4,2,0,2,234733,0,1,0,556
35,13,22,0,12,1391703,0,12,9118,603
12,8,4,8,8,278505,275728,148,201799,396
10,5,5,0,20,167702,0,10,0,555
8,2,6,3,12,61628,143276,92,0,544
8,3,5,0,8,67594,0,5,3103,613
28,4,24,7,6,30308,30308,129,18434,502
13,6,7,7,8,65585,209580,121,428,466
9,3,6,1,17,9025,4505,14,2480,562
7,4,3,6,12,40403,52193,87,17268,548
17,8,9,0,14,1830690,0,15,732,677
12,7,5,3,7,96787,703,47,5178,513
6,3,3,5,13,30431,34579,29,6266,436
24,6,18,2,7,151483,14320,14,9533,489
22,11,11,6,11,705576,329071,148,51528,472
15,5,10,0,8,667838,0,6,350,580
27,9,18,4,26,719840,9814,191,11215,495
82,6,76,5,15,102898,68580,139,14555,443
17,8,9,5,17,664914,46018,107,7257,425
13,8,5,7,7,247724,45708,95,8104,432
11,4,7,3,6,24693,7168,192,5087,489
17,6,11,2,13,469172,7910,12,4720,597
26,7,19,4,10,307020,13437,81,4137,487
29,6,23,2,14,125324,61633,48,19984,456
5,1,4,2,5,19149,19149,109,15923,504
23,6,17,3,14,123072,45149,68,14399,504
18,4,14,3,9,58243,54706,149,28863,532
21,13,8,7,22,1849151,250818,124,9293,434
10,3,7,2,9,12514,4805,97,4561,526
11,9,2,6,11,201512,62741,112,3720,550
12,7,5,1,10,244873,2966,27,0,497
24,6,18,2,14,932458,4870,216,2349,532
16,5,11,4,11,35477,59637,22,13785,465
8,5,3,1,6,182893,6300,28,1751,491
26,12,14,12,9,95497,103213,479,38215,453
15,6,9,4,12,469169,16117,107,938,494
30,10,20,6,17,538215,40109,185,17880,428
12,7,5,8,14,36840,60174,141,9475,423
24,11,13,0,18,813335,0,12,0,622
20,15,5,0,7,312896,0,2,0,464
15,8,7,3,12,458438,4225,69,1925,524
7,4,3,0,10,7195,0,0,0,641
5,2,3,4,5,56622,56622,14,10254,471
16,5,11,4,13,395461,17572,85,6737,481
9,7,2,5,15,56575,56575,124,16353,478
59,12,47,2,15,420972,20160,44,10218,472
26,5,21,4,7,143639,11608,15,6172,587
24,14,10,0,15,981851,0,4,1085,547
24,12,12,0,15,367546,0,34,96,553
7,3,4,1,17,11955,2541,19,15455,716
14,6,8,1,14,101507,1200,43,1200,534
16,7,9,7,14,49405,40097,92,26777,368
24,4,20,4,12,16239,11923,49,1726,506
18,8,10,9,19,464565,137977,37,55818,549
17,4,13,8,11,14267,292175,185,194061,403
14,7,7,0,8,14660,0,24,1149,601
7,5,2,6,4,28506,40171,11,644,487
7,4,3,3,3,14657,11742,182,1642,508
11,3,8,0,6,98677,0,9,1049,606
5,2,3,0,2,27718,0,28,251,670
24,7,17,9,6,194699,221421,139,28814,433
11,2,9,0,6,45862,0,4,0,616
33,5,28,0,7,124519,0,36,1802,644
10,3,7,3,8,65399,39144,48,5766,527
17,11,6,2,10,397095,5832,3,4404,444
14,11,3,12,6,44577,51163,178,12047,424
8,1,7,1,8,2633,2633,16,2633,595
105,31,74,23,11,286752,191476,730,18215,459
6,4,2,4,29,275102,159865,102,0,494
17,6,11,4,31,62642,44213,127,10131,456
40,4,36,1,9,339545,32795,59,5320,572
9,7,2,2,8,37835,431,6,318,600
26,13,13,3,16,745749,6009,14,3818,405
42,7,35,5,11,130166,71216,69,0,465
17,3,14,1,11,331356,17623,47,336,501
10,6,4,4,6,30524,27564,43,10846,403
16,6,10,0,7,71369,0,14,0,600
12,1,11,6,15,18918,66992,80,18918,421
8,3,5,0,10,37319,0,8,389,679
9,5,4,5,8,40577,80286,97,26546,466
18,3,15,2,8,54064,24418,48,23391,521
12,5,7,0,10,90528,0,26,1788,585
12,6,6,2,16,5095,4847,124,3720,496
4,2,2,3,7,10006,11657,51,0,559
7,4,3,2,8,136006,132310,69,0,519
3,0,3,0,4,0,0,6,0,604
18,10,8,3,17,365680,11125,7,3180,407
7,3,4,2,9,17261,15343,0,0,446
46,20,26,12,10,251485,57049,253,1017,430
18,7,11,4,14,72433,48819,50,33817,566
9,6,3,3,5,39452,8151,23,5682,499
17,6,11,2,14,38430,2717,16,1275,624
44,12,32,4,18,229796,48297,329,42933,507
4,2,2,1,3,17392,5391,8,0,527
141,6,135,4,17,79377,103928,36,0,606
17,6,11,0,20,82140,0,5,0,639
32,9,23,10,14,49571,345132,175,30148,414
10,7,3,5,9,40135,40135,314,10649,533
9,2,7,3,7,7900,18034,70,0,519
31,11,20,12,14,533200,116138,262,11417,414
28,8,20,4,69,668925,18696,52,13553,503
50,3,47,4,12,106595,20944,66,14386,543
9,2,7,1,13,9262,9262,26,9262,542
9,5,4,0,5,24527,0,13,636,474
29,12,17,5,13,304346,11572,60,20254,391
5,2,3,3,9,265875,46599,0,0,599
19,9,10,9,9,196516,126408,87,0,495
46,17,29,15,12,284548,983297,129,10786,492
18,9,9,4,11,1483670,66568,58,12160,398
16,9,7,0,17,1888242,0,3,0,621
19,10,9,6,29,1548053,29854,70,0,517
18,7,11,5,13,38658,31825,250,22878,459
6,3,3,3,8,224666,12478,46,3362,609
13,3,10,2,11,19664,9642,32,0,678
8,4,4,4,8,12950,12731,53,796,439
10,5,5,2,14,17739,17739,119,12541,516
25,11,14,8,17,83926,67095,194,13410,447
6,4,2,4,10,53255,53255,88,5946,462
12,4,8,1,14,172773,554,19,9557,597
9,6,3,4,8,446252,61455,52,6723,477
47,12,35,5,10,91539,16608,58,9420,461
13,7,6,4,18,329286,14468,15,6557,415
18,4,14,0,9,534195,0,32,1509,633
12,6,6,1,11,338319,1685,11,3945,486
9,3,6,2,12,36611,36611,95,57993,544
7,4,3,1,7,236264,11463,5,0,643
13,8,5,7,17,143422,51507,82,27203,404
13,10,3,4,21,557111,365775,38,21452,437
27,14,13,12,11,911693,416393,217,85302,396
35,19,16,9,19,839983,133136,73,34724,438
8,6,2,7,16,483776,57553,82,7158,488
24,7,17,7,14,66520,63441,151,19317,603
11,8,3,4,14,95994,55863,42,31824,476
61,5,56,4,15,150664,19886,14,10912,470
23,13,10,0,11,650406,0,0,0,620
22,9,13,5,15,425389,13220,155,2670,481
9,7,2,3,5,177430,10656,55,8341,482
5,2,3,0,8,17412,0,0,0,614
11,8,3,9,6,9957,11472,94,4487,397
16,10,6,3,6,186384,7767,0,0,573
23,9,14,2,11,51062,6901,143,5716,497
29,11,18,0,19,255679,0,32,6547,607
7,1,6,0,15,4899,0,0,1274,671
17,11,6,6,10,496856,63756,117,23263,406
20,12,8,2,12,340395,1757,16,0,479
4,2,2,1,6,7921,7863,87,7863,483
18,8,10,0,9,40470,0,4,0,633
28,11,17,9,22,308473,168223,48,6339,524
15,3,12,2,13,4626,8599,31,7477,451
52,17,35,2,13,393003,1231,19,14879,519
22,11,11,8,11,498871,92095,17,40503,471
6,2,4,3,7,16021,26626,0,0,457
24,6,18,5,14,28467,6389,265,2875,498
29,7,22,4,17,24656,7709,50,6775,429
17,12,5,2,21,458038,97945,62,78788,410
8,6,2,2,7,340746,10015,0,0,617
13,5,8,3,16,113461,71372,59,60822,497
7,4,3,2,14,7984,7984,28,7260,605
16,10,6,0,20,2492942,0,0,0,622
8,2,6,5,8,69299,67441,49,0,513
10,6,4,1,9,367160,3582,17,3582,508
11,7,4,4,11,478083,51132,69,486,497
42,12,30,9,13,106540,106672,102,20156,478
2,0,2,0,5,0,0,6,0,601
9,6,3,1,4,442447,39981,13,2141,482
9,3,6,3,14,6638,10656,32,5590,444
8,0,8,0,12,0,0,35,3329,584
19,11,8,0,18,146309,0,2,0,601
12,6,6,2,17,93094,23614,59,19839,575
24,12,12,15,9,467377,502847,325,126414,441
14,4,10,4,14,69915,69914,61,37767,451
13,6,7,5,10,39792,26761,38,9309,440
11,3,8,3,16,159653,99392,45,41473,521
27,4,23,1,8,78817,6571,24,6571,509
24,14,10,1,31,279897,3393,6,7367,613
4,2,2,0,6,203,0,0,0,713
5,1,4,0,5,1702,0,4,1532,598
21,16,5,7,15,507207,53339,108,10041,400
7,5,2,5,7,301628,286960,95,270076,481
12,8,4,4,22,329863,30331,42,23961,480
75,6,69,5,6,40076,13725,19,5796,514
17,0,17,2,8,0,48933,42,0,491
58,7,51,2,10,99761,12381,81,7797,479
19,3,16,3,9,17156,2286,49,5490,524
28,7,21,7,12,45300,19692,112,9448,477
33,7,26,7,14,48085,78122,24,9880,466
8,5,3,2,7,124804,53230,48,780,442
18,6,12,5,12,132067,132067,68,0,455
35,11,24,6,15,50022,32136,107,7213,415
59,8,51,6,8,50982,19209,144,11830,460
8,6,2,0,9,82923,0,27,0,586
12,2,10,4,9,23093,31093,112,18312,535
5,3,2,5,8,92552,255807,92,62354,460
11,3,8,1,15,4977,4977,103,6097,448
11,7,4,7,8,159423,163992,83,0,444
14,2,12,0,13,0,0,115,2794,609
7,3,4,2,10,24629,5776,35,5661,425
28,9,19,4,7,35202,12254,3,4106,480
22,6,16,7,8,31877,33190,110,8890,411
23,3,20,0,9,21323,0,54,364,604
17,10,7,0,19,394463,0,3,815,579
19,11,8,2,7,102108,6655,35,571,481
14,6,8,1,13,36967,1619,21,13130,457
39,15,24,1,7,1008446,2276,3,2276,498
6,2,4,1,11,1206,1206,127,2813,561
25,1,24,0,15,0,0,46,736,566
3,1,2,2,14,698,8594,0,0,509
17,11,6,6,16,67392,46225,95,6777,477
10,7,3,1,10,51221,9258,21,9258,489
12,7,5,1,12,326266,7075,12,0,606
3,0,3,0,6,0,0,2,0,625
23,6,17,3,13,342599,193549,31,591,490
13,4,9,2,7,14372,5046,27,0,539
11,9,2,1,9,122945,780,16,13156,466
6,4,2,6,12,459781,73963,91,25058,425
19,8,11,2,14,68864,9609,29,6815,402
4,2,2,1,7,5792,2717,0,0,525
31,8,23,0,16,690350,0,10,11000,572
5,2,3,4,9,18932,29376,63,0,494
6,3,3,4,10,17240,24631,46,4183,477
62,9,53,4,13,336788,6189,98,16492,481
5,3,2,2,8,22182,10860,4,0,457
268,11,257,8,13,133227,174727,140,72813,494
20,16,4,0,12,579121,0,0,0,577
6,3,3,1,12,1615,298,38,218,490
23,7,16,10,14,55953,92335,188,25342,483
23,4,19,0,7,55885,0,53,664,648
31,13,18,5,19,391489,14786,26,6745,423
9,3,6,0,12,35592,0,0,0,551
78,6,72,3,26,196320,33807,104,31380,693
26,11,15,0,15,1276664,0,6,1076,630
19,5,14,1,14,50379,16526,12,0,518
19,4,15,4,16,288132,26511,67,2883,515
31,6,25,3,8,80453,3121,22,1288,504
63,16,47,8,19,1705201,362868,54,5184,512
53,6,47,5,19,263253,43074,45,6747,466
31,8,23,3,11,482746,22991,63,10875,474
3,1,2,0,3,69951,0,0,0,642
12,4,8,2,6,181165,5823,18,4253,457
12,4,8,3,15,58118,56675,30,78931,478
24,8,16,0,11,421616,0,0,0,635
8,3,5,2,7,17609,16894,51,10659,520
26,10,16,9,7,424485,56243,166,14607,425
53,17,36,4,9,651975,24263,72,9977,402
25,19,6,18,18,570084,405443,876,168542,417
518,18,500,1,8,62144,390,71,4318,455
18,8,10,0,9,210029,0,0,0,581
3,1,2,0,5,9063,0,1,0,673
6,3,3,2,9,57333,11213,12,0,559
13,5,8,0,14,68542,0,29,2159,614
29,9,20,8,11,8356474,3453538,99,13922,456
6,2,4,3,7,7884,10699,49,0,498
53,10,43,6,16,502385,19056,113,11546,375
11,8,3,4,13,61980,33259,34,11092,408
176,8,168,4,6,65788,28634,34,7661,467
32,7,25,5,14,43927,8909,38,5716,482
13,5,8,3,5,40584,242,51,424,517
29,12,17,8,20,27494,12993,157,6252,522
39,7,32,2,14,643420,60241,31,44208,462
6,3,3,0,4,13430,0,0,0,525
6,1,5,1,14,39905,39905,25,0,596
7,4,3,5,10,274553,12991,47,1653,486
16,11,5,0,7,138677,0,1,775,552
22,11,11,10,6,195849,137127,149,39990,424
3,1,2,2,6,25200,30236,42,25200,620
6,3,3,3,9,20651,31216,62,13678,508
13,8,5,2,14,173623,3906,7,0,645
9,4,5,1,17,575120,25293,35,3150,563
32,14,18,7,5,577248,313400,96,21866,434
16,9,7,0,13,127049,0,7,0,586
16,11,5,7,27,363020,127455,120,0,492
12,3,9,1,36,815083,3450,90,19591,527
36,10,26,7,16,24418,24418,318,17586,461
25,7,18,4,11,309081,219055,100,0,573
2,0,2,0,4,0,0,1,448,626
22,7,15,1,11,756157,762,25,5219,528
6,4,2,3,3,339713,28562,23,1699,544
25,11,14,6,45,47152,23675,139,10988,440
8,2,6,1,8,5791,2638,23,2638,635
10,8,2,0,8,123151,0,0,0,658
31,9,22,1,14,21683,6348,48,22875,471
175,3,172,0,7,4165,0,6,2165,536
10,1,9,0,13,26235,0,0,1076,677
14,8,6,5,14,160599,31782,80,12349,443
6,4,2,3,6,220452,16772,33,2657,454
15,4,11,0,14,10786,0,0,576,632
5,2,3,0,2,1671,0,0,0,619
172,19,153,1,18,164591,1690,205,3226,462
11,3,8,1,7,127657,62912,14,0,662
18,5,13,0,8,128042,0,27,0,672
55,4,51,2,11,396206,31885,223,30949,480
6,4,2,0,14,121092,0,1,1597,559
9,3,6,3,8,10560,16557,198,15389,462
35,5,30,8,11,78234,57848,40,14405,470
14,7,7,0,18,404539,0,13,60002,522
18,11,7,9,13,272002,366152,209,96903,423
18,9,9,1,14,50643,5382,50,6583,455
18,5,13,1,7,157777,31,18,0,537
11,3,8,1,8,33495,11860,19,0,544
14,4,10,2,14,28128,28128,26,27098,501
8,4,4,0,9,205873,0,56,3256,405
10,4,6,2,14,33121,3366,6,2160,516
39,3,36,1,9,8306,233,34,1262,677
5,3,2,2,13,257203,257203,39,29403,585
11,6,5,1,2,40261,635,10,101,547
24,2,22,4,7,47571,55756,3,27929,483
19,10,9,0,24,537437,0,32,246,678
9,7,2,1,7,34401,576,13,1975,438
27,6,21,1,7,31630,9586,151,10333,526
15,5,10,1,8,144638,5256,25,270,539
23,9,14,10,8,59472,48571,198,6462,461
39,12,27,7,11,164261,50397,128,12080,447
18,5,13,5,5,409321,137568,115,66728,498
6,3,3,3,4,52941,42903,129,13637,449
4,2,2,1,12,1677,1677,15,1677,512
10,6,4,5,11,40479,50655,94,25840,459
31,7,24,1,6,189057,2398,1,2398,496
7,2,5,1,6,62950,9546,35,0,522
39,6,33,1,13,84588,28159,18,2856,470
9,5,4,6,7,188624,177023,120,173,510
60,10,50,3,18,242175,15290,96,8421,466
4,2,2,3,8,27111,30772,11,14383,451
17,8,9,5,7,54956,19845,68,1500,505
19,4,15,4,19,45832,46507,246,39528,453
7,4,3,0,6,1120,0,4,0,632
11,7,4,3,11,63794,53823,71,98337,449
13,9,4,0,12,181710,0,0,0,614
34,7,27,4,14,427185,363228,121,149641,430
47,19,28,7,9,96212,13247,63,3725,419
5,3,2,3,16,8744,17911,54,0,539
29,7,22,2,12,200022,23574,31,11787,461
10,6,4,6,10,129622,23329,28,6980,460
12,4,8,1,6,18494,1016,36,1830,449
4,1,3,2,6,11752,11752,152,8631,585
16,8,8,7,14,269963,85699,0,0,443
14,11,3,1,10,291769,1623,8,0,486
40,8,32,3,30,26923,20177,100,13282,498
22,3,19,1,15,9582,9582,98,9582,594
13,9,4,4,9,802453,26055,2,1296,447
32,10,22,0,9,37527,0,35,1571,585
8,4,4,3,16,30479,43103,40,22949,436
15,11,4,0,5,231426,0,1,380,672
26,8,18,8,20,207571,62144,156,19816,450
7,5,2,1,17,165956,17751,3,17751,648
6,3,3,2,7,8022,13825,24,8022,564
14,7,7,6,19,472872,96562,62,0,496
28,8,20,9,17,36607,33635,138,7970,446
20,5,15,0,10,443724,0,0,3878,524
7,1,6,4,16,30128,56485,40,1855,542
15,12,3,11,17,83741,72654,187,9998,446
5,2,3,1,25,502094,10408,23,10408,656
12,4,8,4,12,67010,55063,53,28469,436
16,12,4,9,10,765936,207820,114,11733,419
20,7,13,4,9,157654,29848,59,16667,593
9,5,4,1,12,68967,2006,18,2139,409
37,8,29,4,18,80018,23695,109,1300,530
6,4,2,0,10,410643,0,0,0,614
22,7,15,2,69,146530,11756,37,8071,604
19,10,9,2,16,439136,16532,15,14705,474
14,11,3,11,12,120839,120839,161,22747,379
16,6,10,5,8,34678,28512,197,9810,521
75,6,69,6,12,78468,12536,130,19397,481
7,4,3,4,9,28532,66293,34,0,494
8,6,2,6,7,87483,77507,118,6195,459
10,5,5,1,7,20743,20743,28,0,568
205,5,200,6,12,131451,52857,156,23161,498
12,8,4,6,6,85273,69965,128,11657,426
28,24,4,19,4,405288,109909,411,0,496
19,10,9,3,8,189058,2063,221,1796,436
8,3,5,4,6,41899,54273,69,21104,538
17,13,4,2,22,59382,40056,0,0,532
3,1,2,0,11,1000,0,0,0,625
12,7,5,8,10,2477347,3445308,156,46886,430
25,10,15,4,12,31135,8641,45,5193,443
23,6,17,3,14,37150,36931,223,21054,463
11,6,5,4,12,18630,16524,41,27583,533
22,12,10,7,19,414136,937858,58,131,507
14,5,9,2,4,53628,314,164,412,433
11,5,6,5,6,9487,10782,257,4648,401
33,9,24,0,11,35274,0,2,1467,549
9,6,3,4,8,22695,7661,5,2392,459
18,9,9,1,13,120766,1091,7,11863,428
23,9,14,1,26,498209,2200,8,2253,468
10,8,2,2,12,822507,2869,6,219,580
18,6,12,2,10,434184,22375,0,0,450
24,3,21,0,8,15390,0,20,0,561
9,4,5,1,9,71670,952,0,0,562
14,7,7,2,13,257396,10349,51,14538,475
11,3,8,1,7,13949,13941,45,3100,551
4,2,2,2,3,14574,10053,27,0,517
12,3,9,2,14,199581,182918,20,4783,450
16,3,13,6,6,31826,29264,118,9076,494
13,9,4,0,11,395188,0,0,7,692
6,3,3,1,14,700701,11087,96,22174,707
17,4,13,0,12,267237,0,1,39,706
19,12,7,8,7,84971,69985,78,24854,456
11,7,4,4,21,266946,238511,66,0,488
22,7,15,6,4,23186,23186,100,5961,475
14,9,5,1,13,17143,4866,5,4866,619
12,5,7,4,7,27180,20828,77,8379,482
50,4,46,4,11,157314,153608,56,1263,526
32,5,27,2,38,65906,35143,137,1467,453
11,5,6,2,14,16611,13965,115,10969,456
6,3,3,4,7,6460,23593,19,3364,433
7,3,4,4,6,168418,186880,60,0,450
3,0,3,0,8,0,0,0,0,700
19,4,15,5,11,81231,111281,73,45443,440
6,4,2,4,5,135992,125758,75,0,499
34,11,23,8,16,110281,89466,301,52982,442
43,4,39,4,12,14299,14299,84,5346,463
9,7,2,3,3,39538,775,27,875,401
13,8,5,1,5,99420,4157,39,4157,622
7,4,3,0,10,48213,0,1,14081,695
26,14,12,1,11,940103,74,2,74,563
20,7,13,6,14,40139,20365,127,5610,458
12,1,11,3,12,116738,14981,25,0,601
33,14,19,4,10,88647,2022,123,17650,536
6,3,3,1,14,40469,17738,12,17738,627
13,9,4,9,8,68397,69597,89,21265,441
38,16,22,7,10,164976,32609,212,15510,428
25,10,15,2,22,836886,16898,68,9694,405
5,2,3,1,8,4310,8309,12,0,602
14,8,6,3,10,168345,59934,19,10714,418
3,1,2,2,8,9254,18585,0,0,490
29,6,23,5,13,102815,74234,173,2406,509
20,3,17,4,11,42397,42397,48,3920,628
21,9,12,0,6,52260,0,2,124,606
7,3,4,2,12,0,80335,49,3240,496
7,5,2,3,8,5433,5433,71,2733,638
8,5,3,6,11,68873,68799,52,17577,472
9,6,3,5,12,56672,56282,119,19269,427
13,6,7,0,15,298203,0,21,3860,581
26,9,17,7,12,169190,164035,166,729,452
9,7,2,6,10,205726,205726,43,184612,424
14,6,8,5,7,34036,6479,46,601,506
4,2,2,0,10,11081,0,1,0,586
4,1,3,0,6,0,0,282,10098,432
15,7,8,4,21,624056,243083,111,57291,505
18,4,14,0,15,45216,0,0,1159,626
11,1,10,1,11,2954,839,16,259,539
7,2,5,2,7,3006,5652,130,3006,643
3,1,2,0,5,8939,0,2,0,523
16,8,8,3,22,416714,20645,44,18021,501
7,3,4,2,22,17756,9273,57,720,596
27,7,20,0,9,99232,0,105,1058,681
8,2,6,1,12,6829,5146,25,411,482
5,3,2,3,6,14655,14488,42,4262,639
10,2,8,2,8,165490,163187,16,0,469
19,8,11,3,4,169345,3647,12,3565,474
23,11,12,11,13,106810,82055,86,51221,470
12,3,9,0,16,4468,0,5,0,698
14,7,7,2,19,15564,2586,31,1905,489
12,5,7,7,8,85016,80010,125,0,514
60,22,38,5,11,1418275,23837,47,9015,391
10,5,5,2,25,133242,155324,41,1106,515
16,4,12,2,6,196893,6138,6,0,455
50,20,30,17,27,1179367,863263,252,240199,447
11,3,8,3,11,6372,3785,30,2635,488
4,2,2,1,6,63626,1223,8,1223,448
8,4,4,1,11,257212,24153,0,0,612
53,6,47,5,9,24186,21183,0,0,508
21,7,14,0,5,26032,0,1,0,542
5,2,3,3,13,21670,17812,26,11376,649
11,8,3,5,10,35213,19700,58,3758,439
6,1,5,1,7,1515,5259,13,1933,555
11,8,3,6,28,319854,173747,129,0,476
16,11,5,2,23,128720,117697,18,0,480
12,3,9,0,8,12954,0,6,0,622
15,6,9,2,18,201704,11705,53,1080,481
15,9,6,4,10,472482,42608,13,0,466
8,2,6,2,11,9470,9470,191,6748,512
12,7,5,6,25,21799,30479,70,6124,436
6,2,4,3,6,62523,7924,65,2038,576
12,4,8,6,7,57617,64777,76,36260,494
6,4,2,1,18,337565,80817,4,80817,586
5,2,3,1,5,20901,20901,20,20901,590
25,10,15,8,46,58746,66714,84,6656,460
12,5,7,3,21,27443,26767,96,1250,492
12,2,10,2,13,12854,11204,40,5421,545
7,4,3,3,14,27854,6864,50,3963,490
35,8,27,3,6,27179,8770,57,7512,623
20,7,13,0,13,87736,0,26,0,517
20,9,11,12,12,117392,134218,201,39358,481
11,4,7,2,5,42384,11146,34,481,462
16,4,12,2,11,269838,30217,65,15457,549
10,5,5,3,18,259099,4863,48,3403,573
9,3,6,0,10,163194,0,0,0,690
19,13,6,1,5,107284,3439,5,50,470
12,9,3,2,7,42003,1367,51,695,599
9,6,3,1,7,16857,2639,10,2639,593
5,2,3,2,8,11346,15147,28,0,538
11,4,7,3,17,139108,184573,121,132403,515
16,7,9,4,7,10284,9503,63,4884,451
19,10,9,0,14,728337,0,8,0,534
16,4,12,3,9,33914,26125,9,13176,522
52,11,41,8,17,100696,57754,223,21250,456
8,5,3,3,11,27313,27987,60,70469,488
10,7,3,4,15,160560,155829,55,141842,483
23,12,11,1,14,508326,1971,11,304,665
14,0,14,1,6,7488,7488,14,7488,605
8,6,2,1,8,284013,6674,45,1852,523
7,2,5,1,12,25237,309,1,0,633
17,11,6,7,7,360963,39711,365,19516,412
10,7,3,2,6,85408,21425,20,0,514
14,6,8,4,9,385765,38286,76,0,675
14,9,5,0,13,496636,0,0,0,706
32,7,25,0,19,154101,0,26,203,590
14,7,7,2,19,35008,17617,42,10246,506
12,7,5,3,5,70680,2179,35,2015,551
25,13,12,3,16,141862,11121,27,6771,454
36,9,27,4,13,265630,13913,189,9258,518
19,4,15,0,13,157917,0,1,2082,555
29,10,19,0,9,183422,0,3,235,577
12,7,5,5,7,19994,18774,122,8141,488
31,10,21,7,17,91905,66308,51,0,498
12,6,6,4,15,276814,11079,139,7956,463
6,1,5,3,5,1926,11316,23,7310,472
53,13,40,13,17,133153,120407,173,18393,425
27,6,21,4,8,142668,31405,215,7706,451
23,9,14,4,11,63419,38225,3,6945,509
17,6,11,2,11,526777,11630,31,0,446
17,10,7,9,9,120364,59848,193,9883,425
5,3,2,0,14,80292,0,0,0,669
8,3,5,2,10,373128,13509,3,16151,451
54,11,43,8,9,103297,63009,304,14454,418
20,9,11,5,10,119909,61117,0,0,486
22,9,13,6,8,37051,20708,431,20916,411
6,1,5,3,8,15178,27875,67,0,612
6,3,3,1,11,15103,1096,1,1096,460
10,6,4,1,4,395360,1214,36,1475,436
14,5,9,4,18,218268,280900,68,0,590
240,20,220,8,7,218068,2113,768,930,471
20,4,16,3,12,31794,31794,74,8676,525
7,2,5,2,9,8538,7575,15,2481,460
8,4,4,6,3,8669,32566,121,28118,521
7,4,3,3,12,25192,25192,86,4748,466
32,9,23,2,12,284595,591,58,528,538
10,2,8,0,4,9246,0,0,0,695
16,7,9,5,9,39582,25556,76,4158,522
15,5,10,5,14,17064,48873,94,42706,481
24,12,12,0,15,2186708,0,11,1255,552
7,5,2,5,10,43158,30630,29,2451,484
22,5,17,0,11,288465,0,1,472,676
6,4,2,4,9,24389,24389,311,19849,500
76,13,63,2,22,756578,317,282,3925,462
4,2,2,1,9,1024,1024,17,4929,559
26,8,18,4,6,87339,12257,67,3305,467
21,7,14,0,15,1513522,0,1,884,640
14,4,10,2,6,20700,3416,17,1508,434
5,3,2,3,12,24512,24512,65,1992,472
35,24,11,0,15,1197538,0,3,0,619
18,8,10,6,11,60206,25647,0,0,454
11,6,5,4,11,42883,24236,28,466,495
13,10,3,4,16,72508,64576,48,44295,444
10,7,3,0,16,339543,0,8,0,552
4,1,3,1,12,33610,32967,0,0,658
13,6,7,5,11,153977,58916,84,20411,478
9,1,8,3,5,14950,94762,82,0,543
9,5,4,0,7,127624,0,11,4140,500
21,10,11,7,9,538721,71322,157,12375,473
16,8,8,8,13,27894,36040,119,3274,413
6,2,4,3,10,11945,11945,43,8565,548
14,8,6,0,11,342419,0,4,767,625
30,16,14,16,53,278555,294238,84,54553,394
4,1,3,0,6,27395,0,0,0,591
35,8,27,3,14,25324,3592,23,2578,468
41,7,34,6,13,546941,101366,87,11181,436
27,14,13,3,14,165255,15902,45,13345,555
20,7,13,0,8,446423,0,0,0,693
12,6,6,2,8,87951,3257,118,3121,506
33,10,23,7,16,157090,99762,83,75475,441
6,3,3,2,16,34579,34579,28,0,551
35,5,30,3,15,32809,26533,40,16842,464
10,3,7,0,8,10551,0,0,0,613
5,2,3,3,7,13075,19636,31,6538,511
13,8,5,5,4,49058,10182,59,7519,375
16,12,4,15,8,45487,65568,721,12461,421
10,5,5,3,13,23812,23812,46,6514,515
21,8,13,4,13,382552,26888,120,2650,459
71,31,40,2,15,8830818,4857,27,0,494
14,8,6,2,11,223051,7029,22,4822,624
29,6,23,2,6,31480,15299,55,8078,532
15,6,9,1,6,111808,5285,0,0,495
21,5,16,6,16,36129,42309,29,10757,392
30,10,20,6,9,27551,26968,117,13694,449
8,5,3,2,9,56355,12637,0,0,623
4,0,4,1,8,0,4406,8,0,615
13,6,7,1,8,26885,840,64,840,515
3,1,2,1,2,3681,3681,5,3681,341
5,3,2,3,6,41524,26153,30,6119,431
18,7,11,6,9,25342,27992,137,11108,385
6,3,3,2,15,11671,10899,120,5560,517
15,8,7,6,14,306374,30647,25,0,470
31,23,8,0,14,3667782,0,6,2523,544
7,5,2,5,7,33236,33236,182,5827,475
57,14,43,3,9,187700,28150,76,1250,518
12,6,6,1,24,415796,35401,9,0,481
98,24,74,18,16,233619,158845,447,15847,427
31,7,24,5,11,186738,35951,102,4132,489
10,4,6,1,3,251385,242220,4,0,464
42,12,30,5,6,125861,35723,209,20490,500
58,15,43,3,19,248502,33299,43,16834,456
24,9,15,5,14,111488,13283,139,1710,496
14,8,6,0,13,424589,0,13,0,520
11,3,8,0,12,0,0,25,5529,640
17,4,13,2,13,11510,4315,24,2975,477
4,2,2,2,7,19487,9668,48,0,558
62,6,56,1,13,10239,2069,44,2969,553
9,2,7,3,9,64515,68730,68,63395,559
54,10,44,0,17,192144,0,97,23216,444
9,7,2,0,3,183824,0,1,0,506
22,6,16,2,15,555504,23797,29,4282,482
4,2,2,1,3,109589,8099,12,0,461
17,5,12,5,24,31182,56554,133,23602,519
7,5,2,0,19,364108,0,0,0,538
44,23,21,24,17,1699060,1458287,165,848,434
33,11,22,4,9,371229,24037,97,16425,465
14,3,11,1,5,689703,5997,6,1364,657
3,1,2,1,8,5617,3490,33,0,545
13,6,7,4,13,28266,20867,80,5958,459
6,4,2,4,4,19595,13434,18,10773,447
18,9,9,1,14,1420837,25454,40,25454,536
147,14,133,8,12,520175,219672,70,1423,462
7,2,5,1,18,2466,966,3,2898,530
23,5,18,0,5,5302,0,22,826,558
13,7,6,6,11,888420,212081,156,0,495
11,4,7,6,14,25688,36721,92,12733,475
17,6,11,2,20,194795,23383,17,0,571
4,2,2,1,8,992,2533,7,0,625
16,11,5,0,14,452336,0,2,0,435
18,11,7,7,6,126226,23301,117,7299,404
16,10,6,10,45,755035,255143,130,8615,419
15,8,7,2,9,84182,20043,145,9340,475
26,3,23,0,17,29008,0,0,2917,651
10,4,6,5,10,81436,74110,30,28050,442
11,4,7,2,11,6920,6221,43,10132,486
23,8,15,5,16,45409,31684,120,13976,441
25,17,8,8,8,189253,129165,23,15989,513
8,5,3,3,8,24400,21372,23,10066,477
23,10,13,6,14,174182,42628,30,3925,438
10,7,3,6,10,122587,76663,87,4996,423
15,8,7,1,17,690206,24318,21,1842,530
14,10,4,9,11,482912,101153,110,0,471
13,7,6,0,12,65240,0,0,0,480
25,8,17,7,8,49292,34133,292,12068,440
6,1,5,1,11,1928,1928,1,1928,565
10,3,7,5,13,20794,27675,42,11280,494
36,7,29,0,5,142878,0,0,299,638
7,4,3,5,18,8225,9772,39,3063,538
15,11,4,11,15,355716,129747,132,59923,427
28,10,18,1,11,1283478,13731,0,0,487
30,22,8,21,23,672263,671063,275,224444,424
37,6,31,5,12,184965,155156,74,3300,533
10,4,6,1,13,1407139,121266,39,0,555
19,5,14,0,13,48329,0,78,10480,617
6,2,4,0,16,49348,0,0,6279,667
8,2,6,2,12,18287,18287,63,11032,565
10,7,3,4,14,419939,42315,59,19131,409
40,3,37,1,5,6046,5500,25,0,520
9,5,4,1,5,241461,976,9,1269,549
14,3,11,0,9,8000,0,8,813,621
10,6,4,3,17,164303,165158,3,4007,500
10,6,4,4,15,676849,149748,63,36200,524
9,2,7,0,16,33143,0,0,1350,654
13,3,10,3,6,21501,19576,67,1505,464
29,5,24,2,6,22404,3541,8,2995,598
17,6,11,2,9,937250,3453,0,0,439
6,3,3,3,13,154642,154642,52,124367,413
16,5,11,0,15,122114,0,28,1070,534
49,26,23,11,28,746534,694806,328,1279,446
11,6,5,2,6,11740,1501,31,4730,498
8,6,2,4,22,336518,19717,55,0,514
23,8,15,4,15,98904,80016,87,43225,454
13,5,8,8,10,273442,218954,13,90817,445
22,13,9,11,20,457784,148246,211,60311,449
11,6,5,5,7,59298,10027,119,1428,394
17,7,10,1,9,45826,519,165,1205,475
62,11,51,4,13,164389,36731,43,21028,471
13,4,9,3,7,36867,4711,64,147,488
8,4,4,3,15,275618,28913,137,14196,633
6,3,3,2,8,12101,5908,3,2327,425
9,5,4,2,12,388324,27492,117,17538,515
23,7,16,5,7,37756,51217,248,12768,475
22,13,9,1,69,172537,4817,123,4942,576
27,9,18,3,14,55683,11369,19,9186,411
71,3,68,0,6,5971,0,0,0,601
24,8,16,8,8,366449,41920,392,10269,375
12,3,9,1,5,383790,1231,2,1231,397
9,5,4,1,45,7997,3369,8,6738,469
15,3,12,1,8,262384,5226,2,305,546
82,8,74,3,8,37578,33314,46,3040,499
8,5,3,3,10,230980,121991,54,62770,472
4,2,2,2,12,17636,17636,50,9329,482
32,11,21,5,17,721457,184380,94,166390,521
15,6,9,2,12,466102,8920,42,8542,527
37,10,27,1,10,659288,6210,18,4839,477
10,4,6,4,11,67416,22238,103,12984,455
11,3,8,0,9,10616,0,16,2076,466
5,1,4,1,2,6507,2447,93,3959,481
16,8,8,6,10,80620,77812,6,4157,514
19,7,12,6,14,20119,48979,93,42706,460
5,2,3,4,7,43075,78934,64,39116,420
11,5,6,2,7,33076,16763,48,27,559
46,20,26,6,12,432084,81717,464,37375,422
24,14,10,7,21,95872,54026,49,4778,466
14,7,7,5,14,72733,90115,147,37247,444
12,8,4,6,9,263838,91988,113,2524,545
19,12,7,0,4,735968,0,0,0,461
27,10,17,5,6,96961,40074,103,17485,529
19,10,9,10,9,395459,1012442,18,18190,415
6,3,3,0,8,18014,0,0,0,574
11,8,3,0,12,60191,0,2,2238,569
30,9,21,4,11,78125,40569,82,9531,447
23,7,16,2,14,183085,1023,13,692,512
7,5,2,3,18,30898,21570,52,0,460
8,6,2,4,2,14031,346,19,3319,446
10,7,3,4,11,140802,90350,60,0,460
22,8,14,1,69,117877,48,11,2669,510
5,3,2,1,3,9948,428,124,753,489
69,21,48,9,9,547781,36114,97,12697,430
18,6,12,0,7,10270,0,206,4548,461
6,3,3,1,14,16168,6435,11,0,441
7,4,3,4,5,9690,9690,50,3178,536
22,8,14,3,6,110353,4232,165,2694,410
31,3,28,5,9,19135,29251,115,9923,393
40,10,30,8,34,10457778,299918,34,4674,514
9,4,5,1,18,236365,12109,27,0,660
12,4,8,5,10,483867,84743,155,55318,571
25,15,10,1,16,941387,1010,14,1010,497
8,6,2,2,7,43719,17596,27,14022,519
6,4,2,2,9,219774,179519,0,0,487
19,8,11,8,8,65388,86052,148,2650,461
10,2,8,4,5,27593,32308,56,21644,517
25,6,19,4,9,36771,24079,194,7782,476
38,5,33,2,8,57787,343,25,1455,587
61,22,39,5,16,427574,7973,50,2424,466
33,13,20,5,27,137619,17008,331,8580,490
7,3,4,3,9,66159,66159,130,12806,417
10,4,6,1,8,20399,4758,44,4758,673
23,6,17,0,21,39968,0,30,107021,548
6,4,2,2,13,20260,15905,21,1397,445
440,12,428,0,10,9857,0,4,132,592
14,5,9,6,8,890721,901675,134,0,439
23,9,14,9,9,51651,56699,441,20175,433
20,11,9,9,13,181304,149471,138,15357,487
7,1,6,0,8,0,0,7,488,685
6,3,3,1,14,36814,36814,23,36814,552
8,2,6,4,9,106563,176662,57,55854,466
24,3,21,1,6,111278,17452,96,17452,721
4,1,3,1,12,7114,7114,44,2820,489
6,4,2,0,2,8589,0,3,403,541
14,8,6,2,69,271977,8576,133,14400,500
13,7,6,0,12,326536,0,14,0,609
5,2,3,0,6,11713,0,32,4765,443
22,10,12,2,23,400770,979,9,6164,537
38,17,21,1,12,1857270,1519,33,1519,406
8,2,6,0,4,9170,0,0,0,546
6,2,4,0,6,791313,0,0,0,677
27,8,19,3,15,161263,3246,25,2477,474
28,15,13,19,11,218484,184692,173,14031,373
10,5,5,0,21,155847,0,7,0,638
10,6,4,5,8,373046,361151,26,345755,423
9,3,6,1,5,13775,943,8,943,546
7,4,3,2,17,9009,9127,27,1789,496
5,3,2,3,7,368444,37495,23,596,565
6,4,2,2,12,2391,2161,60,15244,460
31,4,27,2,14,260371,2422,157,3881,467
15,5,10,0,8,385758,0,0,0,590
16,4,12,7,13,1381011,417311,0,1642,457
15,7,8,2,18,147056,16406,13,0,534
12,7,5,3,10,51791,35920,122,11504,510
13,8,5,0,12,946814,0,19,0,667
14,9,5,4,5,218616,10084,14,3439,464
47,15,32,2,19,45721,13406,46,12254,471
16,2,14,2,18,11309,11309,31,4170,584
40,13,27,9,14,84958,83855,213,37876,413
19,8,11,4,8,29345,15513,35,4129,481
10,4,6,1,21,69911,9143,44,42098,506
6,4,2,5,9,22893,43021,74,12572,610
9,3,6,0,8,24676,0,0,0,674
7,5,2,1,8,452,452,53,452,569
3,1,2,1,9,2229,2229,21,2229,591
5,3,2,2,8,12039,22938,32,0,522
20,12,8,8,14,887444,185258,144,39119,429
6,4,2,1,14,968,393,16,0,513
7,3,4,1,7,3857,2598,25,2598,626
4,0,4,0,17,0,0,0,1048,524
24,15,9,14,24,410952,345397,248,106363,481
7,4,3,3,8,344103,172470,51,274,615
4,2,2,0,6,10194,0,7,0,655
13,5,8,3,8,137183,22939,46,2526,453
7,5,2,4,5,8028,7293,58,2125,519
56,11,45,3,9,985009,327,71,3019,429
7,4,3,2,18,18780,14070,0,0,586
68,25,43,10,14,440994,103335,445,37887,491
5,3,2,1,12,20044,20044,6,1350,539
40,20,20,0,9,831252,0,0,0,612
4,2,2,0,4,23,0,9,0,634
43,5,38,2,10,23247,4159,70,4719,465
33,10,23,1,8,204003,495,8,3300,586
15,7,8,2,12,704947,9018,17,0,472
16,8,8,2,8,299828,5475,100,1066,514
18,8,10,7,10,199119,169243,32,1030,545
30,12,18,2,18,845066,28504,34,27731,514
5,2,3,2,7,16182,16182,112,14506,486
22,8,14,9,23,482424,705685,149,371255,468
16,5,11,2,15,26061,26061,53,22621,496
57,10,47,8,14,98006,71036,127,32363,455
36,8,28,5,12,38849,36229,55,1277900,489
13,5,8,2,5,29821,1458,17,1326,475
16,6,10,2,15,550768,6813,28,35148,628
12,6,6,4,8,408065,47114,41,16900,435
11,3,8,1,13,226103,53743,6,3276,456
9,2,7,1,10,507,507,24,2668,539
4,1,3,2,8,4891,13681,16,4345,468
16,11,5,4,16,644311,114107,81,98619,476
24,8,16,5,12,305528,40455,38,3191,521
67,8,59,6,16,143601,51489,259,7613,437
8,5,3,4,13,597726,29435,43,25541,497
14,4,10,2,9,357505,1581,43,2634,402
46,15,31,5,18,297644,42135,40,17981,475
17,15,2,0,8,246783,0,3,1315,517
44,6,38,9,17,95108,100683,316,45507,454
26,10,16,2,16,278724,31904,172,26904,459
6,2,4,3,7,12353,12353,45,8704,444
29,21,8,8,6,276719,17506,35,7378,421
19,3,16,1,7,9871,5662,60,4362,508
9,4,5,0,8,4094,0,0,3704,600
10,4,6,5,14,204343,34769,40,13562,505
20,9,11,1,9,8070,1429,50,0,520
4,2,2,0,8,861,0,0,0,624
16,6,10,1,24,466476,42510,21,42510,574
14,10,4,6,11,79407,112501,143,0,454
18,10,8,0,19,370803,0,0,0,680
14,11,3,6,7,563981,128060,36,859,466
5,2,3,2,11,15796,15796,24,8853,467
9,3,6,4,7,92817,127074,48,28454,564
18,7,11,1,10,25571,1084,67,449,439
42,7,35,2,16,28401,23875,46,3746,510
39,9,30,7,8,28976,16353,463,3102,509
26,15,11,2,12,49958,2136,52,3307,500
4,2,2,1,8,14461,14461,6,14461,556
18,6,12,4,7,11668,10780,87,5956,519
14,6,8,3,4,31737,6799,34,5953,463
30,21,9,14,15,222112,212946,315,199,507
18,5,13,3,7,4061,663,369,889,524
170,8,162,4,8,36414,21065,79,0,514
29,4,25,1,8,200482,1141,72,8050,569
6,1,5,0,5,0,0,42,1077,577
11,4,7,0,13,240794,0,6,3846,672
20,8,12,0,9,67618,0,10,1090,701
28,8,20,5,18,77666,26679,137,22731,425
17,11,6,1,9,314861,1202,1,1202,471
14,9,5,1,9,93978,556,2,556,571
10,3,7,2,11,32623,10063,23,2806,502
3,0,3,1,3,1566,1566,9,0,581
8,6,2,6,8,6396,7618,87,4071,469
17,11,6,12,7,147234,97532,180,1928174,422
16,5,11,2,8,121783,14785,23,3990,473
26,12,14,0,13,1102048,0,1,0,711
8,4,4,1,12,236252,7384,21,0,602
24,9,15,1,18,407575,1501,42,0,520
14,7,7,2,7,76639,902,12,1491,624
7,5,2,2,10,230876,28676,13,14338,501
29,14,15,7,10,919841,273305,218,161444,466
15,7,8,5,11,82262,63967,123,19289,481
50,13,37,13,14,407885,118509,133,16924,474
11,8,3,6,7,39122,31668,110,12897897,413
13,2,11,3,13,32157,25151,18,18514,562
13,7,6,6,19,814677,51037,145,14069,465
10,2,8,0,6,62911,0,0,0,572
14,7,7,5,11,65644,59590,60,19817,493
10,7,3,2,5,233581,6046,5,3612,514
33,10,23,2,10,112516,686,37,441,572
31,5,26,3,7,310550,32887,62,10844,479
12,6,6,1,10,404312,91582,40,0,494
18,12,6,0,7,155452,0,2,447,512
31,6,25,5,12,60162,37125,98,4797,541
7,5,2,0,6,31413,0,1,0,422
23,12,11,10,8,77541,75068,145,34142,382
7,3,4,3,15,414741,171053,38,3350,481
20,5,15,6,19,137508,181685,200,29462,471
17,10,7,0,8,140515,0,0,0,635
5,1,4,0,11,0,0,0,489,648
12,3,9,0,18,95527,0,1,0,685
13,7,6,4,14,30770,22750,33,13030,458
35,3,32,3,12,41788,41788,166,40860,554
21,8,13,0,7,545753,0,3,0,643
37,19,18,0,13,2275697,0,1,230,522
9,3,6,0,17,58460,0,1,367,677
25,10,15,4,10,298476,21406,37,6723,444
5,2,3,2,15,635496,165224,35,4865,436
4,2,2,1,4,121469,501,6,0,536
3,1,2,1,12,0,10742,25,0,655
4,1,3,1,13,316617,10606,6,0,662
12,2,10,1,9,48180,8640,4,3449,508
6,3,3,2,14,119131,13002,29,0,480
22,12,10,1,19,86271,3249,32,3249,483
5,2,3,1,5,18554,2820,5,0,636
37,5,32,3,18,49547,33327,100,10923,513
37,5,32,5,11,396279,20799,41,4459,473
7,3,4,1,10,9216,9216,91,9216,380
38,8,30,5,16,92507,44592,149,14132,425
5,2,3,2,17,26567,26567,42,26003,504
6,3,3,1,11,18209,3789,2,3789,546
10,3,7,3,8,1046,14550,177,11699,590
12,7,5,3,14,177984,177984,59,32674,556
16,8,8,5,14,98736,67816,62,43866,474
34,8,26,2,12,452490,11894,75,18763,474
8,4,4,4,14,20767,37799,53,5068,459
11,9,2,4,15,14553,14487,82,3978,447
2,0,2,0,2,0,0,1,334,582
26,15,11,0,14,98163,0,1,2694,600
17,4,13,3,14,72086,106258,84,65838,571
29,3,26,2,4,28514,546,20,1368,449
12,5,7,5,6,34273,34273,170,14635,450
48,9,39,5,17,684097,27661,329,22043,465
20,14,6,3,13,563764,149189,38,4242,544
18,8,10,7,6,85441,94634,226,53877,444
32,5,27,1,14,455555,800,3,5975,432
21,8,13,10,8,192250,150669,185,26904,464
10,3,7,0,7,65483,0,26,4591,521
8,4,4,3,13,7976,7891,23,6851,571
16,9,7,6,10,55184,42731,46,16671,449
28,15,13,0,16,685801,0,9,0,670
15,6,9,8,13,338280,86699,48,8384,495
7,5,2,3,6,263864,43746,41,0,444
13,9,4,4,15,247937,16811,160,8198,425
12,8,4,5,10,19603,16956,123,7270,489
30,14,16,9,23,1362577,1109481,0,0,496
14,6,8,0,4,4185,0,61,6945,508
21,15,6,0,8,245814,0,0,0,681
6,2,4,0,10,16359,0,0,0,590
15,5,10,1,5,36461,5600,24,6600,576
5,2,3,0,1,32725,0,0,0,591
13,6,7,5,10,250282,26490,53,14704,480
4,2,2,0,4,69425,0,0,0,648
23,6,17,0,19,16033,0,105,16875,559
10,4,6,1,21,385704,42385,78,42385,564
31,17,14,5,9,477982,13296,41,7462,582
12,5,7,1,22,195399,135,30,0,480
28,9,19,3,31,163977,24383,121,23144,448
30,15,15,5,14,500754,158914,38,0,541
19,7,12,1,17,26210,1250,46,5341,549
57,5,52,4,10,30456,37585,89,12540,469
14,6,8,5,17,172530,51241,88,88116,496
19,14,5,0,25,190332,0,0,0,561
8,1,7,2,7,11075,8700,0,0,618
3,1,2,2,8,7447,9724,26,7447,495
10,3,7,4,8,35212,51643,85,0,621
14,3,11,2,9,23914,15700,92,17459,426
5,3,2,1,3,8100,13006,26,0,514
9,7,2,0,9,54553,0,5,0,600
35,13,22,1,11,33282,10530,50,13030,562
18,6,12,3,11,20049,19460,51,9952,496
9,7,2,1,9,62108,13627,19,13627,659
14,9,5,4,14,102813,5946,48,1059,452
18,8,10,1,14,383919,7662,13,7662,467
10,3,7,2,20,1546,59047,0,1025,589
5,2,3,0,2,40972,0,0,0,641
47,12,35,3,12,789669,9697,18,0,480
14,8,6,1,2,380673,11978,15,447,581
7,4,3,3,12,619613,31091,132,20013,413
5,3,2,2,14,9465,7493,27,6225,439
26,17,9,6,21,196382,50133,150,7546,465
11,2,9,2,4,44294,5381,62,4500,531
12,3,9,3,14,17029,19503,19,15392,517
24,10,14,7,10,118149,114247,119,25883,395
14,6,8,3,7,120281,8422,32,2200,480
15,7,8,5,12,34500,21698,51,10997,430
9,3,6,3,8,11824,17989,119,9551,481
5,2,3,3,9,10278,9979,13,5204,401
13,11,2,0,5,312589,0,0,0,533
8,4,4,2,9,228452,2833,0,0,503
31,12,19,4,13,61096,35874,91,16370,430
11,6,5,7,13,53381,59835,333,22526,475
10,3,7,3,11,27674,18890,97,15592,407
35,7,28,1,12,416855,6458,13,6458,519
20,6,14,7,9,175308,126266,133,4974,451
12,7,5,5,15,30430,30430,182,13310,432
10,3,7,2,8,18315,4860,23,3470,550
136,6,130,3,7,37074,15048,92,12953,460
29,15,14,1,22,356269,836,0,50,545
30,20,10,0,21,1165140,0,0,0,651
6,4,2,0,10,2693,0,6,332,661
11,2,9,0,20,1,0,0,0,708
71,8,63,10,17,48775,55064,198,10185,449
17,6,11,3,13,14849,8813,56,4060,498
42,21,21,5,34,246871,93060,111,2537,506
72,9,63,2,17,290416,20917,177,20668,587
6,2,4,1,7,23053,715,21,0,495
10,4,6,3,5,15770,14540,138,3035,441
6,4,2,4,7,28331,14199,103,2845,531
34,17,17,0,22,1810416,0,26,0,636
16,6,10,1,7,1099402,2059,17,0,500
7,3,4,0,2,56588,0,0,0,614
18,12,6,2,16,100580,40780,47,25395,579
8,3,5,0,7,28882,0,0,0,702
20,8,12,3,18,66007,31027,24,38697,464
13,4,9,4,9,24005,31447,64,11864,498
8,4,4,3,8,387173,20200,8,1747,462
13,6,7,2,8,63506,16160,129,2254,511
26,6,20,6,8,99207,73117,167,19607,449
22,11,11,6,12,63054,7864,109,2455,441
7,5,2,2,7,37321,36974,40,0,498
14,11,3,9,20,170843,179375,86,61010,459
18,4,14,3,19,25203,18303,185,7726,491
19,11,8,0,15,200326,0,6,0,448
20,9,11,8,8,27414,26804,424,19646,504
7,4,3,0,9,10799,0,0,874,585
32,14,18,0,13,790291,0,35,0,615
23,11,12,5,14,247161,77143,0,0,494
6,3,3,0,5,76148,0,0,0,584
20,9,11,2,7,106600,4019,8,2402,440
9,0,9,1,5,431,431,8,4234,651
17,7,10,2,13,33762,7393,128,8335,514
16,8,8,4,13,12807,7627,60,22578,492
12,5,7,6,13,111856,68383,146,6691,509
16,4,12,5,8,703492,636690,62,254,560
14,9,5,6,8,192129,54899,141,16906,456
12,6,6,4,10,131751,14719,20,2448,465
130,17,113,9,14,210749,79766,93,24617,439
13,5,8,1,13,55625,153,1,0,634
39,8,31,6,9,52927,59225,113,26211,431
8,1,7,2,7,18748,18748,29,20000,504
5,3,2,4,5,21755,19147,52,11518,515
45,8,37,6,8,97551,13908,208,25830,449
73,10,63,8,14,601317,584178,111,3142,520
21,13,8,0,15,235192,0,9,69,693
20,7,13,1,14,106007,9380,71,71117,506
19,6,13,0,20,448275,0,9,3297,697
37,11,26,3,11,175856,22809,62,2516,446
8,4,4,2,10,13802,9547,47,5521,549
6,2,4,1,4,55893,24380,0,0,511
10,3,7,0,9,4411,0,0,0,655
28,12,16,5,16,2284697,377631,0,0,465
7,4,3,2,10,575710,42676,50,0,494
21,9,12,6,11,45218,35610,353,20084,442
186,9,177,2,10,18288,17103,43,477,465
7,5,2,6,7,46112,48286,16,20662,485
14,10,4,4,9,63746,17303,17,638,483
18,9,9,7,13,137570,30696,73,9178,419
8,4,4,1,14,193281,4969,33,4969,427
9,5,4,0,6,4748,0,4,763,615
6,3,3,3,69,3026,13104,23,2417,477
8,1,7,5,12,6479,13267,35,0,663
107,10,97,3,16,220113,6416,43,0,565
28,18,10,5,21,1268101,136404,54,0,505
9,2,7,0,14,0,0,16,2265,655
12,4,8,2,13,1793,1789,28,6105,415
12,10,2,9,9,848554,848554,0,0,529
15,7,8,6,9,77371,13155,236,3899,492
16,4,12,4,9,28001,27095,315,29223,449
4,2,2,2,9,18211,29775,0,0,542
42,18,24,11,11,666433,239707,190,15501,394
4,1,3,0,8,7373,0,0,355,604
5,3,2,3,13,17883,17882,35,9461,460
18,4,14,1,12,73688,23835,19,23835,449
15,3,12,2,8,14147,5333,81,7144,608
11,3,8,2,15,63249,99153,81,1515,578
27,7,20,3,15,16604,4222,29,1849,447
8,3,5,1,15,193995,12173,35,451,579
21,12,9,10,7,120182,101232,394,19689,489
34,10,24,1,16,416862,14690,5,14690,569
9,7,2,1,8,398405,5350,0,0,447
14,12,2,2,10,59025,4822,21,215,489
33,13,20,6,23,458118,338778,174,0,507
12,9,3,11,10,64204,89053,274,23752,459
23,8,15,6,14,39681,54479,85,14774,513
9,5,4,5,9,109982,109979,2,1250,450
8,4,4,1,7,7635,3056,10,0,517
14,4,10,1,9,18560,2708,55,2708,600
20,8,12,7,9,404669,52990,259,4032,541
22,10,12,7,18,60977,71699,116,3720,493
8,5,3,0,5,9261,0,0,0,679
25,8,17,6,10,500492,96361,38,3225,403
13,6,7,7,7,92941,86659,181,1779226,463
63,15,48,4,13,2055100,100370,131,81867,450
14,5,9,6,12,36343,28708,113,4680,499
13,6,7,6,11,211457,148198,117,75000,458
35,7,28,2,15,327057,27235,66,25639,524
22,8,14,7,16,166626,159423,108,8794,453
6,4,2,4,11,33334,40241,83,0,477
125,4,121,3,12,64602,40333,25,0,480
4,2,2,2,8,13267,13267,50,0,551
17,12,5,5,7,34606,18064,35,3481,537
27,5,22,2,12,103772,45732,55,10581,555
8,2,6,0,9,106455,0,1,0,582
3,0,3,1,3,0,24100,7,0,601
7,4,3,4,12,28211,8943,40,252,478
47,9,38,3,16,292228,6215,48,1657,455
9,2,7,1,7,7960,7960,176,7960,647
13,8,5,5,14,45910,25870,109,14413,396
5,0,5,2,13,0,3533,0,0,622
9,2,7,0,11,29876,0,1,373,587
9,2,7,0,5,55139,0,1,0,677
15,6,9,3,12,13952,9819,34,4603,514
7,5,2,5,7,288848,22447,71,5642,457
10,6,4,0,7,399632,0,1,959,464
21,10,11,4,8,1117434,221489,125,8570,457
12,4,8,0,4,38529,0,0,0,559
6,1,5,2,2,13714,17238,11,15367,424
17,12,5,6,7,360674,25440,48,8104,448
8,2,6,2,17,8583,8583,32,4346,636
10,6,4,0,14,511932,0,3,0,520
15,3,12,0,13,160871,0,2,10929,582
10,3,7,3,17,53885,90739,50,23240,491
23,13,10,8,8,480898,101559,79,33601,404
12,6,6,0,23,61035,0,3,1538,696
15,1,14,8,9,116953,172455,0,0,463
27,4,23,0,10,26403,0,1,326,683
6,4,2,2,6,627615,6783,22,5547,402
10,4,6,2,9,523820,13651,50,4098,571
15,3,12,3,18,162826,162196,25,11486,579
16,7,9,2,14,349849,73535,33,18099,447
14,2,12,1,14,211852,6106,3,6106,548
27,15,12,19,11,218484,188676,110,14031,373
25,8,17,1,12,46292,2695,236,8110,549
21,8,13,1,12,365231,4345,34,3001,471
14,6,8,3,9,63684,25771,11,3020,521
8,3,5,3,14,14048,14048,41,8280,494
11,9,2,1,14,392416,636,58,1502,583
24,5,19,4,14,31541,31541,347,11697,428
10,1,9,2,16,14996,14996,0,0,515
18,8,10,7,13,34154,31515,49,15299,408
74,7,67,5,14,292129,18571,62,4596,484
32,10,22,7,7,149759,68420,125,21737,382
31,13,18,8,9,423114,60198,104,21361,455
12,10,2,4,17,247337,5777,68,937,520
23,8,15,5,9,41544,33604,73,4988,434
12,4,8,4,11,26253,38517,16,3287,568
15,5,10,5,9,14178,14178,103,5078,451
4,2,2,3,7,13135,21216,60,9507,502
6,4,2,4,5,346112,19089,56,512,620
8,4,4,0,6,221960,0,2,492,567
11,7,4,0,3,578953,0,0,0,649
20,8,12,5,26,409635,707008,32,1720,596
9,4,5,1,15,32060,5735,0,0,612
54,16,38,0,23,609815,0,45,9744,522
14,8,6,3,12,17789,3147,19,2444,455
15,6,9,4,3,58365,9210,55,8851,381
20,8,12,6,22,1870385,1832367,95,0,515
17,10,7,2,6,1145173,11009,15,0,472
4,1,3,1,17,2100230,63926,31,342,617
6,4,2,3,8,231985,221536,37,25164,544
7,3,4,2,4,165009,16500,39,2075,508
8,5,3,0,10,36,0,0,0,702
10,1,9,0,16,204400,0,17,4209,654
2,0,2,0,4,0,0,1,3103,614
61,8,53,7,8,319572,65854,155,39685,458
44,22,22,3,21,2459012,57521,92,9559,529
29,18,11,7,13,219603,55725,187,8666,414
27,9,18,7,23,579870,51960,123,24228,534
7,2,5,5,10,22730,25033,45,5904,491
13,1,12,0,8,5822,0,13,562,701
17,7,10,0,12,115015,0,164,1788,561
6,3,3,1,10,605,49544,5,555,643
12,8,4,7,7,201951,260411,334,14948,458
16,8,8,5,14,23168,23168,62,9381,532
6,3,3,0,14,635,0,0,0,609
10,5,5,0,1,34347,0,6,234,577
16,12,4,9,20,398761,245642,134,77988,442
6,2,4,0,4,117004,0,1,25,687
21,8,13,5,14,117514,45755,146,10465,446
17,8,9,3,16,219007,18268,12,16791,499
9,7,2,6,7,42598,35064,126,3700,449
37,12,25,0,30,279131,0,16,1096,674
19,7,12,0,8,681478,0,0,0,557
24,7,17,3,18,689233,7809,55,14982,529
16,13,3,11,14,294721,26934,207,5194,518
10,6,4,0,3,73821,0,2,0,562
4,2,2,2,6,1868,1868,9,5452,460
6,3,3,0,5,2500,0,0,0,616
30,7,23,10,15,77100,70873,384,22875,461
9,3,6,2,14,186060,39397,39,0,486
10,8,2,1,7,580507,1364,16,0,480
73,6,67,0,17,377356,0,25,1717,607
28,4,24,2,8,558166,23836,46,15703,602
27,3,24,2,10,16062,11593,73,2163,546
14,6,8,3,14,42600,36979,178,21662,544
10,3,7,4,12,83502,381506,0,0,418
21,8,13,7,19,651268,28845,88,7989,434
5,3,2,2,11,25911,21160,17,2119,482
16,9,7,1,6,19687,189,6,189,641
14,6,8,4,6,44299,28608,50,13024,448
36,10,26,0,10,159088,0,52,3000,634
5,3,2,2,4,25268,2289,33,0,457
7,5,2,3,11,4750,4750,85,8744,517
19,7,12,7,18,49575,59870,15,14163,466
7,5,2,5,5,13736,15090,72,7160,406
6,3,3,1,13,248055,39786,2,39786,613
6,2,4,0,4,2286,0,18,275,656
13,7,6,7,20,122418,201915,154,108174,414
3,0,3,1,4,0,5049,51,0,506
40,7,33,5,10,205822,14931,138,8873,460
15,8,7,8,17,108907,108907,322,57220,480
22,1,21,1,5,3549,2130,4,2130,494
57,5,52,0,18,471007,0,19,2029,509
9,3,6,3,4,11903,16059,175,15857,501
14,7,7,9,9,95723,89808,150,13409,447
11,6,5,1,7,302035,798,17,998,462
7,5,2,0,6,31449,0,4,0,510
7,2,5,0,10,2444,0,15,3835,683
15,7,8,2,9,116495,35702,25,15933,620
18,2,16,0,19,0,0,5,3038,677
31,11,20,7,12,269162,28004,284,2155,475
10,8,2,2,7,16820,2556,26,1475,545
5,3,2,2,12,481182,90176,17,38293,595
15,8,7,7,12,121912609,121884089,98,111415481,550
6,4,2,4,12,24506,24506,77,12718,385
22,3,19,3,10,46499,46499,179,73318,515
14,11,3,10,7,604759,585343,350,187016,470
17,7,10,8,22,124719,164679,164,15111,430
10,3,7,3,5,24244,4444,15,2948,518
12,4,8,3,23,97751,10991,23,8585,515
10,3,7,2,11,97141,29812,20,3300,530
10,8,2,0,6,55491,0,0,0,649
18,6,12,0,13,755645,0,36,4152,466
22,11,11,7,13,53200,13203,103,1706,458
10,4,6,4,8,27472,25859,229,18625,495
11,4,7,5,14,28992,36763,60,10012,457
18,7,11,2,6,40999,25515,55,3549,528
77,21,56,8,22,486114,51006,155,25627,443
5,2,3,3,17,12902,9908,19,5425,570
15,11,4,5,14,387658,141319,104,1824,469
15,8,7,5,7,76181,59673,116,41421,506
4,2,2,1,13,216083,6505,0,0,552
8,4,4,2,9,8800,7885,196,5606,416
6,4,2,4,5,13771,13771,91,9522,525
35,3,32,1,18,194282,14630,27,482,635
8,4,4,5,13,11342,23399,109,9086,453
6,2,4,3,6,18317,18317,196,7839,462
18,6,12,0,6,85777,0,0,0,580
8,2,6,3,8,22772,19989,114,8227,485
6,3,3,2,12,332168,6677,7,6389,479
10,4,6,0,8,3437,0,19,381,591
9,5,4,1,9,578629,4281,16,415,517
31,7,24,2,18,389374,5032,119,1516,529
10,8,2,6,7,311201,64280,61,11861,401
7,5,2,1,8,3962,2929,36,0,648
20,10,10,3,14,81209,44693,62,52033,442
36,13,23,2,10,329564,2464,73,5745,512
23,1,22,1,8,0,14604,38,4547,526
8,5,3,4,20,335392,11394,16,6226,513
11,9,2,1,7,211532,8165,23,8165,488
4,2,2,0,5,83737,0,0,0,627
11,6,5,2,4,75516,33620,15,30789,545
22,10,12,1,15,256715,1932,15,2898,383
12,6,6,0,7,31233,0,100,847,598
18,11,7,0,10,723915,0,14,0,572
11,4,7,1,9,5222,671,160,1979,407
21,6,15,7,14,8168,8540,74,4675,468
32,16,16,0,69,455353,0,15,1332,518
18,9,9,6,7,223402,19677,73,8484,426
17,15,2,10,14,400884,131912,80,7840,438
45,21,24,0,29,1007410,0,1,0,664
11,6,5,1,7,322260,884,40,892,636
27,18,9,0,6,304430,0,3,148,655
16,8,8,0,21,95909,0,0,0,608
6,3,3,2,26,6446,14274,20,0,491
8,6,2,0,6,17497,0,2,3103,616
21,8,13,7,10,90604,90080,106,18518,458
5,1,4,2,17,4582,14340,38,9758,500
19,7,12,8,8,98038,99486,89,2662870,564
77,9,68,4,14,206682,180382,462,10075,408
14,4,10,0,21,77790,0,6,0,714
28,14,14,2,11,447748,372537,0,0,524
9,7,2,4,7,39545,1979,85,2216,564
5,2,3,1,7,1816,1366,0,0,537
9,5,4,5,13,193267,200880,102,3136,454
9,5,4,0,22,305162,0,2,0,635
14,7,7,2,10,586067,1493,5,0,589
7,3,4,2,17,173822,15957,7,2743,511
23,15,8,13,12,243511,205420,224,19306,502
9,5,4,4,10,70240,28615,86,6505,508
46,12,34,10,9,414739,67785,138,28362,418
10,5,5,3,13,114559,32668,68,45931,482
9,2,7,0,12,7512,0,0,99,579
11,7,4,0,6,446239,0,0,0,597
7,2,5,4,9,18040,17250,70,3600,480
16,5,11,0,10,58728,0,8,0,655
8,6,2,4,7,192249,97161,44,3844,441
9,5,4,1,9,48763,40792,30,1353,567
31,7,24,4,8,115818,70724,72,40754,439
7,5,2,3,6,47772,8676,56,1878,658
221,24,197,12,17,311815,112022,395,9288,455
16,6,10,0,6,90022,0,2,12079,576
8,5,3,3,8,47792,40134,37,21647,609
14,5,9,0,10,572368,0,35,619,455
5,1,4,2,15,21111,46724,36,0,549
13,6,7,6,12,82386,82386,323,14631,467
5,2,3,2,4,1918,1918,15,1132,385
303,19,284,9,10,246869,115306,107,51180,529
15,8,7,0,10,370815,0,0,0,543
32,8,24,1,18,147618,675,36,7897,674
16,6,10,6,17,472633,175939,76,1776,494
2,0,2,0,3,0,0,74,1820,677
15,12,3,0,19,569375,0,12,0,561
13,6,7,2,35,4830,2666,47,3144,475
31,6,25,6,10,298938,72659,362,29484,421
35,15,20,14,15,395099,108595,244,25397,449
12,8,4,0,16,168636,0,0,0,574
17,4,13,0,4,5523,0,0,0,590
13,5,8,1,13,206348,2101,9,6889,524
116,15,101,4,18,95675,48079,108,19214,602
29,13,16,4,9,367338,129862,85,19174,469
15,7,8,6,9,379518,40914,225,10550,488
38,16,22,0,20,672971,0,10,50,667
7,4,3,2,6,11063,8632,47,7280,510
17,8,9,2,13,539415,22490,10,0,495
11,3,8,1,18,63830,29440,25,0,551
10,8,2,6,7,134626,6233,221,1269,440
25,11,14,7,6,89602,88411,239,60934,395
25,13,12,6,13,202805,105109,0,0,456
10,1,9,2,7,1534,2100,88,2003,540
15,7,8,2,11,245800,35976,37,37612,543
13,7,6,5,11,129222,16776,36,7330,474
8,6,2,5,9,48458,48458,76,22363,447
7,5,2,0,5,26950,0,130,6254,583
24,10,14,1,7,89459,449,36,589,477
36,12,24,1,15,440818,59699,37,59699,449
22,8,14,9,14,75756,84896,438,22500,470
6,4,2,4,14,32982,32982,37,20272,467
17,7,10,3,12,291483,22745,18,1350,500
30,3,27,0,6,285744,0,0,0,659
18,5,13,1,18,225255,1086,12,1086,453
6,1,5,1,7,8055,4316,10,0,523
5,1,4,4,9,12739,36205,39,0,478
3,1,2,2,7,18114,25568,33,18114,510
8,6,2,4,19,255458,60769,56,34091,436
17,9,8,0,16,152935,0,10,0,663
58,8,50,2,13,97002,15887,36,10788,491
29,20,9,0,16,2521682,0,20,1696,639
16,6,10,1,23,465068,15649,23,3484,471
11,6,5,1,5,255987,872,23,0,542
21,10,11,5,7,39263,23961,49,14400,389
5,3,2,0,17,0,0,0,0,656
9,0,9,1,7,444,444,16,444,632
36,8,28,2,21,218328,9945,11,6958,459
13,3,10,3,9,23372,20980,82,10861,465
5,1,4,0,10,0,0,0,724,703
25,13,12,9,6,233842,108663,167,43675,394
41,13,28,9,13,77606,28438,252,17018,501
27,13,14,1,12,733139,2167,13,0,657
7,4,3,4,12,180960,174803,100,2198,521
8,2,6,1,5,9116,6656,25,0,502
18,14,4,13,11,164512,121352,24,1400,439
21,5,16,1,16,122084,14396,17,14396,471
9,6,3,4,18,775030,138014,81,0,498
11,4,7,3,22,205858,205858,57,162852,580
12,5,7,2,19,285866,101239,58,4325,567
14,6,8,3,8,19159,9387,84,4529,416
5,2,3,1,11,21849,1287,20,234,589
15,7,8,6,11,15050,11238,27,3745,423
14,6,8,6,19,71018,78177,27,30492,461
9,2,7,2,13,684942,102236,0,0,517
10,5,5,1,13,384395,12677,33,0,527
21,13,8,3,25,853117,70657,0,0,429
15,7,8,4,10,443318,289032,107,178874,446
10,4,6,3,9,33971,42027,26,16564,479
11,6,5,7,8,252520,25627,92,7935,418
13,8,5,6,14,300548,331995,3,53241,498
30,18,12,13,23,477063,298709,87,86282,473
18,9,9,0,14,68887,0,17,2525,615
65,13,52,14,13,72561,54604,285,16086,423
38,19,19,13,14,397226,138003,260,48048,432
10,5,5,4,10,60157,26106,224,11163,474
28,15,13,0,28,1254647,0,26,0,555
12,7,5,3,21,26989,6496,51,0,558
13,6,7,3,10,25886,9620,12,4393,488
5,2,3,1,12,500,500,26,500,612
74,12,62,1,16,580616,4060,7,4060,482
9,6,3,4,13,31910,24565,36,9514,447
10,7,3,3,10,406661,36524,36,11933,466
43,8,35,5,14,523620,190924,20,75152,576
10,7,3,4,10,460257,12666,1,309,478
13,9,4,7,12,118654,77636,110,13672,394
24,13,11,0,16,569935,0,3,0,613
27,13,14,8,12,136826,59936,30,8000,427
18,3,15,5,14,31146,33535,101,23663,492
18,9,9,6,15,372174,73796,83,24568,477
19,10,9,11,10,65212,67022,261,17215,418
12,6,6,3,10,227893,5097,36,3579,551
13,11,2,1,10,361608,188,7,2450,578
52,9,43,2,14,71219,24711,226,75664,487
12,8,4,1,7,19189,136,0,0,587
2,0,2,0,9,0,0,0,0,506
7,3,4,0,3,9091,0,0,0,591
8,3,5,1,9,1838,248,0,0,562
6,2,4,3,4,3276,14056,16,10780,522
9,5,4,5,7,11527,10423,131,8649,427
8,6,2,5,11,371063,203134,108,0,578
49,29,20,9,7,236593,148512,97,51249,451
16,5,11,1,22,146259,146259,27,665,641
5,2,3,2,12,25163,25163,20,17244,624
30,11,19,0,21,1518299,0,38,13570,613
12,6,6,4,13,41988,31786,65,26720,417
15,10,5,1,14,88462,288,23,1949,582
6,3,3,4,4,60755,66272,37,1788,494
9,2,7,3,12,119713,45690,54,0,543
47,4,43,3,6,211245,19560,141,11429,449
42,21,21,10,52,199564,82231,127,34490,391
11,5,6,2,8,230399,9362,7,1154,618
17,11,6,5,18,208711,3366,169,3361,409
10,7,3,1,12,61746,1256,101,2785,446
7,4,3,1,3,56817,3454,9,3455,486
19,8,11,5,16,514244,325791,92,0,459
6,4,2,2,14,9412,9666,30,5000,601
15,2,13,2,9,12673,25345,103,0,544
16,6,10,3,15,218898,10799,0,0,498
24,12,12,10,21,378132,160104,145,35416,349
14,2,12,0,14,13078,0,12,6291,634
8,6,2,1,9,21566,4135,29,2564,464
8,6,2,3,13,31656,10371,65,8410,470
22,7,15,0,10,808976,0,5,0,565
5,1,4,1,13,10150,10150,24,12510,577
12,5,7,2,8,142013,17552,37,0,504
16,8,8,3,10,84414,81473,44,1950,536
32,14,18,1,18,183975,4803,103,4803,609
24,7,17,3,9,41121,27867,155,26034,474
12,6,6,4,4,40152,7401,31,2669,455
5,3,2,3,7,11876,11876,41,2794,428
12,1,11,0,10,0,0,17,1300,698
13,10,3,11,5,97344,88272,253,45975,497
13,6,7,5,13,84519,81248,67,0,494
8,5,3,2,16,425451,176087,38,160682,528
45,4,41,2,9,3286,60568,93,958,549
27,14,13,5,69,564347,70274,68,4822,555
37,8,29,7,10,253530,90433,304,25695,433
10,6,4,3,7,38445,19319,43,8501,457
8,1,7,1,16,738,738,5,2365,417
6,4,2,1,5,22842,4980,7,4980,418
16,2,14,2,10,27064,27064,33,1198,508
8,3,5,3,5,9943,9943,37,4223,390
6,4,2,2,12,8042,1973,31,1643,559
5,3,2,2,14,1454,15824,32,696,552
8,5,3,1,17,76120,2389,6,288,590
39,4,35,3,12,24513,24144,46,14833,398
38,8,30,4,16,120668,16751,19,2564,459
29,11,18,1,2,571649,2797,5,1490,553
14,9,5,8,11,84981,58626,171,21507,542
14,6,8,2,11,15412,10099,58,9702,495
12,4,8,0,8,22650,0,35,1,489
18,7,11,8,13,408819,56241,95,15130,487
8,4,4,2,8,21838,828,9,79,455
7,4,3,3,12,452768,37984,153,22930,484
15,6,9,0,13,307293,0,10,683,543
11,8,3,3,7,34391,12589,32,2083,431
19,2,17,2,13,3535,505,24,5038,580
11,4,7,0,14,457816,0,0,2735,530
7,5,2,4,9,11811,11718,32,7651,404
6,4,2,5,6,18335,27711,193,7100,496
13,5,8,2,13,73711,9939,22,422,453
11,3,8,1,11,6387,6387,20,6387,512
26,5,21,2,11,18090,7715,32,6056,524
57,10,47,9,10,201472,200786,67,3742,415
11,9,2,2,9,292422,84653,34,0,501
13,6,7,3,8,72569,10075,35,9776,483
18,7,11,3,21,141769,100082,0,0,500
16,3,13,2,15,295967,5098,96,8031,503
15,13,2,10,9,306229,39197,99,24258,388
10,6,4,5,8,73698,72674,81,19745,451
22,10,12,3,10,286735,18378,58,0,503
13,2,11,2,6,28189,24189,62,21689,535
17,3,14,2,7,40388,41024,56,20918,525
10,6,4,0,15,209401,0,16,8835,673
17,9,8,0,8,652082,0,7,704,601
10,4,6,3,10,23443,29203,233,7936,516
43,8,35,1,16,131666,11537,90,1066,660
7,5,2,4,2,15480,5763,111,2095,406
35,12,23,10,17,1940655,1850834,212,703931,449
15,5,10,2,8,16529,1166,27,3749,633
7,2,5,4,3,11704,15320,54,4514,543
24,7,17,0,15,381852,0,1,3438,693
7,4,3,3,8,2924,4386,15,1462,628
13,7,6,6,13,77407,68425,80,26522,396
5,2,3,0,11,196164,0,11,0,646
61,5,56,5,19,74627,73480,334,29986,472
8,6,2,5,25,8730,5892,101,971,426
9,7,2,9,5,31443,48692,133,12409,453
6,2,4,1,7,26183,12192,7,0,461
11,6,5,3,7,103281,13908,32,0,447
4,2,2,0,6,30094,0,0,0,628
20,10,10,0,16,2194897,0,1,0,687
11,3,8,4,16,2093426,1051524,22,571397,451
13,8,5,7,9,553125,53776,103,7866,423
19,12,7,1,16,1228206,453,18,747,594
10,3,7,0,9,12670,0,31,2575,610
18,1,17,0,4,174276,0,0,0,621
17,6,11,7,8,40732,42557,181,18116,399
28,22,6,1,12,457534,67,1,3028,463
10,4,6,4,9,65161,67257,85,52598,477
12,2,10,0,12,1935,0,7,2583,728
8,6,2,3,19,60440,59376,70,27106,482
8,2,6,2,8,31304,31304,35,15652,455
13,8,5,1,11,288120,1754,6,0,435
12,7,5,4,18,43521,41597,82,15370,546
11,6,5,3,13,795669,162835,146,16224,523
18,7,11,7,9,16851,16543,78,8585,492
12,8,4,6,14,79839,78322,85,36365,454
38,5,33,2,8,248554,11217,68,0,486
5,2,3,1,10,19363,14362,23,14362,629
11,5,6,1,24,7218,7218,62,12623,451
28,11,17,10,13,226865,33274,320,5993,447
21,7,14,0,9,589281,0,0,0,607
10,8,2,4,1,133907,1734,17,1476,478
18,9,9,0,12,94678,0,61,1458,645
14,11,3,8,7,111783,55034,265,22855,436
15,10,5,1,11,344298,892,24,892,550
29,13,16,2,16,668246,46322,35,0,473
7,0,7,0,13,0,0,0,0,698
13,2,11,0,4,7200,0,0,0,621
17,9,8,6,13,108958,152232,123,37575,423
5,3,2,1,12,92884,90538,95,57379,460
7,1,6,2,11,3124,41794,36,0,633
71,14,57,10,13,329506,77545,54,20939,501
52,12,40,3,19,857434,5240,44,16574,538
7,5,2,5,10,19407,16157,35,11880,480
10,5,5,7,8,115699,86891,0,0,449
7,5,2,1,5,3720,3720,28,3720,579
24,3,21,1,12,29701,10417,17,10417,475
7,3,4,1,11,9263,8928,5,8928,489
3,1,2,3,8,10798,18162,4,10798,526
16,9,7,2,13,1907441,12165,12,0,435
23,9,14,4,10,39975,12433,153,6783,499
19,4,15,0,5,21245,0,1,1468,644
11,3,8,4,9,251,4936,14,616,487
17,9,8,0,30,1176358,0,2,933,718
28,11,17,11,16,603010,99879,294,15319,447
4,2,2,4,8,17693,23200,135,14430,549
18,14,4,2,10,990859,18575,7,13690,477
5,2,3,3,8,16890,16890,192,12643,485
17,8,9,9,7,73329,49847,254,6375,461
9,7,2,0,4,201855,0,0,0,637
13,3,10,2,6,260086,3841,20,0,487
7,4,3,3,8,12791,6226,43,4428,495
13,2,11,1,7,5342,538,14,4788,482
17,11,6,9,6,326576,46030,97,16405,417
6,3,3,2,7,2137,2137,23,587,579
51,4,47,7,11,424735,44134,84,10885,424
8,3,5,3,7,64822,115267,53,3011,386
16,3,13,4,9,100205,31950,40,24990,462
30,5,25,1,15,19667,12052,6,1260,543
12,10,2,1,6,312335,3574,35,3574,412
18,8,10,3,12,30432,7573,32,5993,580
14,9,5,10,7,51143,38653,245,2972,499
17,4,13,2,8,25837,22837,39,14907,548
12,5,7,3,9,105762,149360,113,99294,463
5,3,2,3,7,8048,8048,194,5621,533
32,10,22,0,19,190810,0,4,0,639
15,6,9,11,8,144335,197090,42,15883,438
7,4,3,1,11,26271,92,5,830,569
3,1,2,0,8,0,0,0,0,624
20,1,19,2,8,871,3290,29,1774,608
39,9,30,6,11,27102,17053,123,2680,471
21,3,18,1,15,59838,3106,47,3106,519
44,18,26,10,17,166055,36835,424,4727,502
16,5,11,0,8,76285,0,24,1330,631
17,1,16,2,13,11570,11570,26,9161,489
14,6,8,10,13,137466,331330,203,79173,403
9,4,5,4,13,13217,13217,28,4511,424
4,1,3,1,10,3335,549,25,0,510
18,6,12,3,7,119212,782,319,801,453
15,7,8,8,14,78382,96643,319,35113,446
8,3,5,1,13,545588,4692,13,9162,412
12,5,7,5,9,94279,196621,66,44906,521
35,14,21,3,6,543407,3927,22,2339,419
12,7,5,11,4,170067,287333,136,54583,355
12,1,11,1,17,2854,2854,16,4728,477
42,25,17,9,12,639647,70445,192,34409,426
28,4,24,2,19,668434,20284,32,3725,520
81,11,70,5,15,46734,23589,98,28365,483
7,4,3,5,7,92561,92561,27,27693,421
7,4,3,3,11,47544,33017,78,32618,504
22,12,10,11,10,23839,23258,106,6611,464
9,7,2,0,12,33634,0,0,0,672
15,3,12,5,16,36494,53254,90,0,493
25,6,19,3,10,32593,25504,77,12329,443
6,4,2,2,26,1433095,94301,17,49005,491
18,2,16,2,38,178612,181670,0,0,529
45,14,31,3,19,1212663,17786,72,5602,411
7,1,6,0,9,0,0,0,0,774
6,3,3,2,18,453298,57761,99,2608,464
6,3,3,0,12,12966,0,0,700,736
66,12,54,8,8,84369,76666,241,14390,456
10,2,8,2,8,2151,22839,0,0,454
24,10,14,9,7,38029,34509,248,11470,469
22,13,9,10,17,700452,177205,114,5255,446
10,3,7,1,7,24453,2130,1,1795,539
8,3,5,0,9,45590,0,0,0,697
25,7,18,4,11,31804,6994,129,4080,450
10,2,8,1,7,27748,7785,30,7785,457
29,7,22,1,19,116443,7688,225,7688,561
36,31,5,0,15,8832330,0,26,3030,468
55,8,47,3,39,179537,19458,71,2985,502
5,3,2,3,6,17946,9230,34,706,453
8,6,2,5,11,381352,27327,76,0,451
2,0,2,1,4,0,12670,14,12670,584
16,10,6,1,8,338903,6578,16,0,614
15,7,8,5,13,58648,2890,27,944,535
15,11,4,6,20,27934,8881,37,16704,440
16,7,9,2,6,260673,57440,37,1500,491
12,9,3,3,6,177168,20650,2,3158,472
11,1,10,0,3,0,0,0,0,709
61,4,57,1,7,44493,846,45,1380,537
31,18,13,0,20,1137634,0,5,190,635
8,6,2,3,9,559839,51286,26,0,477
9,3,6,3,6,9442,9442,21,5468,506
35,12,23,0,16,533438,0,29,1548,545
25,6,19,3,11,513485,30668,85,18614,490
40,15,25,8,7,84516,26549,282,8980,501
11,4,7,1,9,77959,1696,33,0,502
16,4,12,3,19,543211,24786,52,1442,647
16,9,7,8,8,34836,37784,89,12795,405
6,1,5,1,9,68570,58428,0,0,482
17,2,15,0,8,9882,0,34,341,600
14,5,9,0,11,310715,0,9,1080,687
10,7,3,7,51,84848,84848,124,38674,442
6,4,2,0,3,42546,0,0,0,605
12,10,2,7,5,978905,31918,29,0,464
18,1,17,2,7,122975,23229,16,0,644
41,8,33,2,13,59452,3678,42,4363,548
15,4,11,3,23,748,92805,68,9848,529
13,3,10,2,5,9612,9612,31,6673,527
4,2,2,1,13,17476,1700,36,0,518
8,2,6,1,8,97478,7191,10,7191,584
14,7,7,5,16,315265,209125,128,8138,451
5,2,3,1,12,390113,2726,10,2726,422
14,10,4,4,12,284903,1803,18,1222,528
26,7,19,1,14,86814,15195,18,2268,454
9,6,3,2,12,262470,7761,9,0,518
4,1,3,0,5,17520,0,0,0,631
12,6,6,6,17,47197,29317,43,10072,480
15,8,7,1,12,71902,31035,9,31086,427
44,5,39,10,9,342926,279382,138,14490,457
7,4,3,5,12,131501,123059,62,2254,479
8,2,6,3,8,1705,110199,3,977,485
3,0,3,0,12,0,0,8,0,642
44,15,29,7,12,623192,96559,123,1792,494
33,6,27,6,6,23536,23536,76,7874,425
22,16,6,0,8,293918,0,0,0,671
23,15,8,10,11,109806,61066,127,15662,417
2,0,2,0,27,0,0,12,1334,665
11,4,7,2,13,909195,45955,25,25427,552
5,2,3,0,7,430,0,0,0,724
5,1,4,0,6,0,0,0,0,742
10,6,4,1,8,20603,2739,21,152,508
60,8,52,1,10,304800,8392,28,299,514
15,7,8,4,7,44650,23210,24,0,491
24,9,15,2,23,2508956,122966,28,0,599
9,5,4,3,7,238833,16301,13,0,439
5,3,2,0,20,49283,0,7,9475,565
69,12,57,11,37,1166008,1036295,213,322254,424
11,8,3,0,12,193207,0,17,5987,606
28,20,8,10,5,446591,15539,80,9340,480
9,7,2,1,4,485324,1239,29,1684,426
5,3,2,4,7,7497,16875,68,876,474
11,3,8,3,12,9415,8395,70,1060,535
33,12,21,3,27,619680,3725,38,275,593
12,5,7,3,8,8579,16983,68,8660,470
5,2,3,3,11,12811,69255,59,12811,552
67,9,58,0,9,166651,0,8,444,677
20,10,10,8,69,858048,289645,137,0,510
11,8,3,5,10,84057,70674,126,2223,469
37,5,32,1,11,307419,6940,25,6940,440
10,5,5,3,14,231432,260499,48,199361,497
6,3,3,0,8,411517,0,23,0,612
49,6,43,4,3,7819,6458,11,4115,467
12,8,4,5,13,129351,9709,46,0,496
5,3,2,0,13,32726,0,2,3042,693
20,6,14,6,14,199909,177589,144,140249,401
22,9,13,2,9,677035,154100,64,3210,433
11,5,6,5,11,85984,85909,161,50485,483
6,2,4,1,7,302,302,18,3117,608
10,3,7,1,13,171955,367,5,0,575
34,11,23,3,15,91399,2831,171,3810,506
14,9,5,10,7,59757,72524,228,18655,405
17,9,8,4,11,82280,167951,103,0,558
5,3,2,0,4,35889,0,0,0,622
10,7,3,2,7,28923,20557,145,57142,531
12,6,6,6,6,60526,57635,191,36066,447
28,11,17,1,14,1736333,221,17,0,627
8,1,7,0,3,0,0,2,1936,605
20,9,11,4,9,38610,26880,164,10126,392
9,3,6,2,10,98781,9850,7,8490,513
17,7,10,4,10,393609,184369,0,0,513
5,1,4,0,7,0,0,8,438,713
20,5,15,4,8,8251,6167,108,1689,492
14,4,10,5,8,58164,60132,114,22552,492
25,10,15,0,10,922408,0,2,0,653
15,7,8,6,26,772145,33205,76,5070,437
18,5,13,6,12,30253,60905,65,1018,509
17,10,7,9,5,15973,20769,250,8770,434
12,7,5,4,7,24841,44523,61,0,583
26,4,22,4,8,73768,38959,82,5090,608
13,10,3,9,12,402787,254714,23,18758,442
7,2,5,4,9,606,27125,46,606,504
14,9,5,0,9,223460,0,27,597,604
3,1,2,3,5,7101,11499,40,3155,614
7,3,4,1,6,232,44918,9,44918,595
14,5,9,2,7,31332,4152,6,3935,481
8,5,3,3,9,470894,89658,38,8004,535
9,6,3,5,6,11816,12970,45,6945,448
16,7,9,3,12,215244,16268,78,2275,559
16,8,8,5,8,23205,14616,43,2805,451
14,7,7,0,12,19044,0,22,1035,438
11,7,4,3,14,82290,64485,24,3907,474
17,13,4,10,14,296652,33293,59,3438,439
23,11,12,0,21,683260,0,10,287,565
20,6,14,4,9,331680,18304,57,10080,419
30,9,21,1,11,4303578,9879,20,614,421
25,10,15,2,8,557884,59989,58,442,439
14,9,5,1,18,3335245,3982,7,594,533
20,11,9,6,15,186786,37812,93,33164,447
36,6,30,4,17,35343,31083,76,16042,467
2,0,2,0,7,0,0,14,0,614
5,3,2,0,4,19854,0,0,0,649
3,1,2,0,14,0,0,0,0,610
31,15,16,6,24,496695,32229,132,12983,524
6,2,4,1,5,428176,3523,13,335,549
26,9,17,6,16,86680,79230,60,34831,423
6,1,5,1,14,618,618,4,1727,645
3,1,2,1,9,0,18851,1,0,663
12,4,8,3,8,9565,8357,31,6000,566
13,10,3,6,2,58666,2519,69,746,472
22,6,16,2,10,517871,203794,13,1822,501
26,9,17,5,28,98891,48402,43,5093,457
14,10,4,7,12,70168,66629,149,29317,438
4,2,2,1,7,5555,3490,0,0,547
13,8,5,0,12,868070,0,0,0,622
15,12,3,12,6,40580,57772,218,6025,404
14,6,8,7,9,26389,44122,166,7763,455
13,8,5,0,10,937691,0,0,1262,675
12,6,6,5,5,25970,2218,91,344,394
7,4,3,0,4,107265,0,8,821,619
19,6,13,3,9,77704,27696,15,2384,464
4,1,3,1,11,31652,736,2,2685,658
9,6,3,2,11,11310,11310,56,9720,541
39,11,28,8,14,140365,68513,135,32464,523
6,3,3,2,13,6977,12608,38,4375,486
7,3,4,2,8,210119,15902,51,11041,536
6,3,3,3,7,13954,34393,19,618,538
49,24,25,15,12,1611148,566145,302,54694,452
10,5,5,5,17,71088,89166,125,50206,544
46,23,23,4,12,480457,15602,20,622,466
7,5,2,5,5,11453,10155,40,2217,404
20,11,9,0,9,174344,0,50,1678,531
20,9,11,4,11,41616,13117,48,7785,457
14,9,5,4,6,193532,52994,32,2480,511
20,9,11,5,11,331783,165744,33,397,474
8,5,3,0,6,17463,0,3,0,624
4,2,2,1,5,5328,992,10,2374,463
26,8,18,11,11,93595,84330,269,20258,451
31,7,24,11,8,172652,190321,181,23452,382
15,9,6,8,8,35748,32363,178,11110,446
20,12,8,2,19,359520,45668,33,40839,480
9,4,5,2,12,6676,5049,25,816,606
5,3,2,0,11,300698,0,0,0,646
5,2,3,2,6,39718,7517,31,0,463
10,6,4,0,8,56039,0,0,0,477
10,3,7,3,10,55678,20399,56,11273,482
19,5,14,6,12,78302,175898,126,0,495
26,16,10,19,13,222984,213554,67,37216,478
6,2,4,1,7,666,666,89,2543,575
10,4,6,1,9,53406,963,15,0,589
9,2,7,1,13,2314,2314,3,2314,448
38,12,26,9,8,130349,49499,37,8951,414
7,4,3,0,11,408531,0,3,2200,562
39,6,33,1,18,189147,17522,19,928,545
7,5,2,0,3,317344,0,10,0,490
13,8,5,10,17,519053,90976,186,26293,438
67,17,50,13,26,815359,176973,166,52108,419
5,2,3,0,4,10985,0,0,775,639
35,6,29,8,12,153887,171947,111,97314,460
37,7,30,2,16,604605,3758,157,4490,534
6,3,3,0,9,8258,0,58,3225,645
11,6,5,0,2,25989,0,0,0,602
30,11,19,4,12,225991,25291,70,59228,408
34,12,22,8,14,392113,60958,28,42911,455
7,5,2,6,14,52672,59384,107,39708,367
6,4,2,0,4,22948,0,16,409,582
15,7,8,2,12,150363,66992,23,21085,472
12,9,3,6,12,65886,61586,85,28309,517
14,10,4,11,12,447884,508769,0,0,460
5,1,4,2,10,216681,144679,21,0,545
42,6,36,4,14,21249,6246,277,3363,499
32,10,22,8,10,127760,47695,379,8709,473
25,13,12,2,12,215125,5827,69,384,532
9,7,2,5,6,210830,52364,115,0,527
47,10,37,0,26,158656,0,15,3488,656
17,9,8,0,8,268497,0,18,358,602
15,3,12,1,16,198104,12307,57,4182,687
40,18,22,10,10,157761,49371,91,11321,418
28,13,15,6,11,525411,17325,109,1878,433
42,10,32,4,16,485492,11839,248,7142,580
13,6,7,4,4,606670,62509,51,6775,409
5,3,2,3,13,211498,211498,64,0,481
4,2,2,0,5,13159,0,2,0,557
15,7,8,1,5,151256,2299,0,0,449
16,5,11,5,29,33786,33078,183,25130,570
8,6,2,3,69,57138,8088,49,5334,422
6,3,3,3,15,26149,2572,4,0,530
12,2,10,1,8,7839,1801,28,3068,496
6,2,4,1,6,35893,26466,0,0,576
58,27,31,1,14,4176896,1278,4,0,644
23,5,18,5,21,53220,43334,113,25266,503
4,2,2,1,14,382011,1616,11,1616,490
10,8,2,2,11,347976,10143,22,2632,477
23,9,14,8,9,65795,65795,140,19566,471
10,6,4,5,4,381661,9760,11,1899,485
19,7,12,1,14,82566,18225,108,27969,462
7,3,4,4,7,12450,16246,0,0,470
19,9,10,2,8,95261,5895,16,4979,450
9,4,5,3,20,27980,26555,58,2693,536
25,5,20,1,6,5673,2605,53,3708,498
21,7,14,8,13,464778,101328,0,0,488
5,3,2,2,3,12182,8736,15,4339,547
11,4,7,1,9,87683,48077,16,5829,499
12,8,4,4,12,163300,47013,72,676,486
12,2,10,0,6,2061,0,34,1509,682
28,11,17,8,9,419961,156056,78,11914,389
10,6,4,0,8,275101,0,6,13312,563
11,9,2,0,7,47880,0,8,1319,471
8,4,4,7,9,188878,294357,5,33306,483
20,15,5,2,27,470713,2008,24,1546,529
17,6,11,2,7,37879,2773,209,4564,451
5,3,2,2,15,8570,8570,26,7911,546
6,3,3,1,9,120685,519,52,3250,516
32,12,20,7,4,138329,20594,131,7184,485
10,6,4,1,5,287031,1382,19,1382,540
63,3,60,1,12,3305,32099,26,908,541
15,2,13,1,9,6321,6321,21,6321,607
34,5,29,6,18,41593,26157,187,10164,548
47,11,36,3,25,718541,41591,49,48416,489
28,15,13,19,7,157423,167395,764,41678,425
7,3,4,2,9,20553,15718,16,15234,508
32,13,19,4,14,215145,36877,74,3778,499
25,5,20,5,12,171041,112634,94,0,512
6,3,3,4,19,50869,63738,80,2130,547
3,1,2,2,9,8564,14652,40,8564,512
7,2,5,1,14,228449,8974,0,0,568
3,1,2,0,10,0,0,1,273,648
16,8,8,7,15,180754,180754,142,9969,432
22,3,19,1,9,2501,3485,50,74041,581
5,3,2,3,14,15617,1746,38,6578,544
13,6,7,3,12,81875,26910,47,8970,443
5,3,2,0,2,13404,0,0,0,587
16,7,9,1,7,42679,147,12,879,569
15,13,2,2,19,489623,103221,4,97887,538
18,6,12,1,8,73623,7535,120,1047655,592
25,9,16,1,21,407975,1630,12,23031,474
12,9,3,8,7,87017,44938,104,24529,440
33,19,14,2,10,492316,30248,66,28359,475
8,4,4,0,7,68967,0,1,0,687
7,5,2,1,10,210054,1547,23,331200,595
33,13,20,9,9,39171,21725,371,5815,431
6,4,2,2,7,11878,10348,33,3032,520
8,6,2,5,8,144137,42182,123,10850,411
15,11,4,0,13,206184,0,1,0,623
7,3,4,1,9,24422,16146,17,0,555
21,12,9,13,7,35557,61244,88,11663,407
7,5,2,2,12,423402,64344,49,47444,594
3,1,2,2,12,1064,602,21,375,465
15,6,9,4,24,225007,145343,89,113431,470
19,11,8,8,11,365907,77354,127,4537,450
8,5,3,6,13,192333,200832,103,0,461
7,2,5,1,9,223120,17235,0,0,628
20,9,11,8,7,16732,16732,449,6120,506
8,2,6,1,5,1,1,163,3928,488
37,7,30,5,8,76564,54564,8,6600,374
4,2,2,0,14,4283,0,0,0,649
49,12,37,0,10,257868,0,6,0,535
49,3,46,1,17,26045,1104,100,3868,587
6,3,3,2,7,30327,28004,27,20425,578
26,5,21,1,8,3685,415,34,2620,553
17,8,9,8,12,58965,28888,29,10764,444
65,8,57,4,28,11850,3293,459,5953,494
12,7,5,0,25,84861,0,5,0,561
5,2,3,1,12,22591,335,4,815,592
9,3,6,0,14,93858,0,2,0,700
10,7,3,0,31,46883,0,1,0,680
15,13,2,7,5,217693,69710,1,824,453
16,9,7,5,17,188284,7724,98,11260,560
20,12,8,4,14,635667,221231,97,172155,446
16,7,9,8,12,381481,123961,127,39126,530
46,7,39,3,18,628106,54004,150,68574,425
33,5,28,1,11,37210,1982,26,1982,465
16,7,9,10,16,140009,138084,62,21721,455
9,5,4,2,8,60699,53555,33,0,673
6,3,3,6,8,17745,25595,95,3563,552
22,14,8,1,10,449800,4100,0,0,459
29,6,23,1,8,90249,18910,0,0,591
49,12,37,0,10,1301748,0,44,2726,625
16,7,9,4,19,20893,46352,161,31506,508
24,4,20,0,2,8204,0,0,2900,599
8,2,6,1,19,269144,2794,16,1909,637
17,8,9,10,14,183403,236418,188,0,446
22,0,22,0,12,0,0,20,0,623
8,5,3,3,6,333694,41988,17,40057,530
7,1,6,1,9,1000,3485,0,0,635
24,4,20,1,18,13916,7330,0,198,538
12,5,7,3,12,28922,1556,7,1325,496
24,5,19,2,9,72411,42607,59,9510,418
8,6,2,4,4,449750,18778,11,0,435
19,7,12,8,9,56043,55711,134,15842,407
72,14,58,12,27,68678,55963,247,16727,413
14,9,5,9,7,46251,56015,127,25856,405
4,2,2,1,7,3312,761,8,0,534
10,3,7,0,14,35008,0,26,0,569
26,9,17,1,10,41638,197,33,5487,399
28,4,24,5,9,17474,23929,178,9632,485
6,3,3,2,13,59472,59472,17,53862,501
7,2,5,1,18,71152,25960,44,0,632
10,6,4,2,9,30427,15505,32,0,590
24,4,20,1,5,9456,1368,1,1368,570
3,1,2,2,9,7973,12430,47,0,529
25,15,10,3,18,1051100,661513,91,2390,469
12,2,10,0,5,495,0,53,3131,570
13,1,12,0,4,39675,0,27,6746,630
22,12,10,0,18,441370,0,40,4754,606
20,3,17,2,19,21791,15383,60,10415,581
9,5,4,1,13,41390,666,30,1062,402
8,4,4,5,6,12850,86140,0,0,554
8,6,2,5,9,399109,56752,63,28816,453
9,4,5,0,14,468894,0,17,42661,600
64,18,46,7,23,218506,35729,349,12309,512
5,3,2,3,6,7818,7818,62,4570,548
18,10,8,2,14,763910,23513,5,2292,474
7,5,2,0,2,48009,0,0,0,580
12,4,8,1,4,26930,3537,91,1766,557
19,11,8,7,16,126017,130328,96,10813,433
20,10,10,7,13,169409,169409,0,0,566
15,8,7,5,5,19526,14610,118,5783,459
28,11,17,8,11,45710,26478,113,12666,415
4,2,2,0,8,148079,0,1,0,677
15,5,10,5,17,14040,23225,101,9900,510
42,6,36,4,16,74722,74722,329,43146,477
15,6,9,0,8,103528,0,9,313,680
16,5,11,1,8,121929,615,22,0,521
43,3,40,1,18,47413,23349,37,23349,578
2,0,2,1,8,0,2631,0,0,575
15,10,5,7,9,135107,59321,291,18387,442
50,19,31,18,10,109261,96896,492,14331,404
9,5,4,0,7,18271,0,16,602,689
8,3,5,4,6,16715,27555,32,7259,392
9,6,3,4,7,10328,8762,129,5734,476
18,9,9,7,14,82277,76388,129,32817,502
25,1,24,2,12,920,6321,14,1377,601
23,6,17,4,11,432357,24226,148,18008,493
37,6,31,2,10,81594,1835,13,15901,446
15,7,8,4,18,264586,122170,0,0,573
5,2,3,0,5,344262,0,17,1168,572
17,4,13,0,6,77400,0,7,1482,554
27,11,16,5,20,337807,33032,90,11213,584
9,3,6,3,7,21874,34462,9,13111,560
19,3,16,1,5,104511,7862,28,7862,623
13,6,7,4,25,110663,109274,114,66773,491
16,5,11,2,12,66171,46746,43,3051,481
58,11,47,6,14,417231,28675,103,14818,439
15,9,6,8,7,136567,130870,129,25183,518
5,2,3,2,8,14662,27969,33,0,546
32,13,19,6,8,113548,29321,343,12350,439
10,6,4,7,5,312345,17099,47,0,494
18,5,13,3,9,26343,14889,113,24672,544
20,3,17,2,10,22074,4379,23,3714,497
3,1,2,0,2,2057,0,0,300,605
28,15,13,17,11,1361565,2197103,247,532766,449
11,4,7,1,19,1842867,8276,58,11394,561
16,8,8,9,15,102747,129617,5,5685,474
30,4,26,0,6,223485,0,6,0,549
56,17,39,7,18,242550,31565,237,14532,453
20,4,16,1,4,69426,8422,2,8422,496
17,7,10,4,12,207780,224141,182,125187,498
30,10,20,6,16,243102,150662,85,22762,359
9,6,3,3,11,298149,13876,67,8069,481
40,11,29,6,8,43754,11259,138,4059,423
16,7,9,2,12,40523,29676,4,9798,581
10,3,7,0,17,57839,0,23,9240,614
5,2,3,2,14,27312,14549,24,11199,478
9,4,5,0,35,326499,0,1,895,563
27,11,16,9,12,777597,112831,220,17419,429
15,11,4,6,21,226525,58860,88,29669,428
12,5,7,4,15,33594,10705,81,1681,566
5,3,2,2,6,280910,27297,57,0,480
28,16,12,7,11,327399,46856,36,9151,446
14,7,7,1,5,229906,1702,37,2620,591
7,5,2,6,11,30795,33384,135,10282,377
6,3,3,3,11,377537,43785,25,38570,461
5,3,2,2,19,116611,54913,23,5980,603
16,5,11,0,4,26031,0,0,0,613
15,6,9,3,15,633310,108297,58,12261,530
7,5,2,5,8,146886,143971,123,0,541
4,0,4,0,3,0,0,3,0,620
16,7,9,4,7,87810,7799,81,2191,408
8,3,5,1,4,13575,3359,12,3359,456
21,12,9,1,12,619796,7348,19,7348,443
45,7,38,5,9,29562,26192,90,8920,452
17,6,11,1,8,46574,515,47,1425,524
30,7,23,2,14,20808,12754,73,3444,457
24,11,13,9,8,109326,100787,188,13559,382
16,9,7,2,14,191504,1898,11,1000,537
16,8,8,8,6,43989,50832,147,17827,546
42,8,34,4,10,242903,8869,20,4888,547
13,5,8,4,16,270646,217487,49,1690,480
24,17,7,11,11,141008,122207,207,19114,443
17,15,2,0,19,408812,0,17,0,485
29,8,21,0,20,277198,0,1,845,700
4,2,2,1,10,4618,4320,24,4320,527
34,14,20,10,14,484451,149642,233,45719,444
4,2,2,0,13,16988,0,0,2628,552
108,3,105,1,7,21724,2540,52,2540,677
13,3,10,1,9,12138,3311,31,3311,601
7,3,4,2,6,2107,954,150,941,517
20,5,15,3,18,213422,31120,213,15172,446
30,11,19,6,7,358342,26045,24,10720,409
8,6,2,6,6,81042,81042,99,11766,392
20,11,9,5,24,144547,8024,36,4197,581
14,9,5,1,10,345159,6608,8,6608,462
21,10,11,2,11,34835,8115,28,7667,434
16,9,7,4,9,49647,15108,33,2662,474
5,3,2,1,3,29478,849,52,3264,551
36,12,24,8,7,128175,26260,117,8860,437
22,13,9,7,14,669223,512607,98,6173,446
5,3,2,3,7,24766,24766,0,0,460
9,3,6,2,5,16222,12043,108,10172,531
9,3,6,2,18,235090,9582,9,5280,519
6,1,5,0,2,0,0,152,5123,434
58,27,31,10,21,580768,65812,145,1960,466
29,23,6,2,9,560319,17726,28,17514,486
24,8,16,8,13,74724,60478,171,29535,452
55,13,42,0,24,1142189,0,1,23892,675
6,4,2,4,19,1121144,144628,58,13445,461
56,3,53,0,8,30324,0,145,3125,501
8,6,2,1,9,39618,2718,1,2718,422
10,7,3,5,14,69664,63822,57,31943,516
73,12,61,9,13,124913,77249,209,17490,459
7,4,3,2,13,37127,28781,0,988,677
11,5,6,4,10,32008,21318,117,5358,455
6,4,2,2,12,59602,43731,36,13391,509
22,15,7,0,18,358200,0,1,0,711
5,2,3,0,2,8766,0,4,0,647
9,5,4,5,9,165486,140014,425,47658,504
18,7,11,0,15,1141612,0,9,0,562
9,5,4,1,19,239571,622,5,622,520
85,5,80,3,8,19566,29743,24,2088,421
12,9,3,11,6,58840,78645,183,16108,449
24,14,10,7,17,252379,103068,81,348,453
16,4,12,2,8,43981,9689,94,10422,504
9,6,3,3,8,281493,17185,6,0,461
9,6,3,3,9,276322,14768,22,12565,484
16,10,6,4,5,423922,30248,70,5958,448
7,1,6,0,12,1348,0,0,3080,645
25,13,12,10,11,211562,187611,64,42532,422
20,7,13,0,19,168062,0,2,0,628
10,3,7,1,12,17341,1557,27,1557,633
16,7,9,0,12,449052,0,0,0,592
8,4,4,3,19,18071,4277,46,2970,506
16,9,7,2,12,791692,44324,55,0,446
28,7,21,6,9,155634,166309,0,0,439
16,9,7,1,13,179605,7057,15,0,402
50,4,46,2,7,5357,5357,27,4501,469
8,3,5,4,7,57376,32217,59,2099,506
31,9,22,8,14,72528,49229,161,19730,471
18,8,10,0,12,307520,0,7,394,589
8,6,2,6,6,31600,23688,134,1035,416
9,3,6,0,7,11820,0,29,885,646
16,3,13,4,10,33830,33830,247,20043,466
11,2,9,2,9,6216,6216,24,3108,491
17,10,7,0,15,578867,0,1,3290,632
15,8,7,2,5,31715,4616,48,3076,524
10,7,3,4,7,204914,204314,122,16341,439
4,1,3,1,6,4930,4930,0,0,493
18,7,11,0,18,54818,0,23,1400,590
16,7,9,7,9,100281,114485,137,13528,469
15,11,4,9,13,905748,226855,97,41431,409
16,9,7,5,13,68651,27863,106,14294,466
8,4,4,6,5,375564,515395,103,191581,510
34,15,19,7,10,222153,63672,70,0,469
4,2,2,1,28,0,11406,29,0,666
10,5,5,0,11,34531,0,0,703,619
17,12,5,1,2,73107,8793,20,265,533
12,5,7,1,9,76490,9,43,0,588
13,6,7,4,19,238495,84939,67,0,606
15,3,12,1,19,279808,159118,244,2711,543
17,8,9,11,8,1017858,978818,51,230453,446
7,5,2,2,2,89264,8518,7,5342,454
34,5,29,0,9,190537,0,26,46777,570
21,7,14,1,11,328595,210,0,0,557
7,4,3,2,9,48475,12468,1,6371,478
6,3,3,2,5,341126,17313,39,0,579
16,7,9,9,13,203876,150377,48,26588,451
16,6,10,4,7,26394,1041,26,445,614
14,10,4,1,12,746477,3246,33,3246,436
10,2,8,0,8,3363,0,127,521,662
13,7,6,6,14,95133,88765,75,3768,487
17,4,13,0,25,14201,0,20,0,693
8,3,5,2,10,7576,1930,75,1528,474
23,7,16,1,11,135360,10491,20,524,536
21,4,17,4,14,12631,5971,65,4871,482
41,16,25,8,69,51441,16996,133,2850,446
19,7,12,3,8,212525,5669,90,3367,497
79,16,63,10,12,676606,543343,135,311031,434
8,1,7,2,5,12420,12420,37,8510,462
4,2,2,1,12,6141,1700,13,1193,526
29,8,21,6,6,39298,23786,119,4333,472
12,5,7,0,14,642192,0,5,0,611
4,1,3,0,3,485,0,6,0,607
7,3,4,3,12,8072,4380,27,512,439
28,2,26,3,14,8395,16883,33,1261,520
5,2,3,0,6,19157,0,0,704,622
16,8,8,0,6,974653,0,6,0,628
9,7,2,4,16,439869,61330,47,1052,468
10,4,6,4,21,13705,26495,59,691,612
34,19,15,12,8,610158,90964,37,20990,420
37,7,30,1,14,71024,24954,6,24954,480
14,5,9,1,7,30657,4454,19,4454,491
10,5,5,2,4,12054,1742,23,542,454
7,5,2,0,6,140488,0,8,0,520
15,6,9,4,13,8567,8567,209,2834,530
33,5,28,5,17,57057,22707,194,8832,413
52,11,41,0,14,67350,0,281,1525,533
6,2,4,2,3,45254,45254,19,44818,439
13,6,7,4,12,91073,39108,56,2137,466
3,1,2,2,10,8285,11243,0,0,497
8,2,6,1,4,9904,7486,59,7486,611
29,8,21,6,12,362312,52779,86,10837,481
14,5,9,1,11,63717,2974,42,2471,533
13,8,5,7,12,22061,55577,6,2737,419
9,6,3,0,4,204446,0,0,0,597
17,7,10,5,12,11387,106204,69,1088,474
8,5,3,1,12,539476,36468,5,36468,482
15,11,4,2,8,294773,5320,23,4979,438
6,4,2,4,12,38605,16930,50,7900,414
4,2,2,4,6,13939,14492,35,0,444
24,22,2,12,11,584480,43850,28,8943,402
15,3,12,4,12,4762,9952,64,3146,454
51,9,42,0,15,133524,0,0,0,634
8,4,4,3,7,55063,55063,52,45894,538
17,9,8,0,14,650519,0,0,5443,629
17,5,12,0,4,42068,0,0,0,618
26,13,13,2,19,1091241,1154,5,1108,520
11,3,8,2,14,124860,124860,40,7033,575
29,11,18,6,13,269135,72120,2,599,466
22,5,17,0,8,259619,0,8,9455,476
8,4,4,2,20,14254,10508,27,3423,523
26,8,18,0,13,69183,0,1,640,595
25,8,17,4,4,29184,17292,11,7608,425
3,1,2,1,15,10610,1917,3,0,486
24,7,17,0,8,140315,0,0,1170,688
5,2,3,3,7,22470,54990,59,0,586
8,5,3,7,16,77344,307203,117,28289,533
12,9,3,9,5,40744,39184,75,5439,374
22,9,13,8,18,181770,174953,150,130080,404
12,4,8,4,9,22152,22152,259,8117,431
11,9,2,0,8,168875,0,0,0,495
11,7,4,2,69,134621,386,33,517,588
7,3,4,2,9,24436,23664,39,21924,505
16,6,10,0,16,705239,0,2,1703,663
6,4,2,5,15,17459,26954,73,8311,561
29,5,24,1,8,14586,4672,0,0,491
45,17,28,2,26,1293505,80066,53,2200,459
8,4,4,1,8,58884,6974,0,0,465
13,3,10,2,8,27952,54763,39,0,535
34,16,18,9,9,399095,143024,94,3503,415
14,7,7,1,10,1144683,945,69,3720,475
31,4,27,3,6,4399,3651,52,1736,487
20,10,10,8,8,183715,62068,205,16412,478
22,15,7,10,25,904561,820613,82,5660,418
12,1,11,2,17,44,56683,24,10224,606
14,3,11,2,12,395183,19509,67,10205,491
6,4,2,4,9,20570,20570,42,5816,483
6,2,4,2,7,6946,6946,31,1310,551
3,1,2,1,8,5855,5855,8,0,655
9,6,3,7,8,62203,69172,129,1726215,460
8,4,4,4,12,337964,41409,38,0,508
15,9,6,2,12,363708,5633,11,13342,473
36,4,32,1,7,272319,115814,25,0,538
21,11,10,6,8,231085,10227,125,4675,401
7,5,2,5,7,10117,17498,97,7381,540
12,7,5,1,17,232675,12909,12,12909,520
18,3,15,1,13,387791,26453,0,0,536
14,5,9,2,20,574282,16772,123,11450,514
4,2,2,1,3,9040,3445,15,1845,558
20,9,11,3,11,1632849,101534,76,89905,446
3,1,2,1,14,5465,2490,25,12779,520
45,20,25,10,10,184347,45272,312,6782,447
13,6,7,7,17,51020,186119,129,39412,471
4,1,3,1,5,5656,4866,7,0,657
9,6,3,0,7,56409,0,5,220,635
18,10,8,0,16,521834,0,23,0,539
9,3,6,0,10,49644,0,18,5123,521
51,10,41,5,14,503443,22915,124,2044,492
13,7,6,0,21,223253,0,2,22979,597
26,15,11,1,16,853993,797,31,1120,480
11,6,5,0,16,87095,0,0,0,692
20,10,10,1,12,347575,9919,3,1494,399
19,8,11,1,11,2180273,7240,8,1487,516
6,2,4,3,6,89051,81953,43,6452,514
8,3,5,3,12,50666,23921,52,17139,493
31,6,25,5,10,297180,36020,120,414,499
25,8,17,5,20,450321,130375,113,10000,476
10,4,6,4,5,1540,7909,19,808,523
11,7,4,8,6,132297,132547,41,39219,396
12,5,7,7,17,16393,31777,94,2532,465
38,6,32,6,28,179208,194919,76,53802,443
25,10,15,2,27,452344,316581,102,0,687
32,5,27,2,6,21483,11239,15,10224,501
17,5,12,6,18,400634,329519,106,160582,467
19,11,8,0,22,310676,0,1,40,707
9,6,3,5,13,58005,58005,100,18832,429
11,6,5,5,7,22053,13956,404,11595,480
6,3,3,4,14,37774,47838,50,26364,556
16,8,8,5,11,88716,7301,68,3294,450
24,12,12,3,9,85081,38766,10,1504,501
14,2,12,0,12,26698,0,117,7219,649
16,9,7,7,11,95783,46186,254,21790,469
9,6,3,5,4,16276,6187,170,3628,458
5,3,2,2,19,20759,20759,26,17682,643
11,5,6,3,19,2575,7142,35,2926,542
15,2,13,2,25,7811,10993,41,7811,529
7,5,2,5,11,26619,26619,34,9632,345
10,5,5,3,14,68087,32831,4,11977,455
20,6,14,0,24,130229,0,13,555,687
8,6,2,5,5,4215,4215,35,0,628
14,9,5,0,13,370689,0,0,0,696
15,10,5,3,15,141553,5636,42,360,500
7,3,4,3,7,23884,23884,180,12205,506
8,5,3,0,12,73961,0,1,0,546
18,9,9,7,10,102029,58548,185,19247,419
3,1,2,1,8,55435,54308,0,0,639
37,11,26,1,12,339948,1050,71,5297,586
8,5,3,5,8,69876,59072,119,15493,520
13,6,7,1,14,303341,247986,54,0,565
21,7,14,0,18,469879,0,8,1676,635
10,3,7,3,9,7291,10251,123,4331,459
12,6,6,4,14,45234,21987,99,6503,522
5,3,2,2,7,12404,12404,27,6235,468
11,7,4,0,6,44184,0,7,720,589
41,4,37,4,11,47795,6589,67,3024,539
3,1,2,1,8,7161,7161,101,8343,451
16,10,6,8,20,746835,252505,0,0,494
4,1,3,1,8,0,7686,11,46,609
9,5,4,2,8,13196,1268,121,1571,566
12,9,3,8,7,158850,134457,169,41171,420
24,10,14,6,22,54928,34014,266,10592,453
8,5,3,0,4,62413,0,4,2518,557
38,9,29,7,18,147639,48682,366,25920,455
16,5,11,5,5,47077,15463,0,0,437
236,11,225,7,16,113618,50149,302,13550,433
18,6,12,0,23,88192,0,0,0,722
40,7,33,5,12,31300,93151,27,649,443
10,7,3,4,10,293491,17414,80,7994,478
23,12,11,2,6,163761,23458,94,5000,499
6,3,3,1,9,526729,9318,22,0,618
5,3,2,3,19,463840,126194,74,0,586
12,4,8,3,14,26574,21279,40,2702,451
21,7,14,2,17,38287,37069,13,2372,687
33,3,30,2,13,30044,306,63,460,545
53,5,48,2,9,481774,81784,21,53872,465
6,3,3,0,16,21457,0,0,292,587
64,4,60,1,6,27787,1430,6,2385,464
13,4,9,0,11,1355419,0,0,0,695
7,4,3,3,6,34723,33723,64,1987,512
32,10,22,12,12,214327,237482,221,41149,409
18,10,8,9,7,54914,85309,337,30395,415
18,7,11,4,7,222555,45021,6,338,460
7,3,4,5,8,314324,25070,0,0,480
38,13,25,10,14,622005,169806,91,35246,373
2,0,2,0,9,0,0,12,0,641
22,9,13,1,22,353430,621,38,0,533
5,3,2,3,7,33511,33511,194,29668,484
23,6,17,7,7,32301,41052,220,14677,451
20,8,12,1,10,198180,18313,153,1280,505
11,4,7,3,12,55197,13952,16,11826,468
29,10,19,0,19,1242228,0,15,2200,562
9,6,3,3,4,18140,30668,41,23936,449
6,3,3,1,6,615,615,57,422,664
16,6,10,7,11,31340,31340,69,16020,402
30,5,25,3,23,448357,217008,32,3310,511
9,7,2,0,9,176735,0,0,0,476
16,6,10,6,9,21989,11601,60,734,464
80,11,69,1,10,351119,100,20,7753,503
5,1,4,1,8,4588,4588,76,52572,522
12,6,6,3,7,1253116,166793,5,0,421
14,8,6,3,5,459687,13820,78,2988,449
18,2,16,1,7,20667,3899,68,3899,524
29,9,20,1,16,208257,13129,21,380,543
6,2,4,1,6,2500,12302,58,0,532
32,13,19,8,10,361876,136976,562,96015,414
77,17,60,3,16,628021,6366,103,21755,478
8,4,4,2,7,11341,9329,37,8125,443
15,9,6,7,9,87030,44685,96,7820,450
13,6,7,7,8,53180,59791,144,8699,437
30,13,17,3,10,340231,13313,53,11868,473
12,7,5,0,13,373720,0,0,0,644
11,6,5,2,11,175743,33708,36,0,594
52,20,32,4,14,1382878,43263,102,2422,471
9,4,5,0,4,1328,0,7,110,688
16,6,10,2,7,40365,129170,51,0,494
13,4,9,0,7,118262,0,0,0,662
25,4,21,1,10,14746,4873,23,4873,677
3,1,2,2,5,14896,2203,19,1999,488
8,2,6,3,8,15430,21214,24,15430,522
9,3,6,2,16,19043,16293,43,10911,641
28,3,25,4,14,37762,37762,58,21810,577
18,9,9,1,19,801371,46701,37,14418,475
25,12,13,3,14,67634,17011,34,10094,532
9,5,4,4,14,273662,273662,147,73196,431
18,5,13,6,10,132219,263918,55,3397,406
21,7,14,5,12,52465,47512,82,15587,427
11,6,5,1,11,17336,16560,107,16560,586
8,6,2,0,3,233871,0,0,0,610
33,5,28,2,9,60452,23823,182,23263,516
16,7,9,5,8,170036,128462,79,940,439
8,5,3,3,5,159109,75811,69,995,509
5,3,2,3,10,269436,55364,38,38007,444
8,3,5,3,10,500277,45513,45,534,498
17,4,13,4,13,47306,38750,162,31110,448
32,14,18,6,8,2391528,30782,22,2905,486
9,6,3,0,6,89743,0,31,2863,501
18,7,11,0,11,442172,0,1,0,606
9,6,3,4,11,41463,40405,64,1205,449
18,11,7,7,15,549779,71001,6,4021,455
16,7,9,1,8,484826,484,79,1479,524
14,5,9,4,14,513860,47835,85,17276,447
22,7,15,2,14,83938,73282,53,784,527
30,5,25,2,25,581938,533159,22,8856,498
11,3,8,0,9,22027,0,160,2134,679
6,4,2,1,4,2256409,42474,25,42474,548
13,10,3,4,6,522605,18218,86,12410,440
16,5,11,0,9,442372,0,0,0,640
38,17,21,3,10,317046,5350,35,4239,640
55,8,47,7,7,62721,72373,548,26307,452
20,6,14,2,9,28765,13934,47,11254,472
11,3,8,3,9,77424,12553,44,8121,528
13,6,7,2,3,50596,4357,2,1900,530
33,9,24,5,7,43953,25475,65,2349,435
5,1,4,1,6,70230,70230,15,0,483
14,8,6,0,8,259985,0,2,90,581
22,15,7,6,14,517040,8062,39,1980,571
19,10,9,11,16,151409,114537,168,12527,482
16,12,4,8,10,483081,97225,66,33402,384
20,10,10,7,10,240956,22035,48,9013,394
12,2,10,2,8,4683,4683,106,2402,684
4,1,3,0,6,0,0,25,2820,657
54,16,38,4,14,407695,33213,54,31296,568
5,2,3,5,8,36984,98344,119,6777,470
24,13,11,6,13,119190,57883,131,27056,408
19,8,11,5,9,134540,11956,78,5854,419
8,5,3,3,10,191637,189669,0,0,519
20,10,10,5,13,176383,144409,131,13678,453
14,6,8,2,19,66241,17933,4,6142,490
8,2,6,0,5,17512,0,75,875,560
12,5,7,1,4,10591,890,0,0,436
21,6,15,5,19,99854,98694,149,7164,419
8,5,3,0,5,193217,0,0,0,698
8,4,4,6,7,23457,60129,97,18465,513
30,15,15,15,18,335382,229311,367,73303,410
42,13,29,4,26,218108,26437,229,33926,465
18,7,11,0,18,908689,0,13,0,536
13,9,4,1,7,144044,396,41,2753,509
45,6,39,5,15,54697,54571,45,17744,411
12,7,5,4,15,106543,15967,63,149310,439
4,0,4,0,7,0,0,13,0,644
5,3,2,1,14,417901,17713,26,1100,506
20,7,13,1,9,124648,10778,27,13902,521
17,7,10,0,9,583956,0,1,0,660
36,3,33,2,9,10253,10253,98,8755,451
38,5,33,1,11,22739,7171,9,7171,436
18,10,8,8,7,55396,39984,400,6754,503
79,8,71,5,13,188125,116990,80,92039,470
11,2,9,1,10,24848,5997,0,1475,629
7,4,3,4,9,25150,25150,32,14474,418
37,6,31,0,7,435864,0,28,1706,603
10,1,9,1,12,0,10571,30,351,516
13,6,7,2,12,315774,41518,24,3378,457
27,6,21,5,18,186991,186864,45,96160,461
38,14,24,15,9,99418,103666,241,33795,410
14,7,7,8,5,64513,120639,79,6720,481
3,1,2,0,11,0,0,0,0,685
22,6,16,4,14,22907,21458,47,12081,463
20,14,6,12,8,2159282,233459,142,7057,462
13,7,6,6,14,158994,76923,0,0,443
10,4,6,3,14,12659,11659,29,5354,555
10,7,3,7,9,58448,53632,77,18029,454
24,4,20,0,11,10749,0,20,1337,651
8,5,3,0,8,27173,0,0,0,634
6,4,2,4,8,18528,7088,77,0,541
10,7,3,6,9,83749,91955,163,1075,427
7,3,4,0,4,89576,0,0,0,660
7,2,5,0,3,186029,0,1,2500,588
20,17,3,0,8,909351,0,0,0,530
5,1,4,0,4,32442,0,3,1112,588
10,5,5,5,17,105529,83879,113,0,521
5,3,2,2,7,31679,10694,20,0,534
34,7,27,3,7,114957,36099,13,0,470
42,12,30,9,15,428081,97825,160,2871,474
12,5,7,4,9,48045,41429,0,0,489
17,8,9,0,9,313042,0,4,418,669
7,4,3,3,5,26028,40333,45,0,459
6,3,3,0,10,4906,0,0,0,696
19,9,10,0,15,535121,0,4,0,559
20,12,8,11,8,1452421,1348714,90,760848,439
10,4,6,3,19,603367,59434,47,4168,640
11,9,2,4,13,137666,117369,47,0,501
4,2,2,2,5,2741,9810,26,2741,613
23,13,10,7,10,240998,12332,31,6221,375
30,7,23,0,12,106520,0,53,3465,457
14,1,13,0,7,6607,0,107,1286,662
14,9,5,7,8,29325,18759,86,6019,530
15,5,10,5,26,319210,87608,100,39953,467
20,6,14,0,8,53471,0,5,4949,571
9,6,3,0,13,53459,0,1,2724,612
7,4,3,3,9,46829,46829,11,1202,460
12,7,5,7,20,22672,36796,49,6118,485
14,6,8,4,9,708111,682510,84,0,526
28,4,24,0,13,504803,0,9,0,520
8,4,4,1,11,82708,1707,1,1707,473
26,9,17,4,27,670157,147250,61,773,494
84,7,77,2,12,99594,49802,41,0,550
6,2,4,1,10,500494,13190,17,15949,596
8,3,5,3,10,40652,33766,51,23105,535
11,9,2,5,8,43387,32208,64,0,451
16,9,7,2,13,294870,81487,115,48184,501
11,7,4,0,5,429366,0,1,0,578
44,17,27,13,17,217621,87043,83,25525,460
11,8,3,1,8,113322,13350,17,0,672
12,4,8,0,4,14107,0,14,1165,581
34,11,23,7,9,309669,42046,251,4261,416
58,10,48,6,17,115386,25389,94,6841,481
15,5,10,2,13,252292,13169,45,9661,595
8,3,5,1,9,326657,6188,17,6188,586
24,14,10,5,9,69502,38726,142,4604,451
35,8,27,13,10,56125,91224,320,12586,431
3,1,2,0,10,0,0,6,0,643
5,2,3,2,7,317616,10078,21,6190,644
4,2,2,3,6,8411,34395,54,7728,522
35,10,25,7,15,120957,34742,37,14777,429
11,7,4,4,6,15759,3929,238,793,466
10,5,5,2,9,370409,6779,72,0,537
11,7,4,8,27,170945,166267,48,2550,426
8,5,3,1,7,32421,415,27,415,495
71,17,54,0,15,491424,0,2,0,551
4,2,2,1,10,256289,13306,30,12519,602
6,4,2,2,1,6480,1249,6,605,504
7,1,6,0,4,10378,0,5,1468,661
14,11,3,6,11,413713,378591,135,149661,498
32,7,25,5,23,542121,53095,124,12271,536
18,11,7,8,10,425573,82656,168,58247,483
7,2,5,2,8,15530,15530,32,15097,461
18,9,9,5,16,416894,342594,102,4479,431
13,5,8,3,16,12128,8409,19,2141,502
11,3,8,3,11,45446,45575,63,182,482
134,5,129,1,7,20620,134,5,159,562
18,10,8,9,12,361661,289446,212,133224,414
8,3,5,2,9,40011,40011,14,16817,489
22,9,13,8,9,580102,77412,4,1149,462
46,18,28,2,10,237134,628,94,1195,505
34,21,13,0,14,2851587,0,9,0,597
12,3,9,2,9,681742,321218,87,1209,624
6,3,3,2,11,51715,41634,3,17542,512
16,8,8,0,20,163776,0,13,0,523
49,15,34,0,34,845129,0,6,656,572
9,5,4,5,13,34293,48281,81,15397,466
155,3,152,5,7,113317,113317,137,39556,454
10,6,4,5,16,74910,20702,114,6404,444
8,5,3,0,10,26836,0,55,8845,484
33,8,25,7,17,206384,27719,114,5158,460
15,8,7,8,8,346362,34747,35,9357,361
14,7,7,2,7,76920,34340,38,5570,541
60,11,49,3,8,225823,49043,20,2037,466
32,10,22,5,8,62902,35208,38,10439,442
16,6,10,7,9,321358,53605,54,9540,537
8,4,4,3,6,304009,33949,25,768,478
5,3,2,0,13,11685,0,37,0,617
15,8,7,1,7,118089,452,30,2795,611
16,7,9,6,13,42048,44818,38,8870,439
6,3,3,5,5,31436,49268,68,19813,427
20,12,8,0,16,579274,0,7,399,723
37,15,22,0,12,1463743,0,17,4714,470
20,4,16,4,12,133954,17327,73,657,492
41,2,39,2,12,4077,4077,32,3120,547
13,7,6,1,13,165352,598,31,0,590
36,16,20,13,19,502564,171479,293,14299,453
6,4,2,3,8,12940,6937,39,3191,622
6,4,2,5,5,27169,27169,0,0,470
3,1,2,0,9,0,0,0,4999,653
16,6,10,4,11,378795,71565,56,8152,498
10,6,4,2,15,212408,11236,28,1390,446
10,4,6,3,9,332490,141248,51,0,444
89,12,77,0,11,224043,0,76,10241,573
7,3,4,0,12,399,0,0,3653,657
27,10,17,7,7,97775,60480,52,26277,433
6,4,2,0,7,334457,0,2,1537,616
15,5,10,4,7,23361,23361,72,3275,488
8,3,5,0,12,3734,0,1,873,565
11,4,7,0,8,52519,0,32,380,635
12,8,4,5,10,36740,32436,54,20758,391
26,7,19,2,12,17020,12000,107,9823,567
15,7,8,4,7,32472,19082,62,11511,576
21,3,18,3,9,39449,39449,167,14287,506
5,1,4,0,13,9072,0,0,10405,649
16,8,8,0,8,116051,0,0,0,666
28,5,23,2,8,41293,1631,261,2415,525
16,14,2,0,27,780228,0,16,0,513
11,6,5,4,7,35603,51670,46,207,440
17,8,9,5,16,370145,15134,5,8770,373
20,5,15,0,9,43474,0,0,0,676
55,22,33,14,9,321450,105020,289,16460,368
11,5,6,5,11,250612,2380,19,2200,471
19,7,12,0,12,463696,0,2,0,589
4,2,2,0,17,18060,0,4,1338,670
62,3,59,3,7,40742,44188,51,0,517
6,3,3,1,7,11983,1747,8,0,648
7,5,2,4,10,9057,7837,162,3509,504
24,6,18,0,13,10254,0,0,490,704
12,9,3,9,15,94416,42580,132,10510,431
23,10,13,8,7,119700,97342,113,8217,460
11,5,6,3,12,13362,13361,53,12170,531
38,5,33,1,7,48253,1176,17,2346,519
28,10,18,9,11,552637,122184,153,66000,446
25,6,19,0,21,942699,0,0,0,617
13,6,7,8,7,33351,40922,116,9982,422
5,2,3,0,3,54540,0,0,391,641
24,13,11,0,24,213620,0,15,11214,611
23,9,14,3,10,113753,16568,36,9841,452
13,4,9,3,18,185516,51630,57,0,520
32,3,29,1,8,49761,13945,88,13945,621
5,3,2,0,7,49507,0,19,16,489
33,6,27,8,9,68491,82877,97,1639000,467
5,3,2,4,10,115545,114821,0,0,447
4,2,2,3,10,9765,20718,0,1578,464
31,3,28,5,10,14874,15978,106,5205,455
14,8,6,3,7,390414,13179,50,7106,477
9,4,5,1,13,977739,5437,11,0,509
10,6,4,0,11,252319,0,25,31701,555
12,3,9,3,14,12055,12055,95,24395,567
15,6,9,6,8,37493,33643,141,6114,425
24,12,12,1,8,346934,398,26,398,594
30,13,17,10,7,119687,76586,116,26316,504
13,6,7,5,6,79159,42157,46,2978,402
37,9,28,2,9,516984,13211,188,2106,517
11,7,4,6,5,35937,38926,53,5123,437
45,14,31,1,12,109725,5734,67,1475,533
7,3,4,2,5,4744,1759,27,1549,499
25,7,18,4,15,67839,42752,112,0,469
8,2,6,1,7,6792,6079,40,4380,477
32,12,20,9,14,49440,36706,329,15825,482
16,9,7,0,12,390137,0,4,0,643
16,3,13,3,14,39171,39171,207,36763,486
9,2,7,2,17,4127,4127,35,10217,523
30,7,23,10,25,83506,99366,0,0,453
7,4,3,0,14,275846,0,0,2336,588
9,5,4,2,6,278311,7074,31,6597,481
17,7,10,9,29,271300,312884,172,1611,510
8,5,3,2,2,40499,661,3,255,605
8,1,7,1,12,355930,3954,32,1561,539
10,6,4,6,9,61182,44521,21,1250,463
17,5,12,2,18,491888,3240,7,1187,434
9,2,7,2,12,6970,4276,21,1525,520
7,2,5,0,6,17800,0,6,2553,645
6,4,2,3,15,8316,9814,43,5340,457
6,3,3,5,12,68213,58009,85,0,541
15,3,12,1,13,17112,1932,1,2898,501
3,1,2,1,11,0,2811,12,0,629
35,13,22,19,8,615885,626527,207,0,509
14,6,8,2,5,42182,427,18,396,613
6,1,5,0,5,0,0,0,0,733
7,3,4,4,4,28148,17464,0,0,445
14,9,5,7,15,381967,77451,128,1132,478
4,2,2,2,9,6124,6124,43,0,585
8,5,3,1,2,436324,16978,4,0,474
32,5,27,3,6,53527,19358,131,12742,475
85,74,11,4,20,146622,15745,0,0,507
9,3,6,2,17,56671,30573,41,30565,517
28,7,21,1,14,283676,47814,28,96,529
8,6,2,5,6,19798,14782,102,3865,509
53,7,46,1,7,200469,16893,42,4750,621
7,3,4,3,11,6171,11659,21,750,559
64,9,55,3,14,91387,16120,54,9833,493
7,4,3,1,10,29102,2034,0,0,514
12,4,8,5,7,597835,906149,97,581534,398
11,8,3,7,15,39852,38832,95,19660,424
4,2,2,2,9,5035,7941,22,5035,512
18,0,18,6,12,56358,65757,105,16780,644
11,3,8,3,11,6274,2672,18,2434,431
7,5,2,4,6,34880,38097,98,0,575
14,5,9,3,13,17669,11645,23,7242,494
21,8,13,4,24,174983,163091,1,3427,558
12,7,5,2,14,1563132,5113,45,0,521
27,5,22,0,15,32365,0,0,0,678
9,5,4,2,8,48389,11725,25,8159,465
20,10,10,1,4,50811,22,7,1781,592
5,3,2,1,26,243221,24186,50,0,617
16,5,11,4,9,427752,13008,81,8569,423
20,5,15,2,4,17119,9239,16,6804,473
8,5,3,0,7,18120,0,11,797,644
9,4,5,2,11,32957,7574,14,1952,489
23,7,16,6,6,54151,21254,121,8963,427
10,6,4,1,11,311131,16666,10,16666,522
9,2,7,1,16,9053,9053,16,9053,646
13,8,5,0,8,194165,0,54,258,558
8,5,3,0,11,168215,0,0,0,570
8,3,5,2,31,15874,13057,20,12742,593
18,16,2,2,17,477838,3962,17,639,506
18,7,11,3,12,285353,38745,69,23872,484
20,11,9,9,11,540703,200896,121,45325,429
48,3,45,1,69,7270,3339,21,7231,502
14,9,5,0,4,144109,0,1,0,574
4,2,2,0,10,38408,0,0,0,708
7,5,2,5,10,128380,128379,90,70491,417
11,6,5,5,9,155203,118404,61,59905,428
8,6,2,5,3,42616,2849,52,828,451
15,3,12,1,18,7890,6690,47,1995,519
5,2,3,1,6,11584,9454,33,0,505
9,2,7,1,12,35504,10039,4,2641,626
9,5,4,1,10,99508,2959,20,0,549
13,5,8,6,15,67341,79356,119,604,451
7,4,3,4,21,596925,59931,56,13275,488
15,4,11,3,7,34676,11796,53,1304,475
40,15,25,2,16,57495,19363,25,17146,501
12,5,7,0,11,931,0,33,1250,474
8,3,5,1,11,28413,20560,29,0,466
63,16,47,12,11,3014017,249874,30,142491,417
50,19,31,2,20,269164,4642,30,7915,548
9,6,3,5,7,13505,9350,30,5016,486
11,6,5,6,12,69457,60477,142,0,443
14,5,9,4,7,28554,22423,51,7845,436
27,15,12,7,12,329443,49723,0,0,456
35,6,29,0,7,45338,0,9,0,526
27,5,22,3,9,35919,17443,16,4395,498
17,14,3,12,7,59739,54205,182,12574,374
23,4,19,0,13,164624,0,0,0,602
8,5,3,4,5,15658,11316,125,4111,480
6,2,4,0,17,8411,0,30,0,599
4,2,2,0,7,2548,0,4,0,591
25,10,15,11,17,51737,51117,36,14556,442
14,6,8,6,11,220784,32979,78,9581,533
21,7,14,2,17,66218,5743,49,5282,561
10,0,10,1,14,5466,5466,16,5466,541
30,5,25,0,11,50653,0,2,1851,469
94,8,86,5,14,295224,117974,111,9300,521
10,8,2,3,28,189335,189309,49,117167,503
14,1,13,2,9,6591,9859,37,6591,554
24,13,11,13,15,428347,380957,408,59141,442
14,11,3,0,11,133369,0,1,0,620
10,5,5,5,8,64286,70424,70,15997,470
9,5,4,2,14,222339,28564,57,13038,544
28,11,17,6,13,227170,21067,102,9600,420
20,7,13,4,14,98682,62978,138,861,453
15,10,5,5,7,272952,29125,81,15642,432
21,9,12,7,16,88338,47920,143,31263,418
7,5,2,0,19,415866,0,0,29283,635
36,6,30,4,11,26520,26520,319,33287,435
16,9,7,7,7,377487,32731,531,13038,460
12,7,5,1,3,320867,9040,4,0,513
10,7,3,3,9,178645,125605,71,76490,471
21,9,12,0,13,315458,0,6,0,627
4,0,4,1,10,0,5004,19,42025,652
5,0,5,0,12,0,0,0,4119,489
42,17,25,1,15,126138,6338,26,256,534
23,6,17,5,12,11981,11981,86,5724,488
14,7,7,0,11,874100,0,0,0,601
6,4,2,4,4,33477,36446,48,22865,598
6,4,2,4,11,59714,79774,80,42703,465
5,1,4,0,11,276264,0,0,0,697
11,7,4,0,6,15352,0,12,0,520
7,5,2,5,9,888082,108711,15,1477,482
4,2,2,2,8,14433,30640,0,0,499
21,5,16,3,4,68538,65929,35,0,515
3,1,2,0,10,193262,0,0,0,676
6,3,3,3,6,12858,12858,33,6190,488
71,39,32,1,10,321075,1019,8,1019,547
11,4,7,3,5,12717,12717,0,0,474
18,11,7,2,19,1908471,129724,19,0,555
12,2,10,4,7,66852,66852,104,24666,532
20,8,12,5,19,110672,37506,188,12000,460
4,1,3,1,3,1313,1313,21,0,519
18,8,10,8,11,108104,41396,253,65520,447
3,1,2,1,5,36160,36160,23,36160,599
12,4,8,3,12,16971,7224,13,3735,547
25,9,16,1,14,86589,449,72,0,555
19,9,10,0,9,295520,0,13,0,636
4,2,2,3,9,4069,35734,0,0,547
20,6,14,0,10,373176,0,7,575,524
13,4,9,2,69,9234,4135,64,25324,557
6,0,6,0,4,0,0,31,3006,539
28,15,13,17,11,1361565,2197103,247,532766,411
6,3,3,4,15,599096,611438,0,0,493
33,10,23,6,11,429072,21953,70,10400,424
14,9,5,1,10,151103,817,12,864,617
38,12,26,8,18,83403,69481,22,15320,473
3,1,2,1,8,1050,1050,14,1050,598
23,13,10,0,21,643203,0,10,0,638
10,7,3,4,7,32368,25972,58,797,523
22,17,5,7,69,2285365,340251,74,617,480
8,1,7,1,7,42009,1618,3,0,662
7,3,4,2,5,15050,15050,214,13950,474
10,4,6,2,6,30862,7575,39,1577,437
9,6,3,2,16,244870,14012,16,1841,511
34,7,27,0,12,48280,0,38,291,660
9,4,5,3,7,5873,5873,41,3143,511
11,6,5,0,14,215002,0,7,2440,539
41,12,29,4,12,136825,27570,5,1886,473
33,10,23,0,15,278580,0,11,0,659
27,14,13,9,17,185336,39737,127,10517,433
18,4,14,2,9,14142,11462,54,4253,442
15,7,8,0,7,22016,0,9,351,712
37,7,30,1,7,231074,1736,89,8612,465
9,4,5,3,4,366881,97388,23,6224,487
24,9,15,5,13,222792,27754,195,22057,478
6,4,2,4,5,10561,10561,40,5131,417
31,13,18,0,13,734117,0,0,0,641
4,1,3,0,4,21073,0,7,0,601
16,9,7,1,8,168812,952,18,545,449
8,4,4,6,10,29510,172952,78,13064,457
83,29,54,0,22,1465496,0,22,2823,596
25,6,19,8,13,29504,49526,67,17191,607
9,6,3,7,10,46930,65631,136,24061,418
8,3,5,4,16,21756,38685,88,220,508
19,8,11,2,11,295594,25531,26,109,470
19,12,7,6,17,164231,75323,59,54712,442
6,2,4,1,8,6954,6954,27,0,551
26,17,9,0,41,2822257,0,7,0,692
16,6,10,2,7,143950,13522,69,14291,512
11,3,8,1,10,42443,3224,16,800,669
10,4,6,3,6,10054,15340,69,1200,475
11,3,8,3,9,32546,32546,66,4116,495
10,6,4,4,18,546720,21872,122,19963,490
30,8,22,4,14,136340,98773,112,5336,503
23,4,19,1,18,4260,4260,11,4355,508
21,7,14,4,8,228579,45850,100,11972,523
6,3,3,0,14,3715,0,0,0,560
39,9,30,0,26,625685,0,8,0,623
11,4,7,5,7,9090,16538,127,5260,462
28,10,18,2,7,432869,11232,25,10755,408
11,4,7,2,4,9985,5312,14,3905,530
6,3,3,2,13,289421,6303,50,0,612
15,7,8,4,15,176211,52586,79,1982,404
21,6,15,0,14,74874,0,3,0,625
20,11,9,4,9,41652,36078,39,25317,675
16,3,13,1,15,404098,18112,27,18112,453
5,2,3,1,8,26869,17422,16,0,495
36,7,29,4,10,60813,27103,361,12182,503
14,8,6,2,26,335797,18709,47,6980,500
6,1,5,0,8,5378,0,1,0,632
8,5,3,3,7,45720,22933,36,0,465
6,2,4,1,9,4392,1599,0,0,601
13,4,9,0,17,148926,0,6,1330,614
6,4,2,3,14,23542,11171,7,6694,474
19,5,14,2,14,44125,35381,65,2469,600
5,3,2,0,6,43918,0,0,491,676
13,7,6,2,18,1694373,66646,2,3728,532
12,5,7,1,11,77234,1150,3,3953,486
14,9,5,4,11,248741,10883,0,0,439
34,15,19,2,16,1022737,13268,16,30911,539
13,8,5,3,11,45546,16926,65,1425,554
16,8,8,10,18,171597,79479,151,21513,428
31,13,18,3,12,256209,20385,39,4652,454
5,2,3,3,15,273428,27146,0,5655,467
73,12,61,8,9,405667,114366,310,42570,481
21,15,6,1,17,441579,195912,26,195912,517
25,5,20,2,14,11774,11551,264,32013,492
5,3,2,3,6,11985,11985,68,5036,494
11,5,6,0,15,157754,0,0,0,639
26,5,21,4,6,39950,36740,55,3671,460
94,8,86,0,4,41828,0,5,339,560
15,13,2,4,9,99994,4055,1,4885,454
31,3,28,4,14,56064,77747,157,51502,526
24,11,13,7,14,487318,161351,181,92274,417
6,2,4,1,21,809974,66745,13,0,640
4,1,3,1,9,0,359,0,0,648
15,2,13,1,14,1940,1940,0,1560,701
24,18,6,4,14,516515,27321,37,9974,430
11,1,10,2,18,44026,44026,0,0,514
17,8,9,0,13,226169,0,11,18,646
11,2,9,1,21,8662,8662,2,1926,643
28,11,17,1,11,123462,1678,46,2884,509
49,6,43,2,11,98506,14381,39,10291,507
31,10,21,10,11,340934,199487,307,88868,393
4,1,3,2,10,1242,19962,0,0,621
25,2,23,0,3,12856,0,24,11335,504
31,3,28,0,6,317891,0,0,0,550
75,6,69,2,18,44573,31544,47,17876,597
20,16,4,14,5,94120,89783,251,17109,436
40,8,32,5,8,46352,12048,6,2950,462
14,7,7,7,6,19909,35486,103,10942,406
6,4,2,1,6,20560,9690,4,0,496
7,4,3,4,8,90431,84281,176,1637,447
36,26,10,0,6,1022396,0,22,2985,525
7,5,2,2,5,20376,1148,1,467,603
26,14,12,2,14,745837,5899,7,550,528
45,9,36,7,19,30324,53701,380,20202,445
68,7,61,6,10,52215,47094,162,37782,427
11,7,4,5,8,194199,15923,64,11729,476
35,7,28,10,9,68595,108483,228,28980,439
19,6,13,4,12,329960,228754,103,6872,614
27,10,17,3,12,486463,37664,64,6086,438
16,7,9,4,9,560388,64043,122,31294,474
24,15,9,0,19,2580334,0,8,5931,634
7,1,6,1,8,47781,45550,26,900,566
6,3,3,1,14,390672,30470,27,30470,514
41,5,36,3,69,2160,9877,46,4315,502
7,4,3,6,8,41612,50402,149,8000,454
24,5,19,4,7,148659,73629,27,8511,466
42,8,34,7,8,72420,53753,249,15163,540
81,11,70,5,17,157365,17699,246,8399,475
6,3,3,3,4,47113496,47113496,22,5527,496
3,0,3,1,6,8090,5079,8,0,617
4,1,3,1,5,27371,11715,5,137,432
75,9,66,2,16,592159,37372,47,26231,549
4,0,4,0,12,0,0,0,0,632
26,9,17,4,8,86853,39613,111,8168,439
12,5,7,1,8,28506,15813,47,4193,522
36,10,26,0,17,503773,0,0,1428,680
10,4,6,5,5,25436,25436,296,11647,487
20,9,11,4,24,253867,65824,78,627,457
24,7,17,2,9,987295,3918,35,3375,541
55,25,30,15,7,1267111,183010,312,48790,432
26,11,15,13,8,84551,86107,210,14496,371
16,5,11,0,8,51528,0,32,895,623
17,8,9,3,13,1287649,280313,21,0,443
28,10,18,6,16,93783,38720,139,2606,462
27,11,16,8,6,154333,36332,99,12723,452
15,10,5,0,13,352449,0,0,0,712
20,8,12,9,10,45479,45479,174,11193,430
8,5,3,3,15,248533,11195,49,5512,509
15,8,7,8,15,19890,35252,141,5065,429
38,11,27,0,11,91978,0,54,656,548
8,3,5,2,5,21077,12640,9,0,560
8,3,5,2,7,18510,18510,215,17700,648
24,9,15,5,7,191916,44478,62,2698,462
11,9,2,8,13,530731,158296,126,21447,374
8,1,7,4,10,0,197653,0,0,558
5,2,3,1,2,22820,1599,3,1599,430
9,5,4,0,19,271467,0,15,0,566
8,4,4,0,8,231410,0,12,3720,472
27,12,15,0,13,2445621,0,13,0,622
80,17,63,11,14,263312,163857,493,18162,446
22,13,9,8,25,421792,173264,104,2898,444
12,4,8,3,9,255716,71414,149,3550,466
12,3,9,3,12,58478,47208,46,36567,473
31,8,23,4,13,36623,13498,113,5702,455
81,11,70,8,9,241776,28650,561,7200,442
20,10,10,3,11,643009,159925,14,0,497
19,9,10,0,13,170872,0,9,1325,628
17,6,11,6,12,78911,82293,2,4129,438
54,13,41,1,10,48012,8861,132,8861,471
12,6,6,3,8,113792,12456,27,4152,402
17,5,12,0,13,14990,0,40,574,528
26,11,15,3,5,247319,22894,39,13997,382
40,6,34,4,10,200937,28454,97,6163,515
6,4,2,3,9,198576,18492,0,0,531
23,11,12,8,14,330914,203632,225,0,451
4,0,4,0,14,0,0,9,3229,609
6,4,2,3,7,10820,2209,52,884,570
92,15,77,4,18,133715,8433,265,4935,465
9,6,3,6,4,39864,43816,67,1060,460
14,10,4,6,15,112336,9369,57,1522,486
14,7,7,1,12,218296,891,2,0,675
11,5,6,5,18,80903,93460,121,22986,458
14,7,7,5,14,1686555,205193,23,4823,561
20,10,10,10,9,159449,92003,171,7794,462
19,12,7,1,16,166089,959,17,2898,574
13,7,6,4,8,39032,19875,48,11048,429
36,12,24,6,11,182823,23564,168,12083,422
5,3,2,4,9,24597,32566,14,7969,471
13,6,7,3,9,238750,14437,141,12506,596
12,8,4,0,17,351032,0,12,0,577
10,5,5,4,8,49261,27341,28,11217,427
8,5,3,4,4,41160,26397,150,20209,457
6,3,3,3,7,15088,21060,45,14413,491
49,20,29,11,12,122494,74946,156,3518,446
11,8,3,3,5,24692,13151,8,4470,427
29,12,17,5,7,177714,27312,30,13942,553
15,5,10,3,14,163160,17821,43,10382,468
7,5,2,3,9,138472,23141,42,0,470
18,4,14,4,21,6969,12229,52,5480,488
27,3,24,4,13,70293,70293,46,12759,515
20,13,7,12,15,596685,409888,140,206884,414
44,10,34,7,13,81577,23528,269,18993,500
33,13,20,0,11,190811,0,18,914,568
5,3,2,2,11,436497,13058,190,9395,522
43,5,38,1,18,23726,9824,169,34009,477
8,6,2,7,12,62622,59839,70,19696,462
40,10,30,7,13,185953,74010,323,10986,577
15,5,10,3,17,628075,52390,31,14040,529
49,13,36,4,14,377250,15155,187,8824,460
15,6,9,5,4,22727,22727,30,3286,394
20,9,11,5,15,224709,28778,100,12408,406
91,17,74,12,11,377760,159572,324,37666,410
29,12,17,12,20,445408,396120,24,35763,457
31,6,25,4,5,13042,8847,46,4896,415
23,12,11,8,8,599358,576535,217,154020,435
30,15,15,3,8,177519,3213,40,681,520
13,6,7,7,23,309820,189840,72,9239,515
11,5,6,4,17,323533,97838,19,55293,481
15,6,9,0,9,74907,0,0,0,672
11,8,3,0,12,488742,0,31,14494,545
2,0,2,0,3,0,0,0,0,653
8,5,3,6,13,59407,69032,42,4195,452
25,10,15,0,11,621787,0,25,980,635
6,2,4,3,8,36766,35833,29,18383,527
12,6,6,0,14,460135,0,0,0,622
4,2,2,0,2,10530,0,0,0,608
20,12,8,9,8,75367,57011,365,18680,420
29,10,19,7,11,218717,119943,52,45632,382
29,6,23,4,14,964176,500407,113,14478,457
43,9,34,3,13,549427,326894,136,4558,586
8,5,3,1,10,477916,3486,39,8718,454
14,5,9,2,9,6483,2071,26,1171,560
14,9,5,11,11,49638,68895,116,15981,404
36,6,30,4,16,159705,38353,128,35384,458
12,7,5,5,7,183290,168704,91,30060,482
53,24,29,3,29,613955,60358,45,4484,509
8,6,2,3,17,28931,8849,36,0,480
9,3,6,2,5,7888,7888,29,4619,417
12,5,7,0,7,75522,0,35,2070,545
20,8,12,8,20,840748,323513,122,3185,527
7,4,3,1,9,20016,1094,34,25025,486
127,39,88,1,13,128669,2097,47,2097,526
24,7,17,0,13,262505,0,16,448,583
12,8,4,3,8,164386,41641,4,4049,464
31,13,18,9,13,34578,23831,63,9529,478
10,4,6,5,11,141105,120462,86,34,514
35,8,27,0,13,339796,0,220,19245,616
8,4,4,6,7,318253,86133,131,33170,435
18,4,14,0,9,178410,0,1,3628,505
11,5,6,3,9,28895,26308,0,0,526
29,13,16,7,12,949600,261290,152,22741,395
16,7,9,6,13,84032,47067,38,25047,536
8,3,5,4,9,38618,38618,8,9290,545
17,9,8,6,12,306993,42417,74,7550,490
21,7,14,2,19,45179,9345,50,2184,655
18,11,7,2,4,319317,2994,54,2583,425
17,9,8,8,14,226361,226203,118,47197,440
11,9,2,2,11,64350,18300,45,0,472
4,2,2,2,6,7112,7112,6,3949,495
47,9,38,1,18,22739,19721,63,3915,638
32,9,23,7,8,183854,35367,126,6248,451
13,5,8,3,9,143321,19014,27,16801,411
5,3,2,1,13,280177,3889,30,108,535
12,7,5,1,10,577609,175867,4,1120,493
31,7,24,0,13,350375,0,3,0,635
8,6,2,3,3,104561,44083,37,7200,432
51,14,37,11,9,71818,35155,419,9372,406
7,2,5,0,2,51738,0,0,0,632
23,9,14,3,9,425765,37577,1,191,481
7,4,3,3,7,20778,14440,24,4064,459
12,7,5,11,10,34560,162615,150,21260,443
4,1,3,3,5,5068,20288,20,15220,553
19,4,15,0,13,348856,0,0,0,623
9,3,6,0,8,241686,0,15,1251,430
14,2,12,3,8,20471,17282,11,11730,576
55,8,47,2,13,185279,9109,79,15760,470
32,13,19,12,17,104953,98621,316,17449,455
48,9,39,4,11,136567,9920,139,7278,473
41,10,31,3,10,334751,21271,168,7429,532
26,7,19,3,10,218927,16007,93,6320,465
10,8,2,0,3,42015,0,3,0,545
6,4,2,0,12,176490,0,1,0,638
14,11,3,10,38,88971,77470,54,2480,451
21,11,10,11,18,732854,130177,178,37671,398
17,8,9,4,12,60321,65783,95,27778,414
11,8,3,7,8,25887,29246,266,13916,371
14,9,5,4,9,140281,9655,0,0,454
7,4,3,3,15,18273,7050,33,2801,489
19,11,8,6,16,25272,9426,70,0,474
7,3,4,0,11,1707,0,3,522,606
10,5,5,2,12,53031,706,2,688,497
20,10,10,2,17,430413,63071,19,6849,537
10,8,2,4,14,557609,201298,94,136820,603
62,15,47,11,19,2040080,519941,105,36966,393
16,4,12,5,12,26005,23355,30,7790,486
10,6,4,0,3,73821,0,2,0,562
56,12,44,9,16,57387,24302,0,0,481
11,7,4,6,9,272136,80808,143,5475,453
15,9,6,8,9,321483,301677,176,39345,448
8,2,6,3,9,23246,26814,65,997,437
20,14,6,0,8,2125076,0,4,0,599
20,9,11,3,11,589539,71924,195,59070,455
22,2,20,2,10,9001,8563,48,1458,625
25,5,20,3,12,254913,26833,200,27798,448
5,2,3,0,5,15921,0,4,0,574
13,10,3,4,9,80078,43486,117,95427,356
6,1,5,1,17,0,12785,0,0,665
20,12,8,0,11,707042,0,3,0,578
6,4,2,4,17,74291,63952,46,56720,485
42,12,30,10,9,206197,199459,269,23078,466
14,4,10,3,10,40527,27149,62,19823,454
20,5,15,5,38,396688,169281,91,34052,445
6,4,2,3,17,13487,28327,41,4376,479
10,4,6,0,13,315851,0,95,22719,474
41,10,31,6,16,49655,28503,107,4242,514
12,7,5,4,6,26371,7078,264,2691,519
16,4,12,2,11,1173569,33850,16,0,534
17,4,13,5,15,135468,145740,70,33955,436
26,6,20,2,7,90598,4249,118,3682,471
10,3,7,0,7,47792,0,2,366,652
16,6,10,3,15,71418,38364,49,7429,528
18,5,13,5,19,20875,21188,57,7905,450
9,5,4,1,6,369638,374,8,1587,545
9,5,4,5,6,663078,932496,105,566580,488
15,8,7,6,19,470024,1933584,144,2979,518
20,9,11,9,8,212389,212237,0,0,447
9,5,4,0,8,150737,0,13,0,561
10,1,9,2,17,7355,25023,0,0,633
16,7,9,0,12,481962,0,6,0,607
7,2,5,1,12,1672,1672,35,1672,577
28,17,11,14,29,431061,492782,293,82986,395
25,4,21,0,14,139529,0,0,1493,632
14,4,10,6,10,38352,40633,195,19826,485
67,9,58,6,19,65007,53092,97,27330,447
10,6,4,3,18,275927,241843,98,1100,489
24,10,14,1,8,446604,2482,19,7462,461
5,3,2,0,4,1210,0,10,2508,603
7,4,3,3,5,13968,13567,52,3516,419
12,10,2,3,5,323982,30226,59,21055,417
16,6,10,2,16,145034,126486,96,111640,495
18,9,9,2,17,476408,51543,64,0,515
18,12,6,9,6,298464,66183,73,10120,396
47,17,30,5,24,1317562,182402,0,0,472
9,6,3,6,12,585800,211427,163,45204,459
32,8,24,7,14,144234,86728,64,21086,424
11,3,8,1,19,14124,14124,6,2926,473
48,7,41,2,17,361233,133379,32,1321,531
8,5,3,0,16,19701,0,22,0,611
3,0,3,0,7,0,0,4,2476,621
4,1,3,0,5,2497,0,5,5821,681
14,5,9,0,13,224583,0,15,3278,677
62,11,51,2,22,322828,1074,155,2696,484
23,12,11,3,7,83349,7954,95,4072,508
5,2,3,0,3,276067,0,0,1222,549
12,6,6,2,14,387573,13331,0,0,637
27,10,17,0,12,258811,0,58,2357,571
3,1,2,0,16,1103,0,20,4317,564
6,3,3,3,15,146123,146893,59,9305,437
15,11,4,5,11,54100,66750,52,31625,544
85,14,71,12,16,155499,106111,620,66110,423
5,1,4,4,11,900,18439,0,0,530
7,3,4,1,18,349997,33900,7,0,560
15,12,3,5,10,958974,56267,41,2421,454
12,4,8,2,14,381237,16682,23,11492,475
12,7,5,3,11,769446,239092,36,12401,511
7,2,5,1,9,19824,19824,40,289,528
16,5,11,7,7,46989,46939,0,0,449
10,8,2,6,5,52103,11810,46,1266,512
4,2,2,1,16,5772,5772,7,0,483
8,6,2,2,21,152409,17125,54,11608,564
8,4,4,0,7,9705,0,26,1341,518
10,3,7,3,7,24329,25628,17,9060,556
59,19,40,14,12,603988,100812,268,18936,404
14,8,6,8,7,53140,69198,120,15662,587
27,13,14,11,7,109432,100343,494,34576,501
7,2,5,2,3,10666,10666,40,1852,430
6,4,2,4,9,12689,12689,40,11273,441
10,3,7,1,13,13777,9124,23,9124,553
5,3,2,2,12,221119,11458,17,11215,516
7,2,5,1,9,14249,14249,47,3715,458
11,9,2,10,12,335053,1277407,196,220289,489
14,8,6,8,14,395048,405038,51,13319,423
11,8,3,2,4,98368,192,79,2440,508
3,1,2,2,4,2762,5896,10,2762,506
19,9,10,9,7,16911,21303,99,4423,417
37,6,31,2,6,163119,17161,31,0,555
7,5,2,0,9,142145,0,0,0,558
15,5,10,3,17,45617,12777,47,4352,485
11,8,3,0,5,42947,0,4,0,580
14,3,11,1,5,9911,33918,5,2203,534
9,4,5,2,6,19056,4822,257,6112,425
19,10,9,0,16,166130,0,2,7357,618
8,2,6,3,7,18515,15134,62,0,499
11,3,8,4,9,119645,119645,130,58317,474
34,14,20,3,12,261767,64240,20,5949,464
32,6,26,4,10,25043,8877,77,7943,449
35,13,22,4,14,619204,5719,41,7781,474
21,10,11,0,12,290255,0,8,1325,678
14,9,5,0,25,272489,0,0,0,679
7,2,5,1,5,35702,5682,22,0,635
7,4,3,0,6,78928,0,24,0,515
12,5,7,3,7,375353,9315,102,407500,490
10,6,4,1,11,49398,11399,26,3762,489
4,1,3,1,14,0,2483,0,555,556
23,9,14,7,20,111570,78687,187,31672,444
10,6,4,4,14,85517,78953,60,41510,479
36,18,18,0,14,98833,0,79,2906,444
7,3,4,1,7,25146,2896,13,0,559
7,5,2,3,69,364068,5312,137,2820,448
24,9,15,2,19,42954,1918,39,1083,448
11,5,6,4,17,29165,28864,29,26112,446
10,4,6,0,10,86961,0,4,0,582
108,10,98,4,13,71038,15946,86,1344,481
15,9,6,7,19,751444,477616,115,0,510
20,8,12,1,8,1205926,2390,14,1069,445
13,7,6,9,16,70458,68936,85,1656,427
13,7,6,5,10,61432,62971,149,24850,494
8,4,4,0,8,241951,0,3,0,596
11,5,6,1,16,767519,16228,11,2200,658
12,6,6,0,20,57122,0,2,0,627
4,2,2,1,6,529210,14627,20,0,551
50,15,35,13,14,116915,64062,47,23720,438
13,7,6,0,6,926740,0,22,1400,593
23,11,12,5,12,202694,31600,18,13048,439
14,9,5,8,9,368329,36607,68,21620,458
17,8,9,2,20,439720,472,33,1087,447
3,1,2,1,7,20570,20570,41,20570,543
27,17,10,5,13,562822,4161,69,3130,465
12,7,5,4,14,1110747,285326,41,10352,412
11,7,4,2,11,304026,3201,14,1704,525
12,4,8,2,16,211923,14956,37,2592,544
9,1,8,1,13,12168,12168,21,12168,580
9,3,6,2,14,1026,1026,46,809,606
8,5,3,2,5,2575,2575,31,2175,530
20,2,18,1,13,9975,28801,20,0,609
24,12,12,4,16,556617,68399,82,0,464
29,11,18,1,19,396663,7901,36,10083,495
9,4,5,1,9,30618,537,12,3192,506
13,5,8,1,12,71461,511,8,13951,469
27,14,13,0,21,612121,0,0,0,528
30,7,23,0,16,53511,0,7,1171,607
4,2,2,2,12,1703956,143945,47,830,544
19,9,10,5,10,79086,74384,384,59696,489
5,1,4,1,16,44251,43771,21,1652,584
12,9,3,5,6,502287,39229,0,0,494
8,3,5,2,17,23175,46968,36,0,530
23,13,10,14,7,55532,65886,296,8714,378
7,1,6,2,7,5690,5690,21,415,526
17,12,5,6,19,346551,249679,37,14995,410
22,10,12,9,11,180857,153748,164,46803,430
13,7,6,3,13,28966,24068,38,7161,509
9,5,4,0,15,144109,0,43,1126,475
23,6,17,0,6,106061,0,0,0,607
9,1,8,1,17,708399,708399,0,1994,655
10,4,6,5,7,41736,45739,51,25525,414
232,29,203,0,37,2064103,0,19,171684,534
13,7,6,7,14,122305,139596,40,52537,424
14,7,7,3,14,119727,14783,38,1235,495
28,11,17,5,6,227174,60118,96,12637,415
14,6,8,3,12,85228,60723,84,12127,439
105,7,98,2,16,758550,14684,63,8450,605
10,2,8,1,10,4852,4852,113,4852,645
27,3,24,2,8,16619,13006,0,0,474
8,5,3,0,7,39466,0,8,0,621
25,11,14,1,13,478948,557,30,3990,544
5,3,2,4,7,25153,32348,61,14200,516
9,6,3,6,5,7958,10091,128,2538,436
26,8,18,6,12,92405,78778,126,56273,455
17,9,8,5,4,95508,46435,119,10100,437
15,4,11,4,10,38327,28888,0,0,501
18,6,12,4,12,17239,15201,44,10084,512
7,2,5,2,6,44470,44470,41,0,521
17,1,16,2,8,8997,14526,35,0,585
11,9,2,2,15,72606,16585,57,6000,505
5,3,2,2,14,18077,18077,27,16870,633
47,14,33,5,14,657386,29083,94,9839,430
4,2,2,2,4,21354,11987,19,10124,495
10,3,7,1,3,11803,1637,6,1839,510
36,13,23,15,17,1421845,1909081,36,497940,463
3,1,2,1,9,7500,7500,96,13633,510
31,20,11,7,11,838392,29217,83,6470,422
57,7,50,4,8,40343,29783,97,11438,457
6,3,3,1,7,7470,782,0,0,539
39,7,32,2,11,45921,1027,74,15562,536
21,8,13,3,7,407739,83077,34,1375,437
17,11,6,8,21,753564,725590,9,619977,493
8,6,2,6,10,433145,55960,67,0,486
14,2,12,0,9,7185,0,0,0,664
4,2,2,0,11,283388,0,0,0,664
12,8,4,4,12,226584,8135,67,2760,459
32,18,14,0,14,622551,0,0,0,592
12,3,9,2,15,1506,1420,25,778,541
21,10,11,15,6,120375,217283,265,3951,427
24,12,12,11,7,88080,96053,139,17241,403
15,6,9,2,7,98115,3916,0,0,462
14,6,8,3,17,243886,781,109,4184,513
21,5,16,2,10,927969,99648,19,3094,460
16,10,6,10,7,79562,77441,198,9830,409
8,6,2,3,10,11837,11837,0,3541,533
10,5,5,2,9,572969,27794,57,14537,529
7,5,2,6,7,84618,92769,7,1659,502
14,9,5,7,11,48872,25263,19,9492,417
5,2,3,2,9,3080,1794,1,694,508
11,5,6,3,12,425523,126687,37,3881,609
10,5,5,2,11,17602,15801,20,0,496
7,3,4,0,11,5348,0,12,3906,646
10,8,2,4,7,457045,53892,73,26212,411
24,10,14,2,7,28504,12074,39,6678,540
53,14,39,0,14,594280,0,5,0,604
9,3,6,0,11,572929,0,2,0,629
13,9,4,2,23,1648978,65981,45,382,492
14,3,11,3,10,93242,90246,60,11984,491
7,4,3,4,12,19035,19035,61,10645,526
18,3,15,1,11,39432,30980,16,5572,686
11,3,8,4,9,23820,12922,115,1624,531
6,3,3,1,26,37630,16110,22,0,521
36,8,28,6,16,93925,65348,78,19997,433
14,4,10,0,9,62341,0,10,494,723
5,1,4,0,12,0,0,17,0,605
9,6,3,0,9,3746,0,14,775,546
6,1,5,0,15,0,0,6,25618,574
21,7,14,5,18,188621,97395,61,4320,459
3,0,3,0,4,0,0,1,0,644
8,5,3,1,19,282977,18793,10,18793,488
9,4,5,5,9,28978,23503,53,5555,466
28,3,25,1,8,16921,8099,8,4333,598
35,13,22,11,12,162235,182340,300,2356000,387
24,14,10,0,20,8445212,0,17,0,547
7,5,2,0,8,223597,0,6,0,548
37,21,16,5,10,651055,6186,31,898,485
48,15,33,1,13,773768,2746,2,3710,412
25,9,16,4,14,806903,179301,80,138816,429
22,9,13,3,7,261230,798,110,8359,500
7,3,4,1,6,732,3161,24,0,585
34,4,30,2,11,82244,12234,13,8094,555
18,8,10,5,10,75245,75244,60,29161,471
39,12,27,6,13,306448,35316,138,11210,420
35,11,24,0,15,78492,0,32,2800,437
10,8,2,1,44,77033,2520,32,2520,567
37,13,24,10,17,240353,186866,215,59357,421
9,7,2,2,2,40954,2927,6,1681,474
8,3,5,2,18,33257,5933,42,4882,495
5,3,2,1,8,39690,1190,4,0,537
14,6,8,8,8,52274,68772,128,16948,437
7,3,4,0,11,61293,0,0,0,726
27,14,13,0,21,763577,0,0,0,617
3,1,2,2,3,0,11903,16,0,602
7,5,2,5,6,13543,22480,3,2363,455
18,15,3,5,17,1227668,31736,78,3244,606
5,3,2,2,7,3257,3257,15,3058,524
73,11,62,9,13,137003,101119,180,57882,400
96,8,88,4,10,199689,149988,223,2221,467
8,4,4,1,11,335793,1093,13,18580,636
5,1,4,0,9,5682,0,35,0,620
11,7,4,3,17,429255,16604,146,7612,493
7,5,2,1,10,244091,3295,26,0,453
12,5,7,4,9,21454,21454,51,7290,463
6,4,2,5,8,45828,42658,57,3703,461
55,15,40,5,19,991129,25323,44,5679,480
8,6,2,4,9,85159,13269,41,7543,473
22,11,11,1,12,984134,565,15,1968,494
3,1,2,0,12,0,0,2,756,528
49,9,40,10,17,171425,153599,136,15552,453
9,6,3,3,10,422385,69611,58,29400,457
19,7,12,0,4,30968,0,1,0,640
13,8,5,0,8,472326,0,0,0,642
29,8,21,7,9,64027,21713,334,5454,477
28,14,14,16,10,61319,86906,287,21126,382
79,10,69,1,4,140983,731,13,8715,528
2,0,2,0,11,0,0,4,93366,556
17,5,12,1,7,24103,22840,98,22840,611
11,5,6,3,10,308398,23090,127,0,494
5,3,2,4,16,64282,64282,115,30024,454
22,8,14,8,11,220959,231391,172,95569,419
10,1,9,0,19,0,0,0,1582,605
12,7,5,8,19,53419,64510,181,12750,446
23,15,8,1,6,183367,238,5,1350,639
8,6,2,2,4,87825,2473,11,2706,480
19,11,8,5,4,1116111,24356,48,6582,397
17,11,6,11,14,456788,148897,94,37836,442
16,8,8,2,9,24475,3065,65,5275,440
8,5,3,5,7,302138,72132,94,29623,454
26,8,18,4,12,157373,14060,10,12872,587
17,5,12,2,27,48799,6426,63,0,502
29,8,21,5,8,32600,18845,326,16986,474
33,24,9,4,10,2168526,37580,29,5657,462
5,2,3,1,8,0,19657,16,19657,663
6,3,3,2,13,10761,1983,49,2270,566
8,4,4,4,14,20620,63622,68,54281,432
20,4,16,3,10,416894,1688,36,1685,451
15,10,5,6,13,406629,34086,81,14370,402
21,7,14,4,14,58904,44663,75,1280,450
20,4,16,1,19,20153,19803,24,19803,610
37,14,23,10,16,441044,150344,164,22718,416
9,3,6,1,13,62429,246,18,0,577
55,9,46,2,13,437164,25265,50,2091,492
48,3,45,3,17,7448,40697,193,9221,485
12,6,6,7,8,58201,65628,76,20119,408
21,10,11,6,21,1208270,1113212,99,0,453
36,15,21,10,16,789216,168206,174,36038,479
8,5,3,0,7,53501,0,6,0,557
16,13,3,6,15,376952,295962,74,82950,461
25,11,14,8,24,157987,65317,176,13977,466
20,5,15,4,10,228628,91802,71,31734,485
6,3,3,3,23,39202,35288,37,18358,539
14,6,8,5,8,14936,14936,318,8059,454
34,19,15,15,12,661720,572144,173,130261,484
21,7,14,2,18,1272056,211545,45,0,561
7,5,2,3,14,28785,23692,44,7890,626
10,4,6,0,8,26407,0,10,438,593
16,8,8,0,20,113723,0,2,606,504
22,9,13,6,11,12485,11316,221,4083,462
8,1,7,2,6,0,14209,18,9621,674
56,8,48,2,15,162411,18849,1,1200,523
29,4,25,0,26,392920,0,162,3519,448
13,8,5,0,7,463767,0,3,0,606
36,14,22,7,6,218628,4096,194,2050,528
34,10,24,9,10,133618,58027,137,11342,451
7,5,2,4,10,494467,14700,34,5585,492
13,3,10,3,12,494672,116965,64,2432,491
9,2,7,1,11,0,30660,33,0,655
18,6,12,4,26,842897,43419,68,18254,502
14,11,3,10,15,360117,181883,162,35737,422
10,6,4,5,11,52161,31160,209,15462,373
44,12,32,5,19,823736,360278,86,229061,375
27,18,9,17,18,819980,703085,237,4556,479
16,3,13,4,14,6251,63438,97,6251,465
21,7,14,7,15,339864,340787,155,586,509
31,15,16,17,11,159199,139867,120,13370,384
45,6,39,5,11,78183,113742,79,41824,465
26,9,17,3,10,430618,23211,205,24222,528
47,14,33,9,11,299352,98884,261,36282,412
19,9,10,8,3,128767,126857,51,81687,492
14,4,10,3,12,190179,8059,53,1851,504
10,5,5,3,11,9895,9895,48,51586,482
6,2,4,4,8,23365,38231,71,2962,415
11,6,5,3,6,25983,14802,29,7508,531
14,4,10,3,9,7009,15433,71,6619,674
11,7,4,1,5,216626,7030,6,7030,592
51,6,45,8,12,52291,122675,27,3754,534
6,3,3,3,7,19367,25548,67,15078,452
12,7,5,4,13,222426,24586,70,2217,466
40,18,22,0,37,838754,0,39,0,599
14,3,11,0,13,2037,0,27,0,575
30,3,27,2,16,232965,10348,69,1864,618
6,3,3,2,9,26251,2154,9,596,473
10,6,4,0,7,77116,0,11,0,484
36,9,27,10,13,134824,135113,117,61954,433
42,11,31,2,8,71589,1846,0,0,585
9,6,3,5,11,119787,74331,100,3366,459
7,3,4,2,6,3774,3431,33,2798,619
35,3,32,3,13,18425,6531,42,28934,542
14,11,3,8,7,453337,209339,333,21972,479
12,7,5,2,8,16913,13500,52,5685,469
33,14,19,0,18,279209,0,2,794,688
9,5,4,5,8,7273,7273,107,2394,530
9,6,3,0,7,111058,0,2,1305,603
12,8,4,6,11,116948,101034,121,20303,406
4,2,2,1,18,194192,36554,25,0,521
12,6,6,4,18,471017,31178,72,23970,441
27,9,18,4,12,405042,12009,202,16029,443
17,10,7,11,16,274157,335258,235,78622,465
4,2,2,2,6,3309,3309,19,0,561
11,9,2,0,19,994256,0,7,0,600
5,3,2,4,10,5213,11289,43,1250,580
23,7,16,2,15,18051,3636,59,31584,429
15,6,9,0,15,2038095,0,25,0,497
21,8,13,6,8,35227,34545,32,16721,495
17,8,9,9,15,194283,169851,96,73919,436
21,5,16,0,15,86543,0,19,1038,542
34,19,15,8,9,306787,105098,139,69640,410
7,2,5,1,8,43561,345,26,345,539
25,9,16,5,10,609641,137865,87,14359,442
11,3,8,7,10,36056,109192,12,35900,505
18,8,10,1,16,141813,248,47,1684,500
11,1,10,2,8,0,32638,34,0,657
33,7,26,4,19,261860,96751,50,3101,453
20,12,8,13,9,355953,263614,24,49759,439
5,3,2,0,15,42356,0,24,2209,598
3,1,2,1,12,4790,4790,23,4790,640
5,2,3,3,13,22052,69693,41,14754,521
2,0,2,0,9,0,0,0,0,697
11,5,6,3,12,199551,10645,24,3022,492
12,9,3,2,10,68533,9136,17,1738,489
13,11,2,8,3,290839,85063,35,0,464
21,3,18,3,9,23361,21777,44,8020,507
9,5,4,2,5,107722,14607,20,3482,476
37,13,24,13,9,420814,104115,328,38376,445
9,7,2,4,22,100471,85377,86,0,542
17,10,7,0,12,471988,0,0,0,677
10,7,3,4,11,226609,79503,40,0,503
41,27,14,12,14,2312627,137053,79,14808,453
9,6,3,3,5,85304,4317,28,3738,472
13,7,6,0,16,94921,0,16,1763,567
5,0,5,0,8,0,0,0,737,660
10,5,5,0,7,201094,0,6,412,435
31,6,25,2,7,18464,2395,5,2188,518
8,2,6,0,16,46147,0,0,0,654
24,13,11,1,14,210161,670,35,297,528
5,0,5,0,7,0,0,0,375,614
4,2,2,1,13,162127,16391,9,16391,502
4,2,2,2,13,156776,5724,0,0,581
22,3,19,5,4,26988,26988,71,16474,453
7,4,3,2,15,35780,34089,59,29117,436
5,3,2,0,10,0,0,14,132,596
27,9,18,2,9,84832,9111,91,2646,463
14,3,11,2,9,9959,17050,38,15556,541
24,10,14,3,21,622606,236470,51,30684,433
23,5,18,4,9,41144,34750,22,3207,416
5,2,3,0,6,1810,0,0,0,609
45,10,35,0,21,133343,0,56,2890,520
157,18,139,14,12,33662,35832,712,17222,415
13,5,8,3,7,5629,5629,101,5103,486
21,6,15,5,10,374845,27417,108,1057,510
17,15,2,0,6,123046,0,0,645,496
10,5,5,5,9,183962,157419,50,38980,500
23,6,17,2,6,144064,1829,24,0,535
25,8,17,5,6,213070,160130,84,0,579
19,9,10,0,8,81221,0,7,24,629
12,8,4,7,13,301275,128460,104,2176,450
15,6,9,0,4,159862,0,11,900,674
7,3,4,3,7,21616,16429,0,0,450
18,8,10,4,12,73010,49698,93,31862,459
15,5,10,4,6,45065,26160,36,8286,419
8,3,5,2,11,97808,97808,40,0,485
30,10,20,3,6,206714,3806,11,2142,443
19,4,15,7,8,416727,173985,197,10500,462
19,11,8,8,14,629249,100962,147,0,458
41,17,24,6,23,749198,94770,22,8027,435
3,1,2,1,8,9465,9465,20,9465,508
19,10,9,5,7,117091,40169,64,8851,434
7,3,4,5,7,45170,58911,77,26512,548
33,6,27,5,12,161821,161821,194,51544,442
21,3,18,0,4,342,0,0,2030,605
7,4,3,3,8,25228,25228,68,23181,461
12,6,6,4,5,20783,6143,94,3755,480
9,4,5,5,12,15220,20953,33,11439,443
20,6,14,4,19,136922,29872,42,7795,440
11,3,8,2,13,330801,14305,35,13370,555
11,3,8,3,8,123738,123738,300,21682,481
20,7,13,4,13,25786,10313,313,7814,476
43,9,34,7,13,33552,16914,163,56132,504
9,5,4,5,7,26509,26509,201,9041,417
10,8,2,1,6,28020,856,23,856,464
11,6,5,0,12,277613,0,10,0,661
5,3,2,4,8,40301,40301,62,21331,469
7,5,2,5,7,50592,39830,0,0,468
6,2,4,0,9,94835,0,9,0,537
5,3,2,0,5,33636,0,6,0,548
23,13,10,15,23,461623,520264,295,98344,424
6,2,4,0,9,315617,0,22,0,538
19,5,14,4,19,78101,30260,57,4844,450
21,15,6,11,7,81999,70776,66,5712,460
7,1,6,0,8,0,0,75,1226,646
55,12,43,1,13,231646,8860,143,18308,448
14,6,8,5,5,35782,4459,64,1266,424
30,6,24,6,13,35513,5839,412,7764,471
23,7,16,5,20,255351,28178,107,1850,511
6,3,3,1,23,37555,5065,26,0,697
5,3,2,2,10,13771,5960,27,2900,511
11,3,8,1,11,324692,694,36,4037,533
11,6,5,5,10,40908,27437,34,3164,450
5,2,3,0,5,3546,0,4,0,622
9,5,4,6,13,248554,42881,86,10572,468
3,1,2,3,7,14745,26794,57,14745,515
10,6,4,2,21,288925,3340,34,3400,480
7,5,2,0,5,29563,0,11,0,602
18,11,7,4,14,182980,14684,53,10705,492
17,11,6,0,24,148646,0,0,0,718
46,2,44,1,18,8422,1234,25,2011,565
18,11,7,8,23,564827,420131,180,1820,486
13,9,4,3,10,561516,145034,57,0,488
4,2,2,0,2,54683,0,1,0,518
36,14,22,11,7,125648,58411,111,4339,439
5,2,3,0,7,52756,0,13,0,735
21,10,11,1,9,678458,1470,26,389,567
82,10,72,5,15,144886,36068,154,7621,427
19,6,13,2,10,92875,14540,19,2503,489
12,8,4,0,6,260940,0,8,3829,585
11,5,6,0,6,377096,0,7,857,509
29,7,22,6,7,19810,13755,84,8917,503
16,9,7,3,15,90334,4447,19,5073,522
38,10,28,7,19,112799,55105,88,22387,430
6,4,2,3,8,9750,7692,42,13447,481
23,5,18,4,15,108067,108067,58,87769,490
10,2,8,2,16,8818,8818,56,7418,457
15,9,6,6,9,56183,46697,49,14425,417
17,10,7,7,8,49498,30549,75,26180,433
22,9,13,0,24,456754,0,30,0,620
14,6,8,6,8,41740,30335,122,13748,432
8,3,5,2,11,35696,54977,0,0,570
14,8,6,0,21,1032664,0,0,0,677
13,8,5,5,10,35877,13638,50,10342,519
16,9,7,11,17,580290,458543,164,28196,435
29,18,11,0,15,6678267,0,2,0,568
8,4,4,3,5,9815,9815,38,5916,635
14,8,6,4,13,33815,24831,81,7289,446
12,2,10,0,9,8081,0,14,1050,554
35,11,24,4,14,166607,10414,24,5380,526
10,8,2,7,12,258025,36665,46,15369,413
8,4,4,6,7,119563,134101,92,33415,498
13,7,6,1,8,387605,4425,16,364,595
7,2,5,3,10,107053,107053,0,0,449
26,8,18,5,33,32808,12995,41,7390,489
11,7,4,3,16,348910,27992,24,8851,427
34,12,22,0,8,602859,0,3,2221,647
7,4,3,4,10,6941,6941,62,3983,374
11,6,5,5,13,39085,39085,187,25372,459
5,2,3,2,5,1338,1338,19,1469,561
5,3,2,2,3,53636,28851,94,27566,425
20,10,10,8,5,87367,75946,112,45032,449
4,2,2,4,7,18831,40150,50,7854,529
8,4,4,1,9,314439,943,22,943,502
17,5,12,0,8,23232,0,26,486,607
3,1,2,1,16,14966,14966,5,14966,540
8,5,3,3,9,2462,22635,43,1878,496
15,10,5,1,28,136236,1218,5,0,622
12,10,2,10,9,229704,166478,158,28131,431
14,8,6,4,17,297821,29014,67,19689,389
2,0,2,1,3,750,750,0,0,557
20,14,6,1,12,182694,230,8,1682,560
5,3,2,1,17,792233,72985,6,0,678
21,10,11,1,12,462598,21232,58,0,628
20,4,16,2,14,21797,21506,126,20172,467
14,2,12,2,14,10107,10107,38,2550,515
89,6,83,1,13,389057,6888,15,6888,473
8,5,3,4,9,176299,17991,58,9379,484
15,4,11,5,10,44434,63488,26,20277,437
36,9,27,5,12,45537,2925,224,3361,459
18,8,10,5,16,324427,144441,119,3720,463
17,2,15,0,8,4008,0,22,736,634
6,3,3,2,10,3851,3851,38,2674,644
9,7,2,7,14,144875,105489,117,4600,531
15,8,7,4,8,149288,130408,77,68876,450
20,12,8,7,7,276192,98667,49,3597,478
16,6,10,1,7,196975,190,79,227,528
6,3,3,2,11,11709,11709,44,0,537
17,8,9,0,9,221316,0,7,1219,630
12,4,8,0,15,9597,0,25,5955,645
18,16,2,11,16,435661,269857,189,570,447
9,4,5,3,13,389995,53538,2,706,498
34,8,26,6,13,93409,29680,18,12855,443
21,11,10,9,16,1188030,660641,224,143,585
24,4,20,4,10,17124,20746,54,11211,494
13,6,7,8,13,10680,35700,8,9063,495
6,4,2,3,10,103673,66880,38,537,478
10,6,4,5,7,154540,154539,148,74835,395
11,5,6,5,10,88893,50137,82,0,503
6,1,5,1,13,17098,17098,8,0,482
21,4,17,4,13,108178,45275,110,35822,493
6,2,4,2,12,2456,2456,23,461,517
9,7,2,5,12,360971,143937,65,11591,436
29,17,12,16,17,183295,187319,215,55212,421
16,7,9,9,12,67372,66487,106,22680,473
42,25,17,3,12,437045,16509,107,314,536
5,2,3,1,6,12695,12157,32,0,563
11,5,6,2,18,160634,16747,37,2350,473
12,7,5,7,13,75649,32945,148,3420,458
29,17,12,16,6,347825,91353,135,5994,420
25,1,24,0,12,0,0,0,0,784
13,7,6,6,9,34410,22343,54,6748,424
13,9,4,1,13,232318,8997,99,13684,437
15,12,3,2,10,267948,13584,35,10584,570
30,14,16,7,14,604106,405425,89,16981,500
27,6,21,4,12,16017,16017,149,5565,550
3,1,2,0,14,0,0,14,3159,664
108,14,94,11,17,1217113,79615,81,12023,473
15,5,10,1,12,362458,7636,20,7636,501
38,2,36,1,15,575,575,17,575,587
26,9,17,2,14,339230,11235,56,0,507
9,6,3,3,8,17600,5618,15,4734,552
11,3,8,0,12,33740,0,0,0,607
9,5,4,0,6,24350,0,66,3515,627
17,5,12,4,9,9193,8702,322,5433,506
5,2,3,2,16,208056,18367,4,1997,460
39,15,24,10,12,106768,41840,173,1185,418
23,3,20,4,8,19379,18413,43,7485,496
17,6,11,2,9,42798,18466,58,13992,477
16,11,5,0,8,486593,0,0,46,657
21,7,14,3,15,265320,225482,24,109226,492
17,11,6,3,4,660640,6556,0,0,664
7,4,3,2,13,346811,5279,3,3175,494
9,4,5,5,13,34811,40087,87,6923,532
20,8,12,3,18,206153,53335,74,17042,480
12,7,5,0,9,418011,0,102,3473,469
10,7,3,6,12,41981,63744,6,13733,430
6,4,2,3,17,11670,5470,28,2376,642
17,6,11,0,9,337575,0,9,53,580
17,5,12,0,13,107725,0,2,13044,494
16,12,4,0,12,219691,0,45,0,519
6,4,2,3,6,12106,23453,60,3175,502
6,3,3,1,11,321073,4770,19,0,641
19,6,13,0,8,424193,0,11,1,501
14,2,12,1,18,13008,1321,23,1769,658
66,21,45,19,21,1118527,855943,406,78616,449
61,7,54,6,14,80270,47811,86,24984,487
9,3,6,3,7,25852,25852,28,20893,519
10,3,7,1,14,695,457,23,537,560
17,6,11,8,15,70159,98526,170,11905,421
11,8,3,4,18,366640,11204,0,0,465
7,5,2,5,7,16445,22223,63,9278,449
31,8,23,8,17,88725,26461,187,10115,479
10,4,6,0,13,80949,0,0,0,687
11,8,3,7,9,78682,78120,231,45349,379
9,6,3,0,4,85794,0,1,1964,606
11,2,9,1,10,7254,7254,25,7254,675
5,2,3,1,13,94483,17321,12,0,478
19,12,7,0,9,574819,0,2,3322,594
10,6,4,7,7,322578,58506,63,13231,440
54,8,46,4,3,62764,52283,23,9512,426
15,10,5,5,11,187084,40566,95,10527,466
8,4,4,3,10,633339,85331,42,0,477
27,10,17,6,13,127999,41443,99,18604,459
19,7,12,6,18,164874,153424,53,12279,475
19,9,10,4,28,314771,14691,67,7210,452
17,9,8,3,6,271058,161375,74,0,484
14,10,4,8,13,290487,157893,144,7722,414
16,9,7,14,8,207316,260461,474,2575292,460
11,8,3,8,12,42257,42257,26,23586,343
37,5,32,4,13,393697,236877,36,606,440
33,9,24,0,9,37614,0,4,121,576
19,8,11,8,14,2436368,422445,150,0,460
33,13,20,8,17,240397,89801,129,24682,415
28,10,18,3,11,135482,5379,23,19764,454
6,4,2,4,7,9979,8066,79,1541,440
12,7,5,1,19,13483,1533,14,0,538
2,0,2,1,6,5956,5956,27,0,478
16,8,8,5,25,335538,303511,78,0,457
17,7,10,0,13,1267383,0,1,495,687
6,2,4,2,16,742566,742566,59,36367,579
26,9,17,5,10,140321,98665,108,27767,438
30,12,18,9,14,423777,106346,334,19405,460
28,7,21,2,12,4762,4548,92,973,516
13,4,9,1,6,2550,550,4,1323,602
30,8,22,0,11,213895,0,109,971,572
7,4,3,3,9,37863,26679,16,12701,591
4,0,4,0,9,0,0,0,0,606
6,3,3,0,8,4534,0,15,10881,466
13,5,8,1,15,201259,22063,15,22063,493
46,9,37,6,9,49817,15640,233,1304,481
45,6,39,2,17,510855,9216,80,8297,453
19,9,10,4,6,163783,3683,24,2599,513
17,10,7,4,16,381085,10720,42,4882,517
21,8,13,9,9,86367,77485,0,0,439
5,1,4,2,8,19442,19442,21,643,611
4,0,4,0,5,0,0,2,6586,572
25,13,12,0,6,497031,0,5,0,579
29,11,18,9,13,339420,296856,215,56956,532
3,1,2,1,5,2448,2448,0,0,435
7,5,2,6,7,47860,67309,72,0,493
45,7,38,5,13,472066,49165,270,42581,459
25,10,15,0,16,4053147,0,1,274,531
12,5,7,2,11,39548,1445,3,1293,426
30,16,14,0,13,340459,0,25,0,603
4,2,2,2,10,7673,7673,8,907,534
32,10,22,1,23,1707193,1009,51,32013,473
10,7,3,4,11,334450,10813,66,6619,457
5,3,2,4,6,14671,12505,51,4921,441
3,1,2,2,8,20154,20154,13,19671,566
38,7,31,0,5,65920,0,20,6384,454
6,4,2,3,14,297715,27451,27,14409,431
8,3,5,4,7,30713,35623,84,0,510
6,4,2,0,5,17356,0,2,0,502
6,4,2,0,8,253180,0,5,1197,676
63,20,43,18,14,409663,225119,335,70200,439
15,11,4,10,4,60598,33572,71,1912,438
13,2,11,0,11,282528,0,9,2059,657
32,7,25,5,13,347501,27510,290,22721,529
16,12,4,0,14,479035,0,21,1265,455
11,7,4,0,14,258971,0,87,9444,440
10,3,7,1,11,10495,1245,100,3226,525
16,8,8,6,7,262756,59920,91,18719,465
4,2,2,2,15,44443,44443,47,298,490
22,14,8,3,7,117984,10040,49,5230,490
13,9,4,6,11,35002,33772,38,19110,349
29,3,26,0,14,70744,0,169,5126,590
16,7,9,0,11,430505,0,20,0,562
6,2,4,2,14,23960,23456,18,70928,518
15,3,12,3,10,13907,13781,101,15714,494
12,8,4,4,7,43524,16307,238,6164,487
12,7,5,6,18,260815,55549,1,5345,468
16,8,8,0,13,287204,0,7,200,619
15,4,11,3,18,22955,10018,32,4276,446
25,6,19,1,8,126954,2391,32,3504,513
10,8,2,4,8,272703,1056,23,212,543
14,9,5,3,11,83721,81005,69,0,546
34,15,19,0,13,1916029,0,24,0,530
7,4,3,0,7,40981,0,15,3939,432
29,10,19,1,10,346562,14960,11,14960,496
13,5,8,6,8,39806,25859,57,10678,403
12,2,10,6,15,30614,67962,105,0,502
65,17,48,14,26,866974,220035,213,33755,423
11,7,4,2,10,36415,10778,7,1638,624
9,7,2,5,20,397214,383234,114,230728,486
9,5,4,4,8,51670,37550,80,5694,506
7,3,4,2,14,1312,1312,13,772,417
10,4,6,1,14,567943,1200,9,172,451
8,4,4,2,8,21838,828,9,79,503
6,2,4,2,15,19215,17582,51,1987,506
7,3,4,2,7,47681,13067,191,15892,506
16,9,7,8,9,126295,103909,181,821,507
14,10,4,8,10,837086,172473,155,28503,409
10,7,3,5,18,11201,9248,70,4953,406
9,7,2,5,12,5611,215011,130,2977,497
16,9,7,7,14,231265,161341,130,108560,487
6,4,2,3,8,46906,19184,86,13837,525
8,3,5,2,10,12444,12444,27,11128,563
42,12,30,1,21,347205,4086,0,0,453
8,4,4,0,8,241951,0,3,0,614
21,10,11,0,22,656409,0,1,0,633
29,4,25,5,15,18662,12000,77,3498,461
21,6,15,1,8,109601,12555,43,12555,620
16,0,16,0,11,0,0,40,1069,601
6,3,3,2,7,6099,5247,10,1510,451
15,10,5,0,16,3142316,0,5,0,641
6,2,4,1,13,1831,1831,28,0,527
17,3,14,3,7,3692,3691,48,2219,482
12,4,8,4,9,11702,24118,95,9690,520
22,6,16,0,9,80279,0,6,19874,514
22,12,10,0,12,789335,0,0,569,689
52,24,28,7,15,406569,143714,386,17784,427
57,5,52,0,14,45485,0,2,1084,591
19,11,8,2,12,63452,2710,71,5971,506
20,8,12,0,17,582071,0,11,0,640
12,7,5,3,9,26690,14385,56,11362,551
41,9,32,2,12,225252,81648,2,369,459
43,9,34,3,14,237933,6853,0,201,623
6,3,3,3,9,6567,5664,50,5939,459
21,12,9,11,13,340065,166316,111,17129,423
24,11,13,12,18,233192,432277,218,58153,539
8,5,3,4,7,69445,38387,63,14446,464
8,5,3,2,7,36554,471,7,1317,444
12,5,7,3,4,10915,8777,13,1593,448
7,1,6,1,9,7364,38280,25,0,595
20,10,10,0,8,839282,0,1,0,681
18,7,11,2,17,167459,11971,13,11789,520
21,6,15,0,38,334085,0,6,0,464
6,3,3,1,6,71694,405,5,514,513
10,4,6,3,14,82735,18220,0,0,519
63,12,51,4,14,225986,28736,398,5604,528
24,2,22,1,8,6907,6907,21,13814,578
11,4,7,3,16,313464,25216,126,18414,486
7,3,4,2,8,171599,21688,5,164,555
20,7,13,6,15,71243,23767,275,2317,459
5,3,2,0,9,56814,0,1,0,545
15,12,3,0,5,26207,0,1,228,676
5,1,4,1,7,431986,18770,1,0,648
9,4,5,3,8,110459,112644,49,84709,489
73,5,68,4,9,190360,160760,55,148261,469
44,4,40,3,21,419555,20453,95,4250,550
9,4,5,2,7,41539,9174,5,420,494
12,2,10,0,10,0,0,6,0,719
8,5,3,4,6,17888,10484,94,7085,471
19,7,12,5,6,114228,62666,143,9548,495
24,13,11,1,19,738200,4351,25,8149,505
42,3,39,2,16,28421,28996,48,19121,479
16,10,6,9,8,203895,250982,181,31646,382
6,1,5,1,4,13605,408,9,408,670
37,8,29,6,7,72207,47884,129,11159,452
13,8,5,12,7,112085,164609,248,31346,490
9,6,3,6,6,29571,24588,48,5892,421
13,3,10,1,7,45717,7842,14,7842,634
6,4,2,3,10,66179,65578,39,61963,448
27,12,15,1,16,463117,788,9,788,510
15,6,9,1,11,229633,2047,28,2047,630
24,12,12,0,10,4624405,0,32,0,576
13,6,7,3,9,241334,7314,24,0,488
10,3,7,3,16,305040,15008,50,8761,468
7,5,2,5,5,50429,49295,222,17814,474
25,14,11,15,12,96449,112994,236,23397,385
6,2,4,1,9,4802,4606,25,174,561
18,13,5,14,14,44068,45864,184,6023,408
11,8,3,6,4,47625,27776,48,9883,396
10,7,3,3,28,51093,8196,23,939,519
22,12,10,5,18,89812,75170,37,14363,465
15,6,9,8,11,97347,69992,107,1519077,508
18,7,11,3,10,374282,18687,63,1879,624
19,6,13,2,5,84911,4205,7,0,534
6,3,3,1,15,142168,1357,0,0,644
4,1,3,0,3,0,0,1,1000,600
15,7,8,3,8,31163,15961,208,12407,491
20,7,13,2,10,81755,6920,0,0,539
9,4,5,0,9,131629,0,0,0,666
19,5,14,2,9,35414,10566,1,512,563
13,7,6,0,9,100524,0,9,2026,539
7,5,2,4,7,264600,13709,75,6326,493
10,6,4,5,5,14890,14890,231,6085,453
5,2,3,0,8,7834,0,0,0,671
38,8,30,3,13,182147,11675,2,1469,524
44,13,31,1,7,618515,111,40,1056,524
31,12,19,13,17,460561,353266,190,110965,418
54,17,37,1,9,283109,2600,4,7262,442
6,3,3,0,2,92913,0,61,971,599
20,6,14,4,12,29015,27483,74,11640,505
5,3,2,1,7,11208,3223,21,0,455
11,7,4,7,8,521631,134900,52,84620,389
5,2,3,0,3,900,0,0,0,605
15,6,9,6,12,67524,44413,209,14208,443
24,15,9,0,31,204342,0,2,301,617
15,6,9,3,8,65842,38082,101,5748,494
14,4,10,0,12,5752,0,1,873,599
5,3,2,2,16,70591,70222,29,43877,468
26,6,20,7,12,101041,93594,100,36443,519
19,12,7,8,7,76575,65925,74,39688,411
8,4,4,5,9,35287,27821,105,14800,451
12,10,2,6,3,49206,20049,32,2032,488
14,3,11,3,22,141033,141033,121,20030,439
36,9,27,6,14,27223,16563,227,7566,449
9,5,4,6,14,50895,65901,91,12459,457
28,14,14,9,18,1315227,451526,230,3402,491
3,0,3,0,4,0,0,2,0,629
6,2,4,3,7,72838,27756,43,0,555
21,5,16,7,9,410206,259082,103,725,446
7,5,2,3,10,23947,20412,54,6563,510
29,10,19,1,6,93520,2204,86,480,454
13,9,4,7,14,623044,149409,157,8612,477
22,2,20,2,11,87047,71079,25,310,648
4,2,2,2,3,31175,4228,14,0,513
6,1,5,1,5,3924,3924,0,0,634
12,5,7,1,4,29954,10274,14,10352,569
38,17,21,0,9,1089737,0,2,0,577
13,9,4,3,8,40048,15113,85,2077,525
72,8,64,3,14,64818,46974,24,28509,420
27,1,26,0,8,0,0,1,1746,575
39,8,31,2,21,401509,75213,29,74870,503
15,6,9,3,11,14884,9152,54,8058,557
18,6,12,0,9,22342,0,0,1000,558
19,11,8,6,16,25272,9426,70,0,474
6,3,3,1,16,3806,3171,7,3171,537
11,7,4,7,9,58720,43027,323,8992,515
4,2,2,0,3,12155,0,0,0,607
18,14,4,5,14,363754,27328,134,12864,384
28,5,23,0,15,13437,0,125,2825,508
7,2,5,1,3,11683,2454,6,0,594
3,1,2,0,12,4448,0,0,0,619
9,4,5,3,10,21229,21229,46,5503,423
27,11,16,5,6,140236,46502,71,9178,485
35,11,24,6,14,222460,28170,145,1971,454
4,2,2,0,7,97772,0,1,0,634
10,4,6,2,11,454742,126518,26,69963,708
8,5,3,2,15,12909,12909,68,8383,497
4,1,3,0,9,0,0,0,0,634
22,10,12,3,14,1135517,47935,74,16555,484
41,16,25,7,16,335292,96921,144,38783,425
8,5,3,8,5,58325,84703,120,31634,462
11,4,7,3,6,32868,26357,111,30716,438
19,13,6,7,10,68292,65090,275,3720,447
31,5,26,1,17,417580,2692,35,1121,673
14,5,9,6,7,59485,65485,105,10350,432
14,3,11,0,2,31579,0,3,303,535
18,11,7,14,8,828429,671767,151,142139,407
4,1,3,0,8,580,0,0,0,697
11,9,2,4,21,868738,23987,74,899,510
9,6,3,0,9,41632,0,0,0,663
16,7,9,7,14,55407,55407,151,21088,493
7,2,5,3,12,213813,16199,65,0,459
17,3,14,5,12,9359,17373,66,4849,617
27,6,21,4,10,16614,14767,127,3066,462
8,5,3,3,22,36191,6823,26,6391,530
10,8,2,6,14,17622,17195,36,5150,408
7,3,4,6,9,119025,199892,34,70432,461
6,2,4,2,8,1385,1385,24,1181,463
6,3,3,3,10,14133,14133,34,3989,423
9,3,6,2,9,15004,23492,49,0,524
12,6,6,0,20,331172,0,3,0,550
4,2,2,1,7,10888,8325,0,0,498
17,6,11,1,16,160245,11166,15,10961,550
5,3,2,0,7,42573,0,0,0,630
10,2,8,3,9,12939,16828,75,7876,532
12,1,11,3,9,3820,17351,18,1382,570
170,12,158,3,12,34317,15399,54,0,467
26,8,18,6,11,45880,36414,217,12672,435
5,0,5,1,5,529,529,11,529,607
12,6,6,6,8,50253,49353,40,8089,372
53,10,43,2,11,344517,24460,49,18643,463
16,8,8,0,17,34480,0,2,672,496
7,2,5,1,12,9746,1707,5,912,516
14,10,4,2,7,70294,4033,46,5231,437
6,2,4,0,13,14830,0,0,0,542
11,7,4,5,5,16546,11270,9,3326,432
43,5,38,3,8,220133,42280,44,23462,462
38,6,32,0,10,664120,0,0,0,677
21,3,18,3,8,21610,21610,278,18536,438
5,3,2,1,2,86957,9065,12,9065,539
11,2,9,1,16,8006,7591,14,792,524
20,9,11,8,6,38584,36101,328,8601,448
10,5,5,5,20,362441,88192,110,17430,540
10,4,6,0,3,249637,0,6,985,601
25,10,15,9,8,78010,82568,355,23659,440
40,14,26,5,8,146110,22651,228,2244,451
10,6,4,0,12,410482,0,4,27177,638
9,1,8,2,7,3028,3028,32,1873,612
25,10,15,0,14,1297812,0,4,2608,615
20,7,13,4,9,107082,49534,302,28593,377
14,7,7,8,9,22857,133127,58,8212,414
37,6,31,3,13,143968,11316,47,14390,499
11,9,2,0,6,87678,0,0,0,580
8,4,4,1,12,322590,5078,13,3850,633
11,1,10,1,12,26995,3542,47,19967,625
39,12,27,3,16,961984,17531,60,11654,507
19,15,4,0,9,474034,0,10,5885,595
31,4,27,1,15,69439,1450,31,2958,528
4,2,2,2,12,61675,56855,50,0,556
6,4,2,4,9,44655,44655,52,27093,493
78,15,63,6,20,459601,212382,97,60236,492
13,6,7,3,8,79437,59637,112,921,522
20,8,12,8,16,145779,151116,120,69615,507
31,9,22,5,7,17267,17267,152,7637,431
4,2,2,3,8,12947,12947,54,3714,508
29,8,21,5,17,79162,39680,290,8630,511
17,5,12,0,3,4533,0,0,0,633
25,8,17,0,9,1077535,0,4,0,590
25,11,14,0,17,196860,0,33,1186,533
11,3,8,4,10,24803,24803,48,14621,476
19,3,16,0,5,11411,0,0,0,625
59,15,44,2,14,281801,2827,7,1202,556
7,5,2,1,9,350980,150,3,0,557
51,13,38,3,16,324256,82581,84,0,524
22,4,18,4,8,112583,111827,64,107780,423
17,6,11,3,45,24862,24410,29,33203,480
13,4,9,2,8,53519,4575,93,0,519
27,12,15,1,9,280202,3540,200,19694,517
19,6,13,3,10,14445,4020,5,1420,397
23,8,15,1,12,42978,4073,40,0,611
23,12,11,0,12,687005,0,2,570,634
21,8,13,1,9,96462,1965,6,1965,598
19,7,12,0,16,147599,0,5,0,689
28,7,21,4,10,455390,58636,40,19440,453
9,7,2,5,19,69048,45032,105,21300,490
9,1,8,1,11,966,966,4,2898,571
23,7,16,4,14,151533,22233,22,2936,474
16,7,9,8,10,69517,148050,122,36805,387
5,3,2,0,8,31592,0,0,1175,680
6,2,4,1,14,6910,6910,23,4936,604
12,1,11,1,18,3245,2405,22,0,536
38,27,11,3,13,1228802,8850,36,1038,487
14,10,4,10,7,102467,98333,157,28287,466
5,2,3,1,8,36961,477,2,477,476
36,11,25,5,16,142786,42347,84,19843,441
11,4,7,3,16,154521,122663,63,66893,477
13,5,8,4,13,66146,36315,94,23588,407
12,2,10,2,5,25042,17091,33,14284,445
72,7,65,0,13,173681,0,27,477,629
7,3,4,1,7,319631,2712,25,0,530
28,14,14,11,17,253422,110305,219,6209,444
18,5,13,2,23,56165,48117,4,43264,543
5,1,4,0,1,2053,0,1,1000,515
31,4,27,2,9,52312,52312,84,52083,526
45,10,35,7,11,117496,108237,139,51715,449
22,8,14,3,8,41806,23211,38,5250,435
20,13,7,6,14,505948,49173,77,2238,495
10,5,5,3,15,12469,33811,50,21342,571
19,7,12,4,9,234354,162587,264,3964,466
6,4,2,3,15,23475,23475,69,18085,538
34,5,29,0,13,10051,0,545,10314,494
11,7,4,0,12,386218,0,23,0,566
6,2,4,1,7,324863,4706,31,4706,555
34,5,29,2,9,329851,20941,160,17477,506
7,4,3,0,10,338754,0,0,0,620
7,5,2,0,4,160611,0,0,0,614
32,2,30,2,12,100340,100340,48,54320,562
14,6,8,3,12,19616,19616,81,0,536
28,19,9,14,20,660942,158297,0,0,465
15,5,10,0,7,30492,0,42,767,528
6,3,3,1,13,2000,5433,5,6037,645
5,1,4,2,9,16774,16774,88,15250,576
41,3,38,1,12,77293,9711,14,9711,571
7,1,6,1,14,43265,40565,34,0,519
7,5,2,5,11,32177,26846,47,10674,515
7,3,4,4,7,12267,19847,78,0,490
25,11,14,6,11,48044,20082,146,8801,515
12,1,11,2,19,0,51758,31,0,663
16,8,8,2,24,618218,40973,144,45769,423
36,5,31,0,18,338213,0,0,0,686
19,8,11,5,8,29801,31995,54,12243,501
7,0,7,0,3,0,0,0,0,610
13,6,7,0,9,34661,0,0,0,628
12,9,3,6,13,20441,18129,56,7600,453
15,2,13,2,9,20932,15917,34,0,489
23,7,16,6,5,27647,16680,134,7619,415
28,4,24,1,18,248842,888,211,4282,476
13,4,9,1,12,15115,2701,0,0,505
7,3,4,0,5,167989,0,4,1023,658
37,16,21,8,23,419610,150962,19,7152,396
23,6,17,5,12,319840,99362,65,87211,493
18,6,12,3,16,336926,23403,73,10046,523
14,4,10,3,15,271281,210844,36,3792,539
11,1,10,2,13,3170,14539,39,3170,505
9,4,5,0,6,59594,0,23,8602,501
19,7,12,6,5,22650,9104,88,6053,456
18,11,7,9,17,455704,71165,170,597,457
34,19,15,7,15,332344,35119,56,23418,431
11,9,2,9,15,366443,366442,125,100364,502
22,3,19,2,12,5574,5574,37,5340,490
16,6,10,1,12,100335,1413,23,1413,549
22,13,9,10,4,135670,44926,46,14391,452
6,3,3,2,12,56314,40766,34,25326,448
18,6,12,2,7,12613,4013,40,2520,477
12,2,10,0,11,22429,0,0,357,581
5,3,2,3,6,12123,12735,46,0,456
6,3,3,3,8,9945,10216,8,3625,552
9,3,6,0,6,43935,0,0,0,685
21,15,6,0,8,418690,0,0,0,610
9,3,6,3,17,49470,59422,3,21448,527
8,4,4,1,24,41336,12773,32,0,534
9,6,3,6,13,371480,71623,125,19289,510
8,4,4,4,12,406681,48646,45,1050,447
8,6,2,6,7,18776,18776,414,12080,508
12,9,3,5,5,46887,24447,158,24947,486
10,6,4,2,7,16564,13822,44,11857,569
6,2,4,2,8,53431,51331,94,561,537
32,6,26,2,9,58746,25647,242,15427,515
30,10,20,6,17,650713,169271,146,11565,434
21,8,13,7,10,86777,49909,257,14991,454
11,9,2,5,69,41530,20266,84,14654,497
22,10,12,6,6,33310,31459,9,8627,497
11,7,4,6,8,16693,12800,46,9055,423
10,2,8,0,12,74485,0,0,0,714
26,10,16,0,9,212821,0,15,1369,598
12,6,6,1,28,43985,33677,21,0,608
5,2,3,1,15,5367,4960,0,1699,608
16,10,6,9,6,245656,154361,191,0,512
23,3,20,2,8,28252,11511,26,2800,482
10,6,4,3,19,82674,81854,112,5860,558
17,4,13,4,10,32690,11379,22,3843,544
8,4,4,2,11,49156,32937,12,20858,563
4,2,2,3,7,5430,5430,54,3831,487
4,2,2,2,4,7168,256,30,1276,530
27,8,19,1,6,93981,811,28,1481,532
10,6,4,3,14,29632,28632,70,15557,514
12,2,10,0,10,0,0,6,0,713
6,2,4,3,6,22361,22361,19,14906,489
11,6,5,0,9,8579,0,8,0,628
6,3,3,1,15,0,54341,22,0,572
32,8,24,3,13,39487,1654,312,2675,544
13,10,3,4,15,59563,34556,52,18342,438
4,2,2,1,9,10088,10088,3,10088,545
19,5,14,1,11,350002,33329,49,1415,610
15,13,2,11,6,30163,16124,55,2398,383
8,4,4,4,11,48237,48237,117,25017,426
41,13,28,4,10,684100,16732,63,6500,459
6,1,5,0,2,16028,0,0,0,664
18,2,16,3,11,66176,31852,42,0,492
9,2,7,3,16,559138,559138,29,22055,496
55,9,46,0,21,271768,0,11,4716,482
18,11,7,0,7,134101,0,10,1180,579
5,2,3,3,14,18456,24972,42,0,500
125,15,110,9,17,159150,83257,128,5346,427
19,10,9,5,12,267350,20857,26,5604,477
15,5,10,5,8,31339,28512,105,9810,556
52,6,46,1,19,233242,32534,34,32534,557
20,3,17,2,16,28085,16847,10,8079,497
175,3,172,0,10,80245,0,0,0,626
18,14,4,10,11,31036,11114,187,2244,475
4,2,2,1,3,70484,484,23,484,581
9,4,5,4,7,10065,8813,93,1463,451
22,9,13,0,14,629729,0,52,4445,507
11,7,4,5,17,280818,142497,47,23569,458
11,5,6,3,13,284536,16176,51,6784,581
28,14,14,0,21,1167185,0,0,20,689
10,7,3,3,7,336409,69970,33,0,454
19,1,18,1,6,15718,6524,14,0,570
11,5,6,2,8,51574,3049,8,2200,597
13,9,4,4,14,177408,35802,1,1392,558
22,10,12,0,19,467031,0,12,0,547
22,11,11,0,16,935877,0,9,0,497
16,6,10,1,11,276650,7573,28,0,555
5,1,4,1,9,1462,1462,0,5358,525
12,4,8,0,9,225017,0,10,1329,589
10,4,6,2,6,194431,12118,25,8071,469
13,11,2,7,17,831267,832612,87,330083,449
16,9,7,1,5,2209392,461,7,461,465
8,4,4,2,9,23667,19766,0,0,517
14,4,10,5,5,154068,33991,82,19215,484
13,8,5,1,9,231333,129041,23,0,540
20,4,16,3,7,171792,45811,0,0,517
20,17,3,12,12,870863,122896,232,3362,414
232,9,223,5,15,142429,33233,151,16602,500
26,13,13,0,69,727347,0,9,1998,562
21,5,16,1,13,3797,236,7,1665,465
20,7,13,0,9,47097,0,79,1500,587
26,8,18,1,12,250202,42983,52,42983,469
5,3,2,1,11,311041,795,17,32514,628
24,13,11,14,8,61381,71793,144,10183,382
14,4,10,2,19,319763,28849,70,0,635
18,2,16,2,12,18955,18158,94,9501,649
29,13,16,2,9,127096,2262,2,82,612
15,12,3,3,16,422350,9455,19,1081,504
15,5,10,5,10,53065,53065,349,33717,465
29,14,15,13,9,159701,165233,257,5683,492
15,4,11,3,15,68084,44440,60,28181,613
6,4,2,1,9,12762,200,5,674,532
29,19,10,1,32,2762735,3023,12,15430,502
8,5,3,0,5,212207,0,0,0,538
18,9,9,12,19,297124,394235,167,66768,453
26,4,22,1,8,15929,559,93,559,591
10,4,6,5,11,42705,27787,49,7146,356
15,7,8,2,14,39130,8555,62,4712,444
24,8,16,1,8,836939,94024,25,3094,448
6,2,4,1,13,9002,953,25,0,522
43,5,38,4,13,55139,59432,45,23723,577
12,8,4,3,10,87142,5506,56,2257,495
6,4,2,2,15,108483,105999,0,1755,522
6,3,3,2,6,5043,5339,14,2474,552
6,2,4,1,9,2789,11096,26,3468,606
16,13,3,0,12,272554,0,22,0,581
7,2,5,0,14,9805,0,0,0,646
11,5,6,2,20,1422614,2563,53,0,562
71,11,60,0,10,711973,0,34,7050,479
21,5,16,5,9,48975,52625,128,11700,454
20,6,14,6,11,49308,50907,237,4973,446
9,3,6,5,6,42445,54222,165,0,512
14,4,10,1,7,259551,3854,44,770,501
8,3,5,0,3,87261,0,1,4813,590
93,18,75,8,13,480416,100288,398,43189,421
11,9,2,7,5,39014,36156,134,6902,505
55,10,45,3,9,594533,1726,18,1055,570
14,9,5,1,16,198670,4837,29,4837,491
4,1,3,0,28,226356,0,15,8451,583
12,10,2,2,13,137313,1584,51,0,447
10,6,4,0,11,69554,0,50,9080,678
8,4,4,0,2,10421,0,3,2499,482
25,9,16,5,16,336015,45660,36,30386,441
8,4,4,3,12,105251,31429,12,3596,482
50,25,25,21,21,547157,215730,142,14743,456
9,2,7,1,5,14910,2454,1,2454,580
23,16,7,6,12,414518,30001,79,0,535
19,13,6,0,6,100509,0,6,818,593
17,3,14,3,7,380705,17283,35,7330,491
16,7,9,8,10,48693,68742,129,13705,443
6,4,2,0,4,156704,0,1,0,590
12,3,9,3,9,309837,17037,0,0,451
9,7,2,5,9,36778,19643,91,2042,561
35,3,32,4,10,8538,8538,72,9177,486
14,6,8,1,8,85114,2680,10,0,497
4,2,2,1,12,6574,1079,7,0,471
23,7,16,1,27,10148,269,32,8410,673
8,5,3,2,14,331944,4947,50,0,486
7,5,2,4,9,38634,35544,91,470,534
9,7,2,1,6,21971,798,0,0,537
9,7,2,5,8,64102,61378,10,18613,403
20,10,10,10,5,62809,41361,73,24145,450
22,13,9,2,13,178105,3177,9,920,595
11,5,6,3,15,21453,14397,35,11301,531
36,9,27,6,13,30911,23396,152,9520,489
10,7,3,3,15,560262,37018,55,21307,517
20,10,10,8,2,78147,34183,115,14395,337
16,8,8,5,7,65005,15321,19,3700,516
29,12,17,5,6,72626,46397,67,8311,424
26,4,22,1,4,123596,108,1,0,602
15,8,7,3,10,89703,14192,101,0,450
8,2,6,1,13,78568,26410,31,43305,520
7,3,4,2,7,6978,6978,198,9721,533
19,6,13,6,16,39011,37360,7,9753,432
15,6,9,5,11,477842,25860,75,10857,482
12,7,5,5,12,288599,72728,38,2577,442
5,2,3,1,9,4215,2050,21,2050,534
7,2,5,2,8,5888,15653,21,0,625
16,10,6,3,12,25719,10598,14,0,486
143,130,13,3,18,1302264,152540,39,6691,476
8,3,5,0,15,9606,0,0,0,659
5,2,3,1,12,34447,8317,96,14764,538
8,2,6,3,12,135667,133118,34,0,585
16,8,8,13,8,74953,95177,335,24361,442
30,11,19,5,12,298501,15058,39,8740,391
20,9,11,0,7,72644,0,20,361,562
46,19,27,10,8,123243,49950,216,11799,419
17,10,7,1,32,42602,1400,35,0,484
11,5,6,7,9,171068,307654,123,152582,489
10,5,5,5,7,34587,34587,351,15104,427
13,9,4,0,9,128047,0,9,0,601
4,2,2,0,8,273821,0,5,508,490
3,1,2,1,11,980,14661,17,14661,575
86,15,71,5,12,279848,25225,196,15694,422
10,7,3,0,9,242582,0,0,0,537
9,7,2,7,7,511045,599155,25,165048,371
5,3,2,0,9,2000,0,0,0,661
8,5,3,3,2,48254,3182,18,2850,556
7,3,4,3,11,52673,52673,57,50023,520
16,8,8,2,8,188467,1861,0,0,518
5,3,2,2,4,19695,1748,15,50,532
16,5,11,2,14,30189,25595,108,22872,443
9,5,4,5,9,103981,100820,73,31918,521
7,3,4,3,8,446286,43618,65,4837,507
4,2,2,0,7,13330,0,2,185,635
13,10,3,1,14,426585,66280,11,66280,567
12,2,10,1,14,20455,20455,24,20455,433
19,13,6,3,7,396896,15900,80,5005,472
9,7,2,5,8,43666,35811,44,5475,403
3,1,2,0,17,8433,0,0,0,511
11,2,9,3,7,22939,32391,15,22229,489
14,5,9,4,13,522776,49050,108,29800,514
30,8,22,4,19,63632,31633,26,10081,482
10,5,5,2,12,149141,4830,9,3885,510
9,3,6,0,14,139822,0,6,0,670
41,7,34,3,30,28403,20177,103,13282,508
10,7,3,7,10,49577,85640,117,12046,453
4,2,2,3,7,17416,17167,76,0,561
6,4,2,2,9,5989,4233,2,2370,569
8,1,7,4,13,119346,126046,152,12376,497
11,8,3,2,12,480592,3618,35,3720,474
6,3,3,3,14,17674,9200,11,14283,534
5,2,3,1,8,0,8887,0,0,554
11,9,2,4,10,334331,8675,59,3425,469
16,9,7,12,11,119866,126748,14,5182,442
19,13,6,6,5,225483,119256,111,38103,440
10,1,9,1,13,10000,10000,97,10000,635
12,6,6,7,9,71163,74814,112,9994,424
10,5,5,5,7,56214,65830,140,1550,520
19,6,13,2,12,90821,10281,388,3337,513
40,5,35,4,7,360223,21654,144,39507,513
25,9,16,2,9,241337,20519,95,1352,481
63,14,49,8,11,67345,31871,237,36464,418
28,6,22,1,11,375280,12010,0,4375,490
4,2,2,2,7,371432,8528,13,6784,603
6,4,2,4,8,8939,5873,10,2481,388
28,9,19,1,8,476437,548,32,2265,575
39,10,29,0,13,886276,0,5,5348,600
19,6,13,0,6,463178,0,378,2781,522
56,14,42,4,17,252572,25751,92,7457,444
2,0,2,0,4,0,0,0,0,663
14,5,9,0,14,168949,0,0,0,632
21,13,8,6,69,444147,141194,81,52730,467
24,5,19,3,16,215163,12631,73,8038,481
12,7,5,10,24,1033592,1788478,191,931870,498
17,9,8,3,20,122242,22714,24,10589,573
14,3,11,3,12,13098,2586,145,27198,458
20,9,11,9,12,76370,61317,117,16730,417
22,9,13,5,14,374314,9213,51,750,443
11,5,6,1,11,26135,30660,29,0,623
6,3,3,1,4,11416,11416,10,0,661
6,4,2,1,32,4730,34673,15,1009,620
4,2,2,2,16,21130,21130,44,15701,553
12,10,2,8,69,56973,50683,123,4382,435
29,5,24,0,18,116741,0,0,3372,677
57,22,35,0,30,3010675,0,25,10530,613
32,4,28,1,69,5176,21,14,890,585
6,2,4,3,6,52916,52916,0,0,503
5,2,3,2,7,21895,20459,27,12272,606
30,11,19,0,13,245745,0,25,957,570
6,0,6,2,12,81534,81534,0,0,523
13,4,9,2,5,66801,8208,96,5822,526
15,9,6,8,7,67424,54768,44,3430,445
5,2,3,0,8,9322,0,13,1746,437
14,10,4,1,8,255183,2886,3,0,549
12,5,7,2,12,960997,23041,69,4831,487
75,18,57,8,10,169840,120897,106,94383,435
10,1,9,1,7,0,24471,36,0,611
11,6,5,6,5,35935,25692,30,11070,447
35,15,20,13,11,485547,1060146,321,0,512
16,6,10,3,18,29482,1687,21,1430,588
7,3,4,1,17,1506,1506,24,1506,626
19,11,8,1,15,1972619,1484,10,0,581
43,18,25,2,16,499046,11086,91,706,452
12,5,7,3,7,21561,4813,12,4354,552
5,1,4,1,6,0,22670,11,0,608
8,6,2,6,14,434567,33100,11,483,459
5,3,2,2,5,4860,772,91,1102,550
16,10,6,9,10,144297,120374,77,79605,566
11,4,7,2,69,260888,51416,38,0,505
9,3,6,0,15,11790,0,8,134000,667
17,5,12,5,9,33720,33511,127,13580,379
11,4,7,0,13,8333,0,2,498,644
6,4,2,3,13,178787,156945,40,132821,411
11,3,8,0,17,10219,0,0,1101,646
9,2,7,3,14,71716,50332,0,0,571
5,3,2,2,17,43895,42923,23,38651,500
21,7,14,7,8,37176,33221,214,10109,560
14,4,10,5,7,63135,84790,101,27594,544
14,4,10,2,8,43766,22640,39,2010,455
9,5,4,6,4,25914,37400,56,12950,508
8,4,4,2,19,20918,16964,55,1367,465
19,2,17,2,9,1950,1950,351,4260,450
34,3,31,1,9,378,378,297,3431,607
8,6,2,0,5,144746,0,0,0,659
17,13,4,1,11,280836,8626,26,8626,678
24,20,4,17,7,104107,79677,268,11603,404
9,3,6,0,7,122472,0,17,2380,664
18,10,8,5,7,472942,42642,89,25810,450
8,4,4,2,12,201956,32909,23,0,445
22,6,16,8,13,61507,93697,134,23688,423
74,14,60,5,10,210224,88979,94,16186,424
12,9,3,8,8,29855,29855,146,10403,503
24,3,21,0,17,108519,0,117,2952,666
27,16,11,2,17,525418,1131,30,91666,520
6,2,4,2,13,53767,13292,0,0,541
7,5,2,3,13,17968,17968,41,75108,497
30,6,24,6,9,822567,243260,93,3400,551
21,9,12,12,12,104209,89652,117,13276,487
9,7,2,6,7,35285,17533,339,7140,468
29,8,21,6,11,44916,37195,598,9834,455
13,5,8,5,15,47259,33280,52,13847,493
9,6,3,1,9,43825,344,4,2708,497
7,4,3,4,10,120799,149720,43,15658,518
18,9,9,0,7,24423,0,0,0,670
8,2,6,2,8,8124,8124,111,3129,515
12,6,6,0,10,79134,0,24,0,580
52,13,39,8,18,822175,134575,149,53272,501
57,10,47,6,14,399200,96518,73,25799,353
8,6,2,6,7,19070,19070,30,6750,387
16,8,8,8,8,133564,32648,69,21139,438
15,8,7,6,8,22734,13370,22,2645,497
11,7,4,0,16,456036,0,8,0,584
11,7,4,4,30,136272,37563,104,0,508
22,7,15,1,10,184411,1007,3,10036,421
12,8,4,1,13,177880,882,20,882,567
12,4,8,2,16,530276,11710,60,5150,494
9,6,3,1,14,256257,7612,24,18276,620
26,7,19,3,12,310526,11344,157,16312,490
8,6,2,1,17,578148,10498,24,10498,502
9,4,5,4,12,56260,41214,26,10651,434
51,9,42,6,14,2306489,1338175,59,42060,541
20,7,13,5,13,48720,4004,157,5483,451
14,9,5,0,17,536715,0,29,0,588
11,8,3,8,22,29577,287533,44,7128,454
13,7,6,1,2,49929,2805,8,0,458
61,31,30,16,18,492214,207794,446,56801,422
12,5,7,5,7,414285,249928,132,14581,503
18,5,13,7,6,18016,18015,136,4219,483
57,5,52,2,13,103223,4311,218,4310,429
4,1,3,0,9,5187,0,0,625,672
18,5,13,5,9,16663,15007,43,6154,508
13,7,6,3,10,70372,15922,34,8356,518
28,6,22,2,8,15644,15644,37,0,541
19,10,9,12,15,271453,355216,8,55695,454
8,3,5,4,13,15584,18085,48,7834,432
9,6,3,4,7,341036,61486,70,33865,526
41,12,29,2,13,586838,16884,48,0,425
8,3,5,3,11,10628,798,72,1650,589
11,6,5,2,11,354161,6559,85,0,525
20,15,5,7,13,823005,7699,65,2242,549
18,11,7,3,13,309280,14337,8,10632,469
8,1,7,3,9,35018,35018,31,0,463
33,2,31,1,10,17307,15630,210,15630,550
18,10,8,7,21,582077,758095,87,878,495
11,5,6,5,13,33392,52579,131,1698,460
5,3,2,2,4,30455,2339,4,1368,563
15,9,6,10,8,204713,130392,347,34577,475
9,3,6,4,11,35180,35180,60,11300,446
4,2,2,0,3,42850,0,1,922,624
6,4,2,4,6,164293,164293,92,4820,445
21,8,13,6,14,384454,23814,140,4425,455
10,3,7,1,13,13777,9124,23,9124,553
32,7,25,7,8,64090,91375,323,28296,438
5,2,3,0,3,20843,0,1,910,575
7,0,7,0,3,0,0,13,28,500
25,4,21,1,11,12717,1420,147,3783,454
123,6,117,3,18,29755,1986,64,4086,487
28,3,25,1,15,3857,287,68,1457,574
9,2,7,3,13,39347,29361,51,1741,527
25,7,18,3,9,344170,9944,43,5329,589
17,4,13,5,19,92184,151600,66,44105,478
69,10,59,4,13,266644,17464,93,7270,548
13,11,2,11,6,431320,407237,244,0,514
18,8,10,5,7,254814,19053,125,1048,427
7,5,2,4,15,67374,11899,80,5251,483
12,8,4,2,8,335302,7264,8,1047,520
18,6,12,5,10,57065,38535,66,19342,447
6,4,2,1,6,16377,996,5,4127,582
3,1,2,0,6,1250,0,5,0,612
17,7,10,4,19,115891,133501,82,0,453
57,18,39,5,7,373410,8297,86,10225,473
17,8,9,6,8,25647,20597,117,89217,484
7,5,2,5,8,25766,37601,54,17347,458
13,6,7,0,4,194285,0,0,0,637
23,9,14,0,34,1172096,0,1,240,562
33,9,24,2,13,383669,62599,63,6864,506
13,5,8,5,7,5985,5372,94,4452,478
8,4,4,1,13,42439,6597,113,6597,649
26,5,21,2,10,159298,43588,61,23551,461
14,3,11,0,19,11452,0,4,3646,527
26,11,15,10,20,1623140,2199003,234,799971,417
34,6,28,3,6,233972,10116,14,5038,467
19,8,11,4,13,38553,33005,73,14540,473
6,4,2,0,20,91943,0,1,0,628
16,6,10,1,13,680054,4417,16,12574,667
8,4,4,3,14,30604,21563,31,14610,468
8,6,2,0,9,714198,0,23,0,480
9,3,6,1,6,18841,5078,16,5078,479
12,7,5,0,14,99409,0,6,2538,498
13,9,4,5,8,205574,29283,80,11001,519
5,3,2,3,17,3792,7851,0,186,522
17,6,11,4,11,235506,9077,110,3302,468
5,3,2,3,16,112543,112542,31,55407,496
23,10,13,3,12,193864,29473,174,18957,621
17,9,8,5,9,35330,36185,115,10015,435
50,13,37,7,6,164704,9585,99,2987,419
11,5,6,0,8,253834,0,7,596,660
51,8,43,1,16,474837,127730,52,127730,521
38,10,28,6,10,43312,18795,337,6664,424
14,6,8,10,7,171438,108053,155,21960,426
9,6,3,4,5,84838,84255,55,0,456
33,11,22,0,20,67104,0,15,3381,530
7,4,3,3,12,69652,69855,53,10003,436
16,12,4,1,10,437528,1162,102,1315,424
6,3,3,4,10,41257,13606,74,5432,506
7,4,3,2,6,5387,5387,12,5351,470
15,12,3,7,13,588868,14995,98,4665,534
53,15,38,9,11,684796,209854,201,22175,444
72,16,56,11,7,278259,242565,183,64663,423
11,6,5,0,14,538250,0,0,0,630
10,7,3,3,9,392515,13058,32,8728,466
23,7,16,2,12,555767,16764,42,4123,409
17,6,11,4,10,31373,31373,48,14689,481
15,10,5,1,9,89341,193,37,1076,608
22,2,20,3,11,12094,20231,69,7854,534
4,2,2,3,8,16950,13644,20,6019,599
9,5,4,5,15,307840,33954,0,0,521
13,4,9,3,9,10454,7246,20,6627,426
11,9,2,0,12,587862,0,7,1373,579
16,5,11,0,18,30634,0,5,1964,551
27,8,19,4,7,49535,12367,104,905,615
10,6,4,5,7,1255250,2015807,100,1233683,424
9,7,2,6,17,167387,49416,149,28412,549
21,10,11,6,17,725993,23913,20,120,415
37,13,24,11,7,40324,17675,141,2014,382
5,3,2,3,5,4537,4537,142,3567,571
13,9,4,0,13,106459,0,21,24752,519
46,4,42,3,13,16228,5346,105,5960,435
35,3,32,0,5,22506,0,6,398,538
14,6,8,3,10,461066,116308,68,106125,468
15,6,9,1,9,84908,45839,4,2070,526
6,2,4,3,11,89246,80968,40,0,503
26,10,16,6,13,32499,5463,110,2527,440
6,4,2,4,8,56144,42488,90,0,517
17,6,11,0,14,52392,0,61,0,672
10,1,9,0,3,1000,0,2,1815,562
65,12,53,4,19,284973,201372,1,2691,519
43,10,33,7,6,90080,58958,30,11854,439
6,4,2,1,8,423543,12466,23,8904,549
6,3,3,3,8,9332,8364,57,2387,510
20,5,15,5,15,75955,189993,49,1469,596
9,4,5,0,15,740791,0,0,0,685
12,9,3,7,15,587584,159031,26,11252,474
6,3,3,2,6,73925,32920,18,0,485
16,6,10,4,11,14637,14134,181,8273,424
21,7,14,3,16,146090,57780,27,4375,480
11,3,8,0,14,8668,0,22,173,575
31,6,25,11,15,201908,309628,170,4320,440
20,7,13,0,20,138711,0,17,2608,693
11,3,8,0,7,1507,0,1,0,633
81,18,63,10,11,381179,84838,175,10380,425
17,8,9,5,8,49690,49800,90,15322,508
12,6,6,1,7,64787,630,0,0,508
44,9,35,8,18,84566,93447,268,57263,435
53,8,45,9,8,40697,37351,315,9183,400
5,3,2,4,5,17126,27604,54,0,488
9,7,2,7,6,36609,30472,52,6764,423
30,14,16,1,10,435855,1935,8,990,549
56,13,43,5,29,715177,372782,125,206155,489
14,9,5,8,18,364678,73584,117,13900,486
41,10,31,4,17,85050,54317,18,50000,450
34,17,17,3,16,794443,8230,164,8108,390
5,3,2,1,7,143976,1181,1,3010,626
12,5,7,6,18,76670,117563,117,4433,473
13,3,10,3,18,58325,18355,10,1188,492
13,9,4,5,7,17306,11648,61,2227,437
32,10,22,8,14,47167,38634,175,73999,435
12,9,3,2,12,1215437,894565,43,554,576
13,3,10,1,8,626625,12031,23,0,547
6,3,3,0,7,116499,0,3,0,633
4,2,2,0,11,25104,0,22,0,591
13,7,6,0,14,216524,0,0,0,592
6,4,2,1,22,595607,11808,12,1419,514
6,3,3,3,15,417397,59316,1,5451,515
17,13,4,16,5,47270,53881,265,10769,475
53,7,46,1,14,42425,19237,16,19237,600
19,4,15,0,8,17844,0,25,2932,566
39,11,28,9,13,84708,82501,563,25182,436
17,4,13,1,8,26780,1374,2,1383,672
8,4,4,3,16,16225,3879,3,1735,506
4,1,3,3,11,1394,87979,49,0,641
4,2,2,2,17,258037,20072,30,5227,485
14,5,9,1,7,18859,1275,117,1275,497
27,4,23,2,8,7991,264455,74,51,555
18,6,12,2,14,450420,14939,81,10870,368
14,6,8,2,8,16215,4935,94,4727,517
11,5,6,1,14,237058,52333,0,0,585
6,4,2,3,5,22763,13149,71,0,503
81,20,61,8,16,565218,31600,77,5440,446
20,8,12,0,9,362626,0,3,0,590
4,2,2,1,5,3686,1298,5,1298,534
9,7,2,1,7,368947,5153,23,5153,405
66,9,57,9,12,67954,71761,289,17040,414
7,2,5,0,11,0,0,5,0,744
48,11,37,5,16,63557,11191,606,8781,491
18,10,8,10,9,139016,106635,98,19666,439
40,10,30,1,13,91066,1838,6,374,585
7,3,4,1,12,101650,62383,2,62383,612
13,8,5,7,13,253429,49185,42,34868,444
34,6,28,5,21,65694,58823,48,4268,469
9,6,3,7,6,60559,61147,221,9825,488
12,9,3,8,8,86627,66863,136,1234,389
43,15,28,0,11,333054,0,18,6310,427
10,3,7,2,5,2485,2291,16,1784,527
14,8,6,9,7,112196,132755,173,38794,455
5,3,2,2,10,147059,110041,50,0,510
45,20,25,18,38,79053,58469,285,6960,469
28,13,15,1,16,2945773,6472,15,10723,443
7,5,2,2,10,52450,75275,61,52450,544
6,4,2,2,15,155073,101,12,1152,457
12,6,6,2,5,200189,55393,32,50422,443
7,4,3,5,7,2318,11238,52,12274,653
54,9,45,5,9,91492,45268,122,15972,422
12,3,9,4,13,34647,44552,42,13088,448
18,9,9,1,11,409862,57577,4,57577,580
5,2,3,1,12,14528,14528,26,0,541
31,15,16,4,15,974655,51658,22,0,486
19,0,19,0,8,0,0,13,2110,675
34,7,27,3,11,632872,77375,69,50969,473
13,5,8,0,6,5657,0,8,1329,625
4,2,2,0,11,317596,0,21,22821,562
10,4,6,2,7,46483,13127,25,13011,548
6,2,4,1,17,7690,6963,38,118969,646
16,4,12,2,8,20616,805,18,1741,541
23,9,14,0,19,370431,0,2,0,661
12,4,8,4,6,18144,18144,84,6109,474
22,5,17,4,13,26030,33221,69,4378,489
7,5,2,3,7,23170,23170,159,10181,449
13,3,10,1,6,37512,3625,0,0,537
6,3,3,3,11,3908,3908,37,1673,395
10,4,6,3,6,31765,8793,31,6402,485
6,2,4,2,7,5546,20791,0,1221,508
10,2,8,2,14,10566,28480,40,22444,539
42,17,25,1,16,1581664,489,22,489,521
7,5,2,4,5,28386,21229,272,17197,464
2,0,2,1,6,34193,24420,18,0,597
8,4,4,3,8,16865,16646,44,9937,441
9,7,2,7,7,26562,44891,30,3813,452
19,2,17,4,8,22721,43134,11,17047,537
8,3,5,4,6,21589,13553,61,4501,446
17,7,10,6,5,11948,16496,486,4687,436
15,6,9,9,19,37982,60700,283,13589,438
20,5,15,4,8,28526,31010,106,14944,396
7,3,4,3,7,9180,14842,27,4553,607
15,12,3,0,8,465976,0,15,0,497
882,8,874,2,18,464692,9738,99,20174,531
15,4,11,5,8,407390,90803,101,0,491
25,6,19,0,21,89443,0,105,431,528
18,10,8,2,6,75574,57801,123,1137,511
19,10,9,12,8,77622,83509,47,12164,343
3,0,3,0,9,0,0,0,0,647
13,5,8,0,3,51426,0,20,4270,583
25,18,7,5,19,330611,19840,30,4960,440
12,9,3,6,5,39874,26327,41,11581,512
8,4,4,0,7,25498,0,3,0,645
6,4,2,0,3,1031933,0,0,0,595
11,8,3,8,9,659944,72212,115,13680,481
15,7,8,5,11,432697,141674,63,43162,469
5,2,3,2,7,65384,64169,58,44606,460
17,2,15,0,19,32846,0,0,490,712
7,2,5,4,11,5465,13253,48,5035,645
32,15,17,2,21,463630,9247,26,9142,512
8,3,5,3,8,27001,27001,136,17480,449
28,16,12,1,11,1536918,200,3,0,667
80,15,65,8,15,103737,40224,89,10617,446
13,5,8,3,7,20777,2834,49,1162,475
24,9,15,11,16,121324,89969,162,14034,449
8,6,2,4,12,42203,3628,39,12778,460
8,3,5,1,9,29801,21108,0,0,515
40,19,21,10,15,287490,79087,125,48526,482
17,8,9,0,11,284735,0,5,273,637
19,7,12,8,12,1483857,225709,91,25538,528
9,3,6,1,8,14742,6229,123,6229,562
12,8,4,2,6,51869,856,14,2234,500
20,15,5,14,17,122019,121421,36,31711,393
32,11,21,0,22,396188,0,8,0,675
63,3,60,3,18,34453,34453,138,11227,485
64,5,59,2,10,76548,6108,504,9254,487
18,10,8,8,17,53371,36947,110,6921,449
12,5,7,5,7,25936,22460,52,9773,460
13,5,8,0,18,182828,0,9,0,629
6,2,4,2,11,255923,33547,20,32092,540
13,4,9,3,16,18299,7325,63,5824,467
8,6,2,0,4,66465,0,2,0,614
12,4,8,4,8,6351,18732,0,1860,458
54,8,46,4,9,48219,12561,349,8704,454
22,13,9,4,15,749954,31997,66,2814,532
15,4,11,1,13,47817,3055,2,3055,641
26,15,11,0,20,516193,0,2,0,594
12,9,3,0,14,79996,0,3,1281,638
15,9,6,4,8,81484,37759,28,2539,480
28,8,20,1,17,331866,23219,103,23219,455
12,3,9,2,11,590448,60988,40,23350,535
11,4,7,3,5,36647,4927,291,2912,442
10,3,7,3,8,47372,47372,45,28248,477
9,7,2,7,14,38947,34759,25,2898,434
11,9,2,5,69,301136,14447,84,5974,460
4,2,2,0,6,0,0,8,0,662
31,9,22,3,7,182262,25902,80,1955,526
28,13,15,5,14,836639,9268,19,3134,546
41,12,29,1,13,169781,1319,16,1319,419
41,8,33,3,5,18228,4229,25,3637,443
16,9,7,2,18,73545,186934,21,546,529
66,11,55,8,11,159392,114530,181,73810,487
8,5,3,2,4,166317,12666,26,0,474
20,8,12,8,14,28261,37693,170,8277,382
4,2,2,3,7,13111,23539,37,0,620
6,2,4,1,18,2171,3618,0,1868,548
26,7,19,5,10,90989,66665,6,37796,453
3,1,2,2,6,56343,22745,11,0,646
12,7,5,6,11,669112,450728,0,0,580
28,9,19,2,15,69914,3037,28,2865,502
34,11,23,4,9,72592,7661,83,2564,424
19,6,13,6,11,21421,21421,79,7629,444
18,6,12,0,14,432707,0,2,0,582
12,7,5,8,10,104941,104941,237,42142,431
9,5,4,6,4,144836,122894,0,0,523
12,7,5,1,14,50137,2005,2,2919,446
14,9,5,2,13,258280,18094,35,14701,407
25,8,17,5,12,465832,65212,68,13734,502
8,3,5,1,9,19152,9587,39,2049,534
128,13,115,3,18,84534,35584,78,20955,468
23,10,13,10,14,43792,48338,116,17285,473
18,9,9,3,13,227955,21954,21,5217,443
25,13,12,5,23,273545,9352,50,10290,474
4,1,3,1,10,7500,7500,3,357,560
19,10,9,5,10,28442,10426,122,6577,419
15,5,10,3,7,92248,33109,195,17721,502
106,23,83,7,21,256812,49750,102,11059,450
9,3,6,2,9,45162,42842,44,441,525
10,4,6,4,8,483547,35255,67,0,528
13,5,8,0,18,182828,0,9,0,629
12,4,8,3,26,313768,43599,140,12399,450
5,2,3,0,5,23739,0,0,349,686
11,4,7,3,9,77728,56091,52,343,517
10,6,4,0,4,119594,0,0,1798,554
13,3,10,3,11,91662,91662,58,74486,494
10,4,6,2,7,55566,42507,80,0,609
17,4,13,2,9,10422,7432,47,2495,487
8,3,5,2,11,335107,30820,1,4543,525
7,2,5,3,7,146136,146136,63,93865,473
9,6,3,4,6,40839,21206,38,3410,423
6,3,3,1,5,14259,727,13,2093,522
8,6,2,5,11,31078,29818,72,2374,491
6,4,2,0,7,25016,0,0,0,667
28,6,22,1,10,82702,4049,15,1700,508
7,4,3,3,6,63772,49710,36,16227,460
9,5,4,0,7,5857,0,10,1050,634
15,4,11,2,7,58218,15432,268,9151,478
57,22,35,13,16,2236351,915534,93,9576,431
26,14,12,2,19,651432,10925,27,9370,443
13,11,2,0,10,577988,0,0,0,673
5,2,3,1,7,4602,4602,0,0,642
6,3,3,2,14,26746,26746,107,13843,542
30,2,28,1,9,0,6760,0,0,575
5,2,3,2,7,8508,11350,39,8107,488
20,10,10,6,8,306677,17604,318,12518,473
5,1,4,1,3,2751,2751,5,2751,492
15,6,9,5,11,477842,25860,75,10857,482
16,7,9,5,11,301474,79049,111,14350,427
7,3,4,4,16,6151,5947,42,1598,474
9,3,6,3,15,17609,3792,12,186,496
19,3,16,4,8,14775,8545,145,6101,580
15,11,4,0,5,754073,0,11,0,557
24,11,13,4,23,120340,22233,129,23901,501
15,3,12,0,18,22889,0,4,480,615
5,3,2,1,2,25119,608,1,0,557
8,2,6,1,11,13118,13118,0,508,494
20,9,11,1,21,95289,12661,76,389,534
7,5,2,4,16,33230,30269,85,116930,461
14,9,5,2,15,117086,7364,8,0,469
8,5,3,3,6,116817,79346,43,0,548
43,12,31,1,11,138898,4905,2,5602,519
19,7,12,6,8,488293,16427,319,3104,449
31,7,24,0,18,70916,0,53,1106,528
10,1,9,1,7,0,5784,46,0,577
5,3,2,2,7,29956,11610,27,0,538
5,2,3,2,5,4521,593,46,2618,467
13,5,8,0,19,80564,0,7,0,682
38,7,31,8,7,30814,30421,173,5082,385
23,15,8,5,12,491748,112734,12,539,495
6,4,2,3,7,96288,16892,48,0,439
4,1,3,0,11,1000,0,0,0,609
4,2,2,0,8,245,0,7,0,628
22,4,18,4,18,22410,22410,116,17360,481
15,5,10,3,16,698798,49889,0,342,567
17,2,15,0,19,35222,0,0,490,709
27,18,9,9,6,633868,156322,121,3806,403
18,4,14,3,8,668336,133237,8,891,463
67,11,56,3,12,175993,46298,40,9810,450
19,11,8,4,13,264628,46487,31,24630,483
70,7,63,8,12,106699,92006,267,16505,459
24,9,15,0,69,228844,0,72,500,508
17,8,9,0,9,35322,0,1,1000,545
17,14,3,5,9,96594,30603,27,0,481
3,1,2,2,7,519,2461,11,519,496
16,10,6,7,7,56831,49719,99,4102,380
24,4,20,0,5,8380,0,0,0,602
22,10,12,7,14,235541,133989,128,326,492
7,3,4,2,11,134932,108365,24,0,463
19,14,5,2,18,266606,11495,40,2752,532
13,2,11,2,5,1151,711,15,480,506
17,5,12,3,16,18454,7549,40,3635,561
28,12,16,5,12,250003,37569,183,1378,486
22,10,12,11,8,73941,89941,238,24804,440
5,2,3,2,7,490,10811,22,0,635
8,2,6,1,8,474,44022,37,2705,516
8,6,2,6,19,465063,523913,89,292094,429
13,8,5,4,8,61955,19821,22,8359,483
14,1,13,1,4,3324,3324,21,10982,566
15,9,6,8,11,131808,138525,212,13082,454
13,10,3,9,9,170383,170383,110,14756,364
19,5,14,0,12,41598,0,9,2964,572
24,8,16,3,9,366979,12116,123,3713,550
15,7,8,1,11,41092,1279,24,1279,443
11,4,7,3,11,11540,11540,34,9261,535
4,2,2,4,7,8696,19325,0,0,564
6,2,4,5,5,30191,52816,72,12910,501
12,6,6,7,15,37759,56739,370,17874,397
15,8,7,0,3,59396,0,1,347,590
7,3,4,4,16,115526,129189,61,35466,542
8,3,5,1,6,97171,12784,11,349,490
17,4,13,4,19,501330,62119,21,36216,516
12,4,8,4,6,37704,22529,227,10157,492
22,8,14,3,17,52579,7040,48,5282,526
4,1,3,1,7,1263,960,35,3691,589
4,2,2,1,7,10750,10750,25,0,634
11,9,2,4,10,334331,8675,59,3425,411
5,3,2,0,3,64700,0,0,0,642
31,13,18,1,9,177880,1373,61,1236,494
30,8,22,2,8,129140,112028,286,109613,474
15,9,6,0,14,50025,0,1,6469,566
6,4,2,4,7,553473,98596,51,49197,474
17,7,10,3,12,290662,8239,169,5800,481
9,1,8,1,12,2760,532,15,1172,448
6,2,4,1,13,499,499,87,2593,710
12,3,9,2,4,19750,11972,57,8483,521
18,6,12,4,10,30205,33769,120,15515,458
39,8,31,0,10,91593,0,16,719,584
3,0,3,1,1,0,2466,4,0,396
9,4,5,1,13,57379,1130,0,1238,576
12,2,10,2,11,7996,2507,77,1832,552
22,7,15,7,18,100847,106750,333,34569,525
35,11,24,11,16,223563,219725,365,15975,438
11,6,5,2,6,602077,6745,57,634,545
6,4,2,3,5,101881,12296,0,0,495
29,10,19,0,7,701588,0,3,0,592
8,5,3,3,16,335022,20852,44,7713,514
16,12,4,2,14,292407,24042,14,0,470
13,5,8,4,14,39474,32774,131,15373,573
11,6,5,0,9,93557,0,2,0,480
38,13,25,3,18,262166,158955,68,149617,506
13,7,6,3,7,1029480,40145,24,0,541
12,3,9,5,15,38072,44324,70,17774,489
10,5,5,5,10,36791,36791,78,12642,447
26,12,14,0,8,204999,0,7,0,605
19,4,15,7,9,25956,53435,55,13739,523
10,3,7,1,18,22436,2413,10,5818,493
60,7,53,3,12,589210,38761,92,13995,527
6,2,4,2,13,5759,5759,106,6156,569
10,7,3,5,8,16585,30785,50,7484,510
19,6,13,2,7,214816,11412,42,7478,399
7,5,2,0,6,1116,0,2,509,680
25,9,16,8,9,38585,42515,149,23621,406
10,8,2,8,4,44268,31586,151,21041,472
69,21,48,6,7,159536,22983,64,5057,464
23,14,9,8,6,49519,21538,128,4249,427
51,7,44,0,5,48755,0,52,1055,558
11,2,9,2,5,26534,23572,12,12377,547
15,10,5,1,9,121596,398,44,978,469
6,4,2,5,7,14366,17293,82,1193,469
11,7,4,8,15,45483,54869,62,17224,405
9,7,2,2,3,312827,2777,53,0,510
6,4,2,2,7,253377,4951,28,4474,419
39,3,36,2,8,117497,182569,118,1672,535
15,9,6,6,19,262344,68119,71,2587,427
10,3,7,1,11,111608,54068,0,0,676
30,10,20,0,10,320205,0,12,790,595
10,8,2,0,20,96171,0,0,0,567
7,4,3,3,14,16362,16362,40,10622,414
17,8,9,4,19,162887,136028,94,70178,620
8,1,7,0,16,8428,0,0,688,666
31,14,17,1,17,447445,4768,87,8582,534
32,8,24,4,26,736649,89736,27,2872,583
4,0,4,0,1,0,0,0,0,621
8,6,2,0,3,124927,0,1,0,493
9,5,4,3,24,35844,4021,0,2669,492
44,26,18,5,27,739447,11634,14,12443,411
6,3,3,3,5,15647,25551,43,1365,548
25,12,13,0,11,344230,0,0,0,614
4,0,4,0,6,0,0,0,0,669
19,8,11,9,10,1629211,2481457,217,512253,395
24,9,15,4,6,211801,33740,75,0,464
10,7,3,5,13,37678,44885,170,15905,487
3,1,2,0,13,0,0,1,1463,669
36,5,31,1,3,61164,1073,2,5982,628
11,3,8,1,9,8972,3109,34,3109,555
6,2,4,2,5,5618,1391,14,0,459
17,6,11,1,14,1267805,20041,25,1139,564
12,4,8,2,9,913700,30329,0,0,548
15,4,11,0,11,42816,0,12,8078,610
5,1,4,2,12,6449,28733,46,0,497
10,5,5,5,8,64152,60120,122,21467,432
10,1,9,1,13,5666,5666,13,26042,449
45,6,39,1,9,93022,63805,72,5636,475
13,7,6,9,4,135013,136504,113,54664,460
19,6,13,4,8,67480,16062,60,931,460
18,8,10,9,13,540198,431983,129,309594,441
14,8,6,4,13,406584,12330,84,733,486
7,2,5,2,9,47496,47496,59,0,520
6,2,4,0,8,1000,0,0,1160,672
37,10,27,7,7,535628,450646,153,4101,424
20,8,12,3,7,81080,12049,92,1575,436
22,4,18,3,4,14581,10749,21,5425,467
7,4,3,3,15,36756,36336,48,17602,464
4,1,3,0,3,4163,0,1,206,671
8,6,2,2,5,172366,14994,0,0,496
5,3,2,2,12,27397,2716,53,266,477
16,5,11,5,14,556318,107481,103,37816,421
11,4,7,3,6,26136,24632,36,19773,452
17,12,5,5,9,89519,30761,23,25109,497
5,3,2,1,8,284646,911,9,911,573
16,9,7,7,8,68856,27946,126,12744,384
3,1,2,0,7,1862,0,0,0,634
8,6,2,0,10,16154,0,0,926,476
12,6,6,7,13,78765,100014,136,15718,550
19,6,13,0,15,25423,0,2,0,708
10,7,3,5,18,13429,12291,42,5460,581
8,6,2,5,25,8730,5892,101,971,426
6,4,2,2,13,5707,5511,28,4024,503
7,4,3,1,4,3632,35,41,662,625
13,7,6,8,15,55840,43289,150,9385,439
17,7,10,3,10,301742,22053,66,0,447
12,2,10,5,11,28552,54744,103,0,494
15,12,3,10,8,94225,86315,13,5783,364
12,3,9,3,7,75528,90481,34,3102,523
32,11,21,6,20,370039,64540,80,7218,424
42,22,20,12,19,2199924,317779,357,5320,454
80,14,66,20,14,152217,248881,428,15949,351
8,6,2,0,7,333278,0,2,2349,603
16,6,10,5,12,47367,40488,89,0,494
18,8,10,4,11,34127,30397,81,8969,471
96,24,72,20,16,563192,173907,488,16825,427
7,4,3,0,15,107009,0,0,1026,681
51,10,41,6,16,176110,52251,169,726,437
6,2,4,1,13,67024,11620,26,0,501
6,3,3,2,15,414927,33523,0,0,462
17,7,10,4,16,52762,28573,16,2200,459
14,11,3,1,17,703694,360,6,0,517
12,7,5,5,8,23719,18218,16,2827,417
22,8,14,0,9,86770,0,20,2886,612
4,2,2,1,9,17372,14225,25,0,636
9,2,7,2,8,31990,8934,27,5307,622
7,3,4,2,12,15931,11589,7,1709,456
11,5,6,3,9,41352,25204,61,1405,619
10,5,5,1,12,63223,54,3,54,485
6,4,2,3,2,22598,685,74,935,477
8,2,6,1,12,1844,1844,25,1844,624
70,14,56,4,6,220265,32699,32,10096,418
28,12,16,1,13,192363,17226,1,17226,630
7,4,3,5,7,14048,9875,94,4434,441
9,4,5,0,26,605559,0,0,10407,595
14,9,5,5,11,175134,69839,138,0,489
11,3,8,1,8,31638,6090,11,6090,499
9,4,5,2,16,124736,39392,32,0,495
52,17,35,10,21,313178,196016,405,114941,425
5,2,3,1,17,9326,6202,25,0,651
5,3,2,2,7,6667,4854,29,3859,474
9,3,6,5,12,152021,154730,0,0,443
83,12,71,12,13,154742,157254,235,34282,439
43,13,30,3,11,325618,5759,42,3040,576
12,3,9,4,8,10532,92442,0,0,570
14,7,7,5,17,23965,27105,91,14869,429
22,9,13,8,13,342747,104772,107,61289,453
138,17,121,1,18,219008,577,38,590,486
14,11,3,11,8,128420,131975,157,41296,446
15,10,5,8,12,497996,107385,136,5408,435
69,14,55,9,13,352062,102046,448,24076,453
19,8,11,7,25,655414,96522,101,0,463
7,4,3,2,9,59859,5717,21,0,502
15,9,6,7,12,265047,266580,148,14703,429
16,6,10,2,11,925689,2928,83,2191,550
14,7,7,7,12,662660,306091,132,11888,524
38,14,24,10,7,74103,36166,58,8597,477
32,10,22,6,13,669607,477598,99,15437,474
10,3,7,1,8,7209,5419,46,666,637
4,2,2,2,5,2034,2034,14,2039,522
14,6,8,4,6,64718,52668,66,12297,472
18,8,10,2,18,232214,3658,29,1356,470
4,2,2,0,8,10708,0,0,0,685
4,1,3,1,11,0,15878,8,0,585
9,4,5,0,10,60275,0,0,73,636
8,1,7,4,9,534,10963,37,534,515
12,6,6,1,9,37327,3701,22,3917,531
14,8,6,4,11,348137,279111,0,0,469
13,4,9,2,10,31074,20900,41,2524,469
6,2,4,1,7,8703,8703,15,8703,497
19,8,11,0,4,655547,0,2,0,625
11,5,6,5,8,38283,34400,105,2550,530
9,5,4,1,14,255988,968,0,0,497
9,7,2,6,8,24181,24181,107,15491,502
17,6,11,0,7,78364,0,3,0,662
62,11,51,3,12,308564,21420,66,11167,497
12,2,10,4,8,8336,16816,63,6380,452
79,13,66,4,18,94891,21877,32,7814,456
12,6,6,1,16,50429,1494,53,0,452
15,10,5,8,15,309729,137582,134,42334,435
204,7,197,1,11,33838,2274,17,6822,462
12,7,5,1,7,283356,846,15,774,487
8,5,3,6,8,73852,96093,40,3480,454
19,14,5,5,14,348084,72665,58,29936,495
32,15,17,11,16,335055,209874,187,53692,445
12,4,8,2,14,493057,18773,98,27537,547
10,2,8,1,14,277498,470,30,3350,611
19,7,12,5,9,253109,159827,263,3964,489
5,2,3,1,10,1250,1250,69,1250,548
14,6,8,0,7,507328,0,1,0,650
7,3,4,3,10,967076,10150,39,8670,492
13,5,8,0,16,235031,0,0,1824,616
20,13,7,9,11,180195,179494,206,38627,441
26,10,16,3,5,190561,1452,2,355,463
10,7,3,5,6,452993,63089,91,2772,392
17,3,14,2,12,9734,6667,20,0,513
16,6,10,5,5,16460,22168,43,1231,452
21,8,13,3,18,34045,8860,15,4420,484
8,6,2,7,11,44799,31534,28,10458,485
4,2,2,0,6,11985,0,20,949,579
8,5,3,4,15,102961,50483,9,47453,474
12,5,7,1,13,67931,44856,3,44856,543
9,7,2,0,4,64477,0,0,0,546
41,2,39,1,7,28914,10772,17,10772,597
23,12,11,11,15,2460368,750627,220,0,452
6,4,2,2,10,32216,32209,31,0,443
29,7,22,7,14,117809,117809,269,14648,431
10,2,8,2,13,4909,4909,40,3981,578
27,6,21,3,12,15622,10213,62,8437,448
16,9,7,2,15,86295,45399,17,0,589
23,6,17,6,12,31280,30885,467,19156,455
18,9,9,7,8,85755,57486,155,11103,450
30,13,17,7,20,734825,41456,308,8559,438
17,6,11,0,9,81007,0,14,228,617
115,6,109,4,7,30771,18136,102,10393,428
3,1,2,1,5,1813,961,10,179,605
3,0,3,0,3,0,0,3,0,601
7,3,4,2,6,17754,17754,44,21240,480
6,1,5,1,11,0,24408,8,2214,601
11,5,6,2,4,233170,7097,3,0,516
6,3,3,0,3,185706,0,0,0,617
5,1,4,0,7,3559,0,8,1170,694
7,3,4,3,10,71222,55708,25,35250,598
25,17,8,0,11,275704,0,0,0,654
13,5,8,7,9,193845,308480,74,110336,479
12,10,2,3,16,311654,9947,55,11931,497
4,1,3,0,2,2964,0,91,914,561
23,6,17,3,9,46995,38005,0,0,439
18,9,9,8,13,46641,46641,214,18391,429
23,2,21,1,15,1148,1148,25,11565,493
39,20,19,18,9,148770,86881,299,20584,407
37,6,31,4,69,38426,32281,63,21721,483
23,15,8,2,24,1215359,15003,1,78,509
14,9,5,5,11,51272,19416,118,14969,463
34,18,16,3,30,4256745,26421,67,0,436
18,9,9,13,17,350311,496559,221,143760,523
8,3,5,1,14,9978,9380,15,9380,471
16,7,9,1,6,543431,2214,7,90,595
24,7,17,6,14,320193,105969,31,0,415
4,2,2,2,5,24276,24276,33,0,547
42,9,33,5,17,348180,120634,51,4003,440
10,6,4,0,11,97330,0,6,3510,690
13,11,2,2,8,117896,1415,2,1205,535
37,13,24,12,15,230355,221070,228,1520,505
12,6,6,5,69,11294,8032,21,6050,539
19,8,11,5,14,225201,8728,23,2045,454
6,4,2,0,7,1219549,0,5,0,633
7,1,6,0,14,440815,0,3,8408,683
3,1,2,2,7,12638,17822,32,12638,565
18,13,5,1,27,461176,356,14,584,526
35,16,19,8,16,206390,23470,162,3455,484
5,3,2,2,5,5238,5238,33,4664,574
7,4,3,4,11,35636,45000,46,601,480
61,15,46,8,10,94211,58411,69,18286,440
24,12,12,2,19,41010,9463,18,7613,519
20,9,11,1,12,976647,2895,6,2895,567
30,12,18,0,11,1356481,0,1,0,657
8,4,4,4,16,53368,53368,51,30815,397
51,27,24,1,14,2900287,23583,98,0,506
15,10,5,7,10,442940,48475,83,30130,423
24,12,12,2,8,135147,2176,35,5066,493
9,5,4,0,16,142313,0,0,0,680
11,7,4,4,7,199429,10531,79,684,494
5,2,3,3,9,539417,26262,46,0,618
3,1,2,3,4,27751,17048,0,0,442
19,5,14,0,10,292236,0,4,844,548
12,6,6,4,13,87871,1844,30,0,460
15,10,5,6,8,179591,143113,103,33325,458
27,6,21,3,9,161844,1187,39,3489,485
4,1,3,2,20,55896,65110,0,0,528
26,9,17,5,11,77734,33693,20,10295,466
12,9,3,8,6,33929,53798,2,105,433
9,4,5,2,6,22657,21243,61,4350,488
6,4,2,2,10,9310,9310,79,12002,528
17,12,5,0,11,207333,0,2,1618,628
13,7,6,0,15,339269,0,0,0,615
13,4,9,3,11,69337,61293,55,0,586
51,13,38,4,21,752737,12620,99,3090,453
48,8,40,8,11,266692,266686,145,36726,451
56,1,55,0,8,0,0,11,4132,693
18,11,7,6,15,598865,74180,90,19883,492
33,8,25,4,10,43665,8912,16,5973,455
6,3,3,1,15,408637,4569,19,1776,540
17,8,9,7,6,15953,20051,154,24258,448
7,3,4,3,10,225309,35349,88,14163,528
13,9,4,2,1,21431,537,10,286,544
12,5,7,0,12,0,0,5,0,712
4,2,2,1,12,997,997,5,997,476
6,0,6,2,8,29146,31167,0,0,580
10,6,4,0,18,119924,0,4,0,636
27,6,21,2,7,391267,31771,101,31004,485
13,6,7,3,69,393475,35252,68,10216,476
11,7,4,8,6,62861,63437,119,27406,409
48,7,41,5,11,259389,19065,263,5526,467
6,2,4,1,25,7962,7962,23,7962,399
17,5,12,6,11,534791,252869,43,13686,427
10,7,3,5,16,35215,27799,29,43036,497
20,11,9,14,10,436160,543165,163,2451,492
11,4,7,1,13,6187,1233,22,18159,553
11,6,5,4,4,59515,40236,209,3109,443
43,20,23,3,17,433769,14779,0,5440,418
26,7,19,1,10,29604,6349,5,6349,571
25,2,23,2,19,35940,31863,27,2203,538
7,0,7,0,5,0,0,0,591,604
12,2,10,4,8,71557,71557,31,19490,560
6,4,2,5,8,51265,122343,88,36508,498
10,2,8,1,7,480,2467,55,1510,575
18,4,14,0,6,36450,0,15,0,456
16,4,12,0,9,81972,0,9,0,601
6,3,3,0,8,32767,0,0,0,598
10,6,4,8,8,234660,204387,24,105312,495
13,6,7,1,13,376397,14506,16,1623,583
94,9,85,7,19,166618,162173,323,14926,531
21,3,18,0,3,11140,0,1,0,641
19,10,9,9,13,47728,83454,410,14160,456
28,10,18,14,13,352043,377427,243,93419,418
19,4,15,3,14,11586,8642,45,3443,538
11,4,7,3,13,64752,10309,0,0,526
15,9,6,3,17,231030,7398,36,8959,433
6,4,2,1,6,34525,10630,1,0,619
17,7,10,7,11,255679,201876,0,0,544
6,4,2,4,5,16021,14950,62,5145,578
10,6,4,1,8,72953,7959,3,0,580
13,11,2,6,7,348577,29568,132,12847,479
4,2,2,2,8,15529,15407,37,0,583
8,4,4,5,12,352233,528667,102,177362,520
11,7,4,2,11,217730,8705,31,2019,462
7,4,3,3,11,277957,22090,54,15072,556
8,6,2,0,13,110796,0,1,0,542
2,0,2,0,4,0,0,0,0,680
10,6,4,6,5,56529,56529,106,33593,470
12,4,8,3,10,65944,13295,27,3080,436
4,2,2,2,18,4672,4672,10,2741,474
15,2,13,2,4,6719,6719,0,0,484
26,13,13,1,16,804484,87,5,104,577
9,6,3,0,5,35960,0,5,1794,551
40,19,21,6,19,982521,54430,61,2236,510
13,4,9,2,7,26777,19500,98,11250,626
19,6,13,1,13,70672,12329,4,12329,628
56,6,50,2,11,529403,18343,61,6166,446
25,6,19,5,14,11859,6600,227,5277,378
13,4,9,5,16,229637,79075,63,3032,474
12,5,7,5,13,1015107,50535,86,5720,482
8,2,6,2,15,17240,11837,29,5974,466
19,7,12,7,21,61572,61572,116,0,510
15,3,12,2,13,102049,68444,38,6601,505
15,11,4,7,14,48402,28808,171,6468,475
15,12,3,0,20,178212,0,9,0,578
16,7,9,6,14,225890,50235,35,29166,503
9,5,4,3,7,11076,7223,43,2897,440
15,8,7,9,29,240467,284666,185,126402,491
17,12,5,6,17,351878,54698,62,4955,446
26,8,18,3,7,160918,18137,42,0,491
17,6,11,0,9,48460,0,2,590,640
8,4,4,1,10,9786,2149,6,664,508
21,5,16,1,16,30890,23665,71,4552,600
23,4,19,1,17,50549,3560,0,0,489
20,11,9,0,12,1079525,0,2,0,503
5,3,2,3,11,8045,8045,0,0,514
14,6,8,2,17,166688,138895,15,0,561
19,7,12,3,12,58505,7943,27,3975,464
7,3,4,4,8,46869,56963,90,3441,483
11,5,6,5,7,28185,27719,118,13153,501
16,7,9,0,8,371902,0,29,18880,569
16,4,12,2,12,13681,12681,28,10745,569
15,6,9,6,37,204169,248598,145,67998,545
79,30,49,5,16,1088053,133545,0,0,469
11,5,6,2,7,18344,10022,26,8248,445
8,5,3,3,12,78528,55783,124,45214,513
11,6,5,5,12,169874,169874,5,72185,523
33,10,23,4,11,466330,44277,69,25276,679
12,8,4,8,8,204942,239267,0,0,436
8,2,6,3,7,15830,17290,22,7915,531
23,13,10,11,14,196504,181673,0,0,460
18,10,8,1,13,3697118,3414,15,0,475
5,2,3,1,6,44039,15491,25,0,629
15,6,9,5,5,52197,47172,81,8413,448
8,2,6,0,10,262868,0,3,7054,562
9,7,2,5,16,173048,230183,92,114735,418
20,4,16,4,13,367428,11458,6,3865,509
20,5,15,2,7,401358,4322,27,0,451
15,11,4,10,11,1417373,1299149,177,444295,411
11,4,7,3,11,35427,54946,0,0,495
4,1,3,0,5,1487,0,0,0,647
22,15,7,0,20,414987,0,5,0,571
11,9,2,3,2,227355,8347,7,5248,506
8,6,2,4,14,83475,35026,40,15343,474
20,6,14,1,10,297232,30847,52,30847,409
10,8,2,0,18,216638,0,4,0,639
20,12,8,7,7,96214,60230,121,4963,486
17,5,12,4,9,37924,34142,77,12162,460
11,6,5,3,6,153020,103663,61,0,544
36,8,28,4,14,276766,5346,94,1606,514
32,6,26,6,9,66901,64374,277,22499,443
42,9,33,8,7,76096,72213,127,20147,505
12,7,5,6,8,112468,69128,67,17105,478
11,6,5,0,5,140517,0,3,0,533
19,7,12,9,13,370465,103802,171,27451,432
7,5,2,2,7,10966,10966,35,437,469
30,22,8,0,13,713112,0,13,0,563
30,12,18,0,9,1156631,0,0,0,687
15,13,2,9,13,135911,141866,116,34371,423
9,6,3,0,12,201615,0,0,0,654
9,5,4,2,14,32835,28724,33,21662,408
7,4,3,3,10,216543,126774,63,0,519
35,16,19,5,13,431247,106068,40,11227,475
5,2,3,2,19,9962,19828,0,0,532
19,3,16,3,11,14194,14194,8,12624,410
21,9,12,4,27,109560,62230,39,2763,510
17,10,7,9,22,204682,195808,207,1596,525
10,7,3,2,7,541880,13098,52,5633,438
4,1,3,0,8,9678,0,12,7636,505
5,3,2,2,9,38892,24672,3,10877,556
68,17,51,8,17,191417,43430,142,250300,527
6,2,4,1,3,29116,2543,6,0,586
4,2,2,3,13,21704,29790,18,15922,517
9,1,8,1,4,14567,14567,7,14567,659
8,6,2,6,12,54519,63135,0,0,447
14,4,10,4,17,488248,24740,62,10469,596
12,5,7,3,8,76232,10291,29,9776,472
15,6,9,5,15,628274,34842,81,12684,491
13,3,10,2,12,29185,38255,54,3248,460
5,2,3,1,7,21836,11692,32,1259,535
6,3,3,0,4,3815,0,0,3125,672
15,9,6,5,15,86124,33436,107,28489,375
5,3,2,3,13,38275,38275,97,25252,592
6,4,2,2,9,13026,172,4,147,543
17,10,7,4,45,468468,194723,82,4079,481
12,8,4,2,16,604398,7953,3,1984,489
12,5,7,0,17,1382647,0,9,2200,578
15,6,9,4,12,294494,5668,56,0,513
17,9,8,9,9,23309,30530,358,9544,434
7,3,4,0,10,0,0,30,9370,539
6,3,3,0,8,117567,0,0,0,617
11,6,5,1,9,202536,29817,0,27540,580
11,6,5,6,15,154833,450120,23,58634,447
15,7,8,7,18,376962,44386,140,6594,441
28,4,24,2,9,23507,13769,0,0,521
10,0,10,3,7,0,35080,78,0,515
11,5,6,4,17,455015,29800,0,6108,457
34,13,21,6,14,175474,17563,171,7750,477
11,8,3,0,4,99674,0,3,0,512
9,6,3,3,10,274674,25098,68,3644,458
65,10,55,1,15,702052,46493,54,14267,563
7,5,2,3,4,347631,33806,40,0,465
8,4,4,1,4,376213,9445,6,0,458
37,5,32,5,18,34491,41102,325,12910,541
19,11,8,8,14,194239,132339,112,26775,472
6,4,2,5,8,276180,175039,96,19130,471
30,7,23,8,14,204827,176353,284,20776,452
19,2,17,2,13,25830,25830,60,3029,599
16,5,11,5,18,109273,95501,119,68421,395
36,10,26,10,8,361288,106496,148,33660,497
16,8,8,11,7,37818,64704,199,8453,426
18,5,13,1,16,298491,10689,30,10689,511
14,6,8,0,5,397703,0,10,0,575
16,10,6,0,10,134764,0,0,278,613
31,15,16,7,12,344402,41322,56,8441,472
18,6,12,3,14,178289,21623,83,10738,683
18,4,14,2,12,53606,3796,21,3793,449
10,5,5,5,7,12080,12080,81,6813,494
235,35,200,2,21,866134,5705,48,2914,520
27,9,18,9,16,511303,207997,142,7200,529
8,6,2,6,7,40202,40202,145,16485,586
45,8,37,6,11,50248,23315,127,13663,506
14,4,10,0,15,11137,0,19,3252,539
16,6,10,5,16,38276,37955,253,9308,486
20,11,9,10,19,306638,120372,54,12060,431
18,9,9,10,14,56131,60063,161,8968,415
5,3,2,3,4,119543,85120,72,0,531
8,2,6,3,11,16295,18687,72,1500,495
5,2,3,3,7,3144,11539,116,2475,567
2,0,2,0,7,0,0,4,0,610
11,8,3,1,18,932809,87,13,806,538
12,9,3,6,7,365397,54494,112,2926,493
24,9,15,1,29,74098,571,18,465,581
9,4,5,5,19,434956,56894,66,231,489
5,3,2,2,6,9906,9906,304,8864,489
6,4,2,4,6,43581,43580,161,20487,526
19,4,15,2,4,9657,4493,33,0,453
20,9,11,2,19,1259419,9393,24,6936,566
8,4,4,2,10,11819,11819,0,0,553
11,5,6,4,9,55684,53530,96,10432,501
8,3,5,3,18,50394,30524,22,298,555
10,2,8,0,11,26165,0,6,939,678
34,12,22,5,9,151747,2039,207,391,523
4,1,3,1,8,16026,16026,34,20026,558
9,6,3,2,5,33763,6279,29,1029,675
18,9,9,2,17,666395,26346,56,25678,500
18,10,8,3,9,51659,5320,38,21097,511
16,8,8,1,14,678619,160,15,0,559
20,9,11,3,14,457578,10477,29,2899,479
9,6,3,5,8,327797,19162,52,9834,408
49,7,42,1,18,255383,1828,19,9304,627
26,6,20,4,15,810095,46690,81,3370,498
23,13,10,5,8,350605,19947,24,15129,465
14,7,7,3,8,284813,12504,161,10762,512
17,10,7,6,18,371340,13983,18,4337,415
7,4,3,0,9,69017,0,15,0,658
7,5,2,1,10,129151,362,28,0,544
34,15,19,0,22,836489,0,20,0,618
46,9,37,3,10,23239,7655,37,6035,417
125,5,120,1,14,577131,29148,20,1491,481
8,5,3,2,8,31949,34690,48,348,493
48,8,40,9,14,43664,30244,0,0,443
10,5,5,7,5,58619,65744,42,11841,453
4,2,2,2,16,17960,12457,41,8882,436
5,2,3,2,8,21468,21468,60,531,537
23,7,16,0,8,62220,0,17,176,685
17,3,14,2,12,40250,9062,49,0,556
7,4,3,4,7,23915,23915,82,17540,509
3,1,2,2,12,6500,15918,44,6500,537
9,6,3,3,5,27847,6777,160,6512,464
6,4,2,1,15,236,236,6,466,582
12,9,3,0,4,81428,0,0,0,659
69,28,41,1,14,2470180,1080,79,4824,474
18,6,12,6,10,43606,30188,0,0,466
3,1,2,0,2,34566,0,0,0,617
7,4,3,3,9,41516,18711,35,0,532
7,4,3,2,4,31111,531,32,990,549
9,1,8,0,12,17401,0,5,1286,607
42,4,38,4,10,9680,9680,221,5229,413
13,7,6,1,14,219079,890,24,2219,430
21,14,7,0,22,545106,0,2,0,573
15,8,7,1,16,34818,670,37,1650,538
11,7,4,8,6,17776,22998,140,5594,414
10,4,6,0,16,27319,0,34,3575,503
12,7,5,1,12,62835,891,10,891,450
20,7,13,3,10,149108,18807,54,9330,545
15,5,10,2,8,21057,13280,47,1784,526
18,14,4,0,5,388291,0,10,0,659
10,2,8,0,10,6672,0,0,1478,686
9,5,4,0,13,111480,0,5,1501,634
11,4,7,3,11,25677,8206,0,0,486
7,4,3,0,8,31439,0,0,0,591
9,4,5,2,18,1005249,237088,25,224879,532
10,7,3,9,8,116947,121424,308,89267,444
5,3,2,3,8,24584,22034,30,14538,495
24,9,15,7,13,943788,290312,139,81877,430
4,1,3,1,8,37000,10371,2,249,622
34,12,22,3,14,105656,26858,19,17069,464
10,6,4,0,8,99110,0,0,0,580
6,4,2,0,14,497647,0,2,1763,499
14,4,10,4,16,46270,27600,85,2428,462
18,8,10,8,10,32479,44669,254,18938,481
8,4,4,3,7,7794,7794,29,3189,458
5,1,4,2,4,25981,33207,21,7226,518
26,14,12,7,28,143380,70259,52,17577,481
27,10,17,3,19,1296990,8890,70,7849,414
5,1,4,1,8,7161,7161,46,0,519
6,3,3,2,9,295206,11370,20,7910,633
15,8,7,7,12,49126,53671,128,34137,461
15,10,5,7,8,59203,8312,118,3108,447
6,2,4,2,7,10240,9238,11,9237,532
46,13,33,13,14,404878,119856,368,17585,474
11,8,3,3,10,117065,29572,125,6498,509
26,12,14,7,6,74840,18121,97,1287,436
10,2,8,0,6,35448,0,0,0,600
10,5,5,1,6,508948,2725,40,2346,427
34,5,29,6,32,1343169,335158,4,5999,482
8,6,2,4,7,115173,104005,85,24859,479
37,8,29,5,15,99005,42534,150,8217,487
13,6,7,1,21,75864,89,19,557,602
23,8,15,0,11,524926,0,6,1700,592
17,13,4,11,6,99508,128025,200,38766,436
26,6,20,0,22,1329652,0,96,13361,491
13,7,6,0,12,9883,0,11,437,632
12,8,4,3,5,74698,13238,24,10848,535
12,8,4,8,7,23550,24968,139,7373,446
16,6,10,4,8,106574,29133,47,26080,472
5,3,2,4,4,142391,206150,75,0,515
6,3,3,2,12,15509,11260,0,0,514
8,6,2,4,13,14102,14102,72,7842,469
39,19,20,0,17,302411,0,55,0,512
24,12,12,0,9,179734,0,0,0,576
7,5,2,3,10,20483,13329,24,6246,451
14,6,8,5,14,364498,99793,37,10481,443
8,5,3,1,5,141819,8284,4,8284,673
10,5,5,0,9,111922,0,26,0,624
13,10,3,1,10,68200,775,2,489,552
5,2,3,0,8,6778,0,0,0,641
7,5,2,0,17,28533,0,6,0,629
26,10,16,12,25,681379,130946,308,20400,436
8,6,2,5,13,56329,55479,4,8108,450
3,1,2,1,6,21428,21428,38,0,505
12,6,6,3,16,800725,81484,24,22540,486
10,7,3,8,9,13681,20527,193,3724,447
24,5,19,1,8,259476,3350,9,437,517
59,5,54,4,9,56763,28285,64,13920,427
19,11,8,6,21,296627,71938,174,12453,508
16,11,5,7,7,205037,196626,144,23996,434
10,7,3,2,7,23155,439,204,1459,569
20,8,12,2,13,472113,2295,14,2281,503
24,8,16,0,12,643445,0,0,0,510
11,5,6,4,10,14012,36543,12,1884,469
16,5,11,6,10,27380,39104,78,19469,427
22,7,15,1,7,44882,4706,53,4706,556
13,10,3,12,4,198622,127197,243,42010,453
9,5,4,0,15,17335,0,0,1474,629
23,1,22,0,6,10513,0,13,0,605
17,15,2,12,3,102508,95084,26,5981,300
12,3,9,0,8,0,0,0,0,588
4,2,2,0,5,1,0,0,0,634
10,2,8,2,11,9211,9211,96,9930,567
35,1,34,1,6,445,3872,25,0,652
9,6,3,5,4,20031,20031,104,11200,615
21,11,10,10,12,264783,156846,3,6170,448
15,8,7,0,12,600113,0,2,0,563
9,5,4,4,12,606702,61802,0,0,446
6,3,3,0,7,74864,0,5,364,632
48,11,37,10,8,416161,142819,221,57915,442
9,6,3,3,7,328600,28729,33,9323,476
28,11,17,0,12,365335,0,10,0,682
10,7,3,7,7,223041,432815,93,3918,464
2,0,2,1,6,0,11415,34,0,608
10,5,5,1,9,311392,7989,20,7989,635
5,2,3,2,10,8580,5060,40,0,512
20,11,9,10,10,255886,131542,0,0,539
78,14,64,5,14,239136,22923,16,5371,497
17,8,9,6,12,150924,56923,39,10671,446
8,3,5,4,14,48779,61124,56,19348,434
9,2,7,3,19,42483,50334,1,7851,419
19,8,11,8,9,159121,152603,218,52732,499
8,5,3,8,6,44272,66386,116,25645,469
39,9,30,4,9,77640,13109,168,2783,478
16,4,12,2,9,34509,259,84,2676,576
7,5,2,3,9,123403,102156,42,1810,447
22,5,17,5,10,18512,12264,84,8373,477
7,2,5,0,8,29830,0,22,3186,633
16,10,6,4,15,276200,33813,46,0,528
18,6,12,3,11,39254,39254,69,18366,503
23,11,12,2,12,208145,9163,92,841,494
5,3,2,0,1,4867,0,4,74,656
13,4,9,0,8,580449,0,1,0,688
26,12,14,8,16,441614,440901,187,99959,453
6,3,3,3,11,33561,31560,50,4386,542
39,6,33,0,11,36340,0,150,465,641
11,9,2,7,7,392412,32450,173,10628,440
21,8,13,0,17,290755,0,3,0,622
7,4,3,5,11,706259,81753,79,562,458
16,6,10,0,14,242124,0,0,1717,683
9,6,3,2,6,292530,4719,7,1366,552
7,2,5,0,9,2237,0,0,0,666
23,8,15,0,10,108316,0,2,26,640
6,3,3,2,11,17134,22597,35,0,554
13,9,4,6,10,219141,96323,102,0,544
8,6,2,0,4,17292,0,7,8258,558
28,17,11,19,16,405140,211814,535,30495,421
18,8,10,6,33,28608,23059,49,7766,485
13,8,5,0,15,207260,0,0,0,611
9,5,4,4,9,239477,202060,12,121823,474
15,5,10,4,5,15986,14292,83,1093,472
3,1,2,0,3,28683,0,104,4534,485
11,3,8,0,13,18074,0,30,26340,554
32,6,26,1,9,138907,700,21,0,557
12,7,5,7,10,57601,67668,111,14894,459
6,2,4,3,6,17394,7643,35,0,523
20,8,12,12,4,332514,629592,149,2247,415
34,5,29,0,31,0,0,8,6053,654
10,6,4,0,7,33024,0,9,529,549
6,3,3,0,12,28784,0,6,0,701
87,10,77,9,19,733834,1219268,244,9779,504
45,8,37,3,9,111005,23228,69,9877,508
6,1,5,0,5,0,0,0,0,682
17,7,10,1,6,51719,4197,161,4197,445
10,3,7,2,10,11751,11751,28,11620,458
5,2,3,3,15,6824,6496,28,6153,544
18,9,9,7,23,1000451,657642,450,4360,492
7,4,3,3,13,71420,71164,39,6983,522
23,3,20,0,15,37739,0,1,1846,646
13,4,9,5,9,13217,15806,70,2134,463
20,12,8,0,7,264665,0,0,0,583
7,3,4,2,5,8629,8629,33,45003,638
9,5,4,4,3,31761,18204,30,5131,383
10,6,4,3,14,29632,28632,70,15557,514
14,8,6,8,12,97913,101116,306,8234,425
10,6,4,7,9,40287,40517,51,11807,472
51,21,30,6,11,690160,583348,138,1514,465
18,11,7,9,19,225363,210787,113,28684,434
39,9,30,0,6,152298,0,19,0,557
15,8,7,2,8,53166,45212,0,0,454
21,9,12,1,8,470922,3452,28,3452,465
16,2,14,3,5,44109,44109,47,23756,549
20,9,11,6,15,109469,46156,277,18685,456
18,12,6,1,8,1216376,9,0,0,557
3,1,2,2,9,22648,28045,0,0,668
24,4,20,6,19,105858,281115,140,65738,578
11,5,6,0,4,472661,0,0,0,675
2,0,2,0,2,0,0,0,0,638
26,6,20,3,12,71651,22663,54,18116,486
13,4,9,1,16,240904,17113,9,3212,621
14,9,5,0,4,110754,0,7,110,674
20,7,13,0,7,13694,0,31,366,536
10,5,5,2,25,95712,92871,60,24317,516
15,10,5,1,6,228070,448,31,0,595
53,7,46,4,11,87019,39432,66,280900,572
34,13,21,7,12,267504,36502,39,5963,423
7,2,5,2,12,572315,208935,27,0,480
23,7,16,2,5,219067,3881,9,2848,495
7,3,4,2,6,10336,8183,27,4796,480
9,3,6,4,10,448317,131165,75,0,514
13,9,4,4,18,60490,42243,116,15792,529
36,19,17,0,8,6058174,0,3,97,614
13,9,4,0,6,67232,0,0,0,467
60,14,46,3,9,278203,340,144,1300,522
2,0,2,0,2,0,0,6,457,643
5,3,2,2,8,16271,16270,39,5008,433
7,3,4,1,6,33978,6378,32,6378,480
79,19,60,12,19,171857,122373,440,55440,377
10,6,4,4,8,38133,36035,309,23890,449
5,3,2,0,8,67463,0,41,0,537
17,7,10,4,16,454148,45625,70,12787,447
10,6,4,3,10,249568,9451,68,4498,520
12,8,4,7,17,496901,93737,83,0,494
14,7,7,7,69,384190,191021,146,43943,549
7,5,2,4,5,40260,7958,129,4223,447
25,6,19,3,7,223297,4750,33,3105,462
7,2,5,1,11,51779,51779,24,840,632
20,8,12,7,19,49126,46079,104,21502,389
18,3,15,3,17,31887,27402,85,20562,470
49,3,46,0,11,6707,0,27,1481,647
10,7,3,5,5,73028,17473,87,8211,446
16,12,4,13,6,27660,37888,154,9350,435
7,4,3,0,5,10402,0,0,0,688
28,14,14,1,14,717290,7097,7,0,492
9,4,5,1,14,24613,12036,56,4677,539
7,3,4,3,8,12161,23769,42,11608,526
23,6,17,9,7,48085,75390,115,20843,414
6,2,4,2,11,45738,45629,0,0,549
28,7,21,6,12,475097,45432,0,0,446
61,5,56,5,8,217193,43483,61,10785,503
17,5,12,3,18,162662,49299,9,9723,466
22,5,17,2,13,227315,5319,33,4459,575
11,7,4,5,6,42456,41857,100,0,467
6,4,2,0,3,215800,0,6,0,635
13,8,5,5,7,29477,9036,57,4287,517
12,7,5,6,12,366046,31809,89,8267,454
11,6,5,2,16,34950,25862,35,3453,585
10,7,3,8,4,27617,33532,87,3804,413
15,11,4,3,7,46010,14585,28,2623,538
5,3,2,3,4,12952,12952,43,6376,441
14,8,6,9,9,445211,121893,116,7019,507
26,14,12,7,17,1043701,51082,53,13399,507
29,13,16,10,12,601443,206859,114,67961,434
77,7,70,4,7,211570,34987,86,10437,413
31,8,23,6,26,137537,130323,69,7407,406
8,3,5,0,5,1062788,0,0,0,558
7,4,3,0,18,90219,0,8,264,618
127,17,110,5,16,123794,124286,24,23555,420
22,10,12,2,52,522981,6238,26,646,477
8,6,2,0,4,58251,0,0,0,660
38,17,21,2,17,1478757,2842,7,17890,542
10,8,2,0,13,562864,0,0,0,678
6,2,4,1,15,2136,2136,23,5356,594
7,5,2,6,6,55574,62721,273,22795,517
15,4,11,4,7,99870,63627,113,0,477
6,4,2,0,6,21898,0,11,0,545
17,13,4,1,17,378770,650,30,0,538
8,3,5,2,12,6401,6401,12,4465,534
22,8,14,4,13,271114,7484,0,0,447
7,4,3,1,11,166881,11088,12,11088,523
14,5,9,1,16,36930,186,15,0,536
6,4,2,3,9,12980,12980,23,8181,500
29,15,14,0,10,903231,0,60,26735,513
11,5,6,3,19,291663,70581,31,39603,467
5,2,3,2,14,4217,23959,13,0,507
17,6,11,4,9,48085,41981,60,31488,440
29,19,10,0,8,189917,0,18,0,557
19,10,9,0,8,180209,0,19,4500,508
2,0,2,0,4,0,0,0,0,581
5,3,2,3,31,54944,54944,37,14829,626
6,3,3,3,8,3642,3285,153,7015,491
8,6,2,3,24,701570,47442,45,7193,465
31,23,8,2,26,293324,11385,18,8472,480
30,12,18,4,13,352890,18421,89,0,446
6,1,5,2,14,11854,19385,37,11854,640
4,2,2,1,8,362151,4984,9,0,528
26,8,18,2,15,97609,3171,9,472,548
7,3,4,1,14,11718,7448,29,0,643
16,5,11,4,10,221346,21066,110,4047,511
18,16,2,1,8,421393,997,2,692,567
20,7,13,4,4,26185,16608,36,12208,480
18,12,6,0,16,1449826,0,9,0,617
9,7,2,0,15,13424,0,9,1138,662
21,10,11,1,8,320311,62,27,0,660
22,5,17,3,18,64849,35519,18,970,476
14,3,11,3,7,65427,65427,105,361,503
11,6,5,6,10,13325,13306,66,5967,419
9,1,8,1,10,3900,3900,36,3900,595
16,5,11,1,15,57083,6162,44,4974,564
45,7,38,3,19,325365,13730,224,8008,545
15,6,9,0,8,204074,0,5,59,624
11,6,5,0,15,635906,0,12,29754,465
24,7,17,6,9,31010,32357,79,8398,422
35,11,24,6,8,34861,16814,248,6875,449
20,9,11,6,15,502405,51624,64,14662,400
6,1,5,0,7,0,0,0,0,696
45,8,37,4,14,12800,12800,226,6142,459
2,0,2,0,3,0,0,0,0,673
31,13,18,0,7,300133,0,6,0,478
49,9,40,5,7,21557,1487,82,1673,469
6,3,3,3,11,29820,29818,53,27118,521
31,5,26,1,15,149066,1481,40,2781,555
19,11,8,10,11,70309,32559,144,4356,484
39,13,26,0,15,20784,0,64,2876,580
4,2,2,0,10,9640,0,0,366,596
37,12,25,0,16,569720,0,29,1548,537
23,6,17,0,6,120352,0,4,0,634
84,23,61,0,31,7301998,0,6,1060,474
15,11,4,10,8,76271,69010,168,4459,442
9,4,5,3,8,20277,36405,50,0,625
28,1,27,1,9,4713,9944,16,0,644
16,11,5,6,14,663116,77098,54,8827,466
17,14,3,14,6,107677,52957,87,17003,417
8,5,3,2,3,47328,1377,7,1106,540
40,12,28,1,10,184163,75077,7,0,545
11,2,9,0,9,3049,0,0,0,670
37,10,27,6,10,399450,19971,71,6365,528
39,6,33,4,15,213369,12180,372,3139,608
10,3,7,5,6,98897,36850,78,22474,464
3,1,2,1,3,3367,107,1,0,642
10,8,2,2,12,123586,7200,0,0,442
19,10,9,7,17,72186,53187,82,13828,507
16,5,11,1,6,36259,15689,13,15689,635
16,10,6,3,18,363998,17536,23,198,518
11,6,5,3,14,146843,17872,39,14073,474
33,12,21,1,11,1656488,797,17,9,482
13,9,4,6,14,482576,92756,112,0,608
17,11,6,2,8,37317,7682,46,4650,652
5,2,3,3,7,50006,90209,49,9000,581
27,11,16,0,11,650455,0,25,980,522
8,4,4,2,3,15030,23467,27,0,600
27,12,15,10,14,230171,94900,19,48922,443
15,7,8,0,7,115129,0,1,0,576
24,8,16,0,9,73796,0,26,2750,611
47,7,40,3,13,95077,5812,85,5260,529
31,6,25,4,12,32469,14432,101,15116,420
33,7,26,6,13,10152,10364,137,1453,459
6,3,3,3,10,6617,9390,36,3023,622
11,6,5,2,12,1507338,13427,28,2612,474
10,4,6,3,5,15770,14540,137,3035,441
37,15,22,9,33,3950383,4221578,0,0,502
104,19,85,5,17,364047,55351,611,10858,483
33,15,18,5,8,123009,39228,211,10841,391
2,0,2,0,6,0,0,25,0,614
15,7,8,4,7,119438,84447,69,0,514
12,5,7,8,11,117438,184550,116,86838,430
10,2,8,2,12,22818,22818,30,4753,537
11,3,8,0,6,187680,0,0,0,621
13,3,10,2,8,28697,7846,59,6725,455
126,15,111,8,11,266969,58459,199,4684,457
11,1,10,0,6,7792,0,0,1865,653
8,5,3,1,10,8912,2419,7,2419,528
16,9,7,11,8,77962,79419,200,13831,420
3,1,2,2,8,13682,13682,28,8778,493
12,7,5,0,8,330816,0,0,1250,673
24,16,8,14,7,477587,51172,210,10294,407
19,7,12,6,14,209150,18108,123,4824,537
32,3,29,3,9,11946,5943,49,5645,442
8,0,8,1,13,468,468,46,468,599
99,22,77,12,10,346352,72859,304,14910,411
5,2,3,1,10,13051,13051,25,13051,543
48,9,39,6,17,27480,18151,117,5641,458
8,4,4,0,8,33634,0,17,2562,565
12,1,11,0,11,15077,0,29,2808,497
17,9,8,11,7,748490,581334,159,19739,474
19,14,5,13,11,153289,135402,172,16679,382
12,3,9,2,10,5547,5159,261,32058,462
59,5,54,2,12,11536,12841,190,1840,450
7,2,5,4,8,25274,15744,74,5950,455
5,1,4,0,5,12806,0,0,466,645
34,4,30,4,8,15111,9701,54,9377,512
20,8,12,5,8,516893,33806,118,28912,419
43,8,35,2,13,233814,4029,37,15227,433
5,2,3,3,3,16995,16995,9,4980,477
9,4,5,3,13,83658,25997,51,9659,469
33,7,26,4,9,35167,12974,32,3954,469
9,3,6,1,15,505686,5313,0,419,490
4,2,2,0,10,3131,0,8,0,621
43,17,26,16,17,412769,1554613,391,17777,433
27,4,23,1,11,10311,250,28,2400,501
10,3,7,3,8,1803,10542,40,0,509
9,4,5,1,20,556577,10786,18,3287,675
6,4,2,3,8,147428,153305,32,2547,520
18,10,8,7,8,115797,90621,312,3197,471
9,6,3,1,12,57125,3791,42,3791,506
6,4,2,4,11,33421,33421,64,12801,421
68,9,59,5,15,123537,19888,173,11650,447
41,4,37,1,14,15464,2576,11,10197,464
12,6,6,0,4,66677,0,10,0,489
13,6,7,4,14,46415,13493,19,5857,492
2,0,2,1,5,1763,1422,20,1422,581
11,6,5,5,8,30070,20859,171,15593,601
10,5,5,0,16,57402,0,15,0,689
26,9,17,5,11,758148,139814,132,11744,525
14,6,8,5,8,28305,24260,306,14196,502
51,14,37,7,13,141072,20449,117,13484,423
15,7,8,11,16,69287,107418,76,15334,416
37,10,27,0,12,320153,0,17,878,568
5,1,4,0,13,0,0,0,4285,692
7,4,3,4,10,87470,87470,54,14668,448
5,0,5,1,15,6387,6387,1,354,605
19,4,15,0,6,110317,0,0,0,655
28,9,19,8,14,95158,95158,163,28092,446
7,3,4,1,6,14095,9035,32,0,476
10,6,4,6,10,83530,80429,83,12881,466
9,4,5,4,11,35593,24987,0,0,503
5,2,3,1,8,803,16920,0,0,501
13,6,7,1,14,363872,19800,16,27710,522
18,5,13,8,7,29226,45452,165,4320,462
23,13,10,13,16,107083,100377,272,9767,388
4,1,3,1,5,6196,3822,16,0,539
5,3,2,1,6,8506,3029,0,2208,639
12,4,8,2,17,807764,64198,28,45388,515
10,3,7,0,9,6202,0,0,0,616
15,10,5,3,8,642119,12816,16,971,498
16,5,11,4,12,93906,21247,4,6725,497
21,8,13,7,13,1470510,257006,134,160985,414
10,4,6,0,6,218180,0,9,0,621
23,8,15,4,7,398718,35650,92,15153,515
5,3,2,2,8,3682,2665,32,1888,472
15,6,9,7,8,38997,42726,187,12039,441
16,6,10,5,10,619894,154691,140,3642,478
12,3,9,4,7,13833,17788,53,6073,477
10,8,2,5,13,329110,46546,9,39745,459
32,10,22,9,16,640123,90393,47,25091,452
30,8,22,2,9,252132,994,191,2730,416
14,6,8,0,4,30911,0,2,1700,549
10,3,7,0,5,196217,0,4,0,625
9,3,6,0,5,62813,0,0,0,630
22,10,12,7,12,672627,332142,133,121177,489
8,5,3,4,8,18686,17248,39,8348,454
7,4,3,1,6,73392,722,13,1722,580
8,6,2,7,14,26584,32270,95,9219,439
9,7,2,3,11,39541,7406,74,653,454
70,14,56,6,19,295619,7951,209,4928,501
14,6,8,1,19,902195,6742,35,4374,452
4,0,4,1,6,130449,130449,0,0,624
18,6,12,5,17,169627,27732,109,5656,495
5,3,2,2,7,17140,17140,0,0,490
9,7,2,0,13,102241,0,0,212,606
19,3,16,1,13,24144,378,9,1857,675
13,5,8,3,17,95852,95852,3,4034,442
34,11,23,8,17,160117,60839,167,24202,538
38,20,18,9,16,532721,54768,12,15261,474
12,7,5,0,7,68410,0,0,0,638
5,3,2,3,10,404766,110990,52,59947,447
8,6,2,2,4,145446,8424,21,0,520
24,6,18,4,20,27648,26576,77,5960,500
22,11,11,2,22,458795,2533,0,0,531
52,14,38,3,12,97193,8052,36,4253,469
11,6,5,0,10,12243,0,9,2502,661
4,2,2,0,9,0,0,0,0,733
32,9,23,1,9,411137,1840,16,0,456
13,4,9,2,17,17179,15149,7,26456,436
14,10,4,7,7,817799,377493,93,20424,446
15,6,9,0,20,423528,0,0,0,681
6,3,3,3,10,15590,14795,23,5936,458
5,3,2,1,5,19702,3175,38,1415,528
6,3,3,0,18,28881,0,27,0,675
14,9,5,0,29,389956,0,12,1790,522
5,1,4,1,9,11551,5774,42,0,529
44,10,34,1,13,80509,546,35,2474,612
10,5,5,0,4,32445,0,0,0,594
4,2,2,1,2,86360,6936,14,0,495
54,10,44,3,9,908311,603,52,3019,462
17,8,9,6,7,136869,54598,128,32808,466
6,2,4,0,10,8429,0,10,21,662
14,4,10,3,12,3161,5040,45,2668,654
4,1,3,0,13,2216,0,4,0,640
14,2,12,1,18,10983,1077,1,1413,531
73,8,65,5,9,168724,149489,145,11417,505
7,4,3,7,13,115768,119856,86,9850,385
9,4,5,4,10,12231,12230,25,11408,445
27,7,20,3,8,173198,28676,47,3907,488
37,14,23,5,11,133753,47924,83,24634,450
12,4,8,3,16,150410,16932,86,0,508
6,4,2,0,10,3269,0,6,0,546
16,3,13,4,10,9937,11973,41,2036,489
25,7,18,3,12,831364,87272,50,0,517
4,2,2,1,4,6889,12352,19,0,683
40,6,34,2,11,288164,7636,81,8200,494
27,7,20,0,19,278873,0,19,10175,607
37,15,22,12,22,2077372,320734,174,6669,481
16,12,4,9,15,74258,26956,119,9588,397
7,3,4,4,14,96079,100782,100,10247,550
54,9,45,4,9,101202,43683,75,39374,421
23,10,13,7,12,500376,199330,557,11454,452
4,1,3,0,12,150148,0,0,0,649
34,13,21,10,7,84269,67064,329,18395,408
13,3,10,3,15,308548,81054,72,1545,503
8,3,5,2,9,226054,63456,12,41388,647
14,5,9,1,8,749159,160,109,3725,449
22,4,18,0,9,187152,0,7,4080,525
21,6,15,0,14,903015,0,1,5681,640
6,3,3,1,9,343418,7942,16,8042,637
16,5,11,1,22,50665,65335,78,0,630
14,9,5,6,69,158556,158556,78,18630,437
8,5,3,5,10,25715,25584,82,3661,449
33,3,30,0,14,8730,0,4,1600,616
12,6,6,7,14,78298,51779,27,15323,443
28,6,22,8,12,54460,40459,186,18897,479
16,9,7,2,4,143848,1078,8,539,548
9,6,3,0,6,2353695,0,5,0,537
59,7,52,7,14,29043,27370,161,9900,459
5,3,2,1,13,550,550,9,2316,507
20,3,17,3,18,79751,59968,192,28319,469
11,5,6,3,12,57031,35312,52,2410,547
19,6,13,4,14,19805,19805,144,10248,550
6,4,2,5,6,14823,14482,66,7399,455
5,2,3,1,15,425971,3016,13,0,588
7,3,4,0,11,291085,0,1,12750,644
4,1,3,0,11,37836,0,0,315,610
18,14,4,8,5,81423,25622,64,9460,437
5,1,4,0,5,0,0,0,0,751
13,5,8,6,15,38024,46005,56,36513,432
8,5,3,5,8,42978,31748,126,0,517
13,5,8,5,8,89088,21018,58,5732,454
14,3,11,0,16,529817,0,0,210,716
37,8,29,5,18,27425,16246,41,6614,495
40,6,34,2,13,40814,14829,66,15513,482
7,4,3,3,13,373093,145004,68,13579,492
17,8,9,4,25,62221,187171,41,0,627
65,4,61,3,17,21412,21412,74,2493,508
40,9,31,4,3,260573,14676,27,2449,503
23,6,17,0,26,495201,0,0,0,612
9,4,5,4,5,58873,40950,20,20586,507
46,11,35,5,15,204236,14209,36,3205,444
22,10,12,2,13,221651,2094,26,28609,389
53,7,46,1,13,59274,6901,13,12782,529
72,12,60,5,14,738832,688739,92,540705,450
8,5,3,3,10,332281,7917,35,5854,509
15,12,3,7,13,45453,41328,49,20443,416
28,6,22,3,3,22675,8942,134,9994,484
25,5,20,4,16,45136,27747,150,11958,440
10,2,8,0,2,10073,0,0,0,614
27,10,17,6,15,971716,101619,49,30417,415
25,9,16,2,9,58638,4889,15,4220,452
16,11,5,1,8,246389,50,9,0,500
47,16,31,5,12,278801,23823,13,1886,514
24,12,12,15,6,1057938,1132900,58,510961,426
35,13,22,0,19,2183359,0,2,0,675
8,3,5,1,10,236330,25757,35,25757,457
5,1,4,2,7,2929,19669,0,0,627
13,6,7,3,9,69062,23716,82,22003,420
25,5,20,5,13,52874,52874,168,18457,405
13,11,2,7,11,18548,8927,40,4972,435
15,6,9,1,21,211824,13731,25,2015,536
10,7,3,5,9,68820,57903,92,618,490
29,5,24,3,6,13023,10715,47,0,552
6,4,2,3,6,6126,21843,42,730,485
11,8,3,5,18,584686,243768,96,52103,489
18,0,18,0,3,0,0,0,0,640
4,1,3,1,3,3098,3098,20,0,649
4,2,2,1,6,8978,6654,23,6654,522
11,2,9,1,13,4272,4272,24,4272,632
17,8,9,2,9,154104,1743,18,2856,600
28,17,11,14,19,426783,425147,185,4064,500
8,3,5,0,12,52237,0,2,695,528
10,2,8,2,8,21534,4755,27,2162,539
41,3,38,3,12,45709,23920,219,13585,522
14,6,8,0,10,320276,0,2,0,637
19,12,7,0,14,260884,0,50,4200,450
20,12,8,8,17,95385,64411,162,12822,442
24,7,17,4,11,19596,16270,0,0,489
4,2,2,3,7,7027,17225,45,2106,457
15,5,10,0,10,41078,0,14,1090,663
13,2,11,0,6,10333,0,5,3485,620
51,12,39,8,10,184259,35945,618,10843,415
14,7,7,3,9,29165,17572,145,13364,540
10,6,4,4,8,2460619,2437104,95,656,544
9,7,2,0,18,8144,0,0,2954,674
12,2,10,2,18,15936,24824,29,15936,577
14,4,10,1,17,218895,1,27,0,586
18,7,11,2,22,54082,87989,93,0,466
15,10,5,0,5,50401,0,0,0,698
12,7,5,0,12,225811,0,6,1075,603
15,4,11,3,12,9113,6890,201,5132,487
12,7,5,7,17,517083,274668,0,0,550
12,5,7,3,18,58047,50472,22,44786,480
6,4,2,2,3,44422,19708,84,14623,490
19,9,10,8,8,328930,325351,171,134399,462
34,18,16,1,14,1373954,1280,11,1280,536
16,2,14,1,7,13613,1,57,1628,677
12,7,5,3,11,93321,22983,49,1158,489
16,7,9,0,16,58825,0,3,1035,606
15,6,9,0,20,12137,0,1,0,720
11,2,9,1,9,0,33716,74,10654,574
7,5,2,1,6,28457,10577,0,0,570
9,7,2,2,12,283148,8917,41,0,562
4,1,3,0,7,0,0,0,0,617
10,8,2,5,11,825445,718920,78,436518,524
13,6,7,4,14,57113,38514,108,11695,436
12,8,4,2,14,196493,6821,4,999,621
11,2,9,0,15,23227,0,0,0,715
11,6,5,2,10,57109,9960,15,5420,370
54,5,49,0,14,62696,0,0,1944,706
12,2,10,1,12,51797,4280,15,252,700
12,6,6,1,10,686541,3967,7,0,568
4,0,4,1,3,807,807,11,807,561
19,8,11,4,12,978550,552240,99,25,512
24,6,18,7,19,157590,241294,101,81709,507
13,9,4,7,12,44876,30320,147,9646,382
12,1,11,0,8,192457,0,22,419,657
12,2,10,1,8,22044,1472,22,1615,577
32,9,23,2,8,60138,1138,59,1983,500
24,7,17,3,14,17193,12423,35,1250,398
15,7,8,3,11,48757,19140,8,12396,490
18,12,6,4,39,749193,13678,27,0,517
19,8,11,2,25,13537,4261,5,40917,457
4,2,2,0,8,0,0,2,67,751
27,3,24,2,8,102777,34337,101,28678,608
15,6,9,4,9,87951,43120,18,1869,519
6,1,5,1,22,208985,2063,1,2063,670
18,10,8,3,7,455085,1463,84,2405,497
9,5,4,4,15,434150,96335,78,3554,544
9,2,7,0,9,0,0,10,222,640
18,5,13,1,8,299683,2359,45,0,497
11,6,5,3,18,1399033,1057492,47,1026665,523
36,8,28,3,17,101441,2486,14,1312,504
29,14,15,7,7,468673,32586,140,12489,451
15,7,8,4,9,431242,34476,2,16386,462
27,9,18,8,13,290111,60593,136,68577,424
21,6,15,8,23,143079,257586,169,0,481
14,4,10,5,8,38270,50788,167,26654,504
10,3,7,1,14,16015,6065,0,0,623
5,0,5,1,11,11840,11840,8,11840,599
4,2,2,1,15,34609,33609,17,33609,593
6,4,2,5,7,40562,65178,105,6048,524
6,4,2,5,4,28866,28866,96,20626,449
26,6,20,3,16,36667,35896,153,27573,391
11,9,2,0,7,212600,0,1,0,666
6,3,3,4,5,27112,40327,82,20527,495
23,6,17,0,13,79912,0,32,4345,555
10,5,5,5,7,30700,53202,52,1211,462
12,8,4,5,9,17396,12176,124,6693,431
11,8,3,1,8,973728,1100000,3,406,512
6,4,2,4,7,27285,28773,66,14237,447
35,5,30,2,7,9363,1938,33,2291,483
9,3,6,3,6,46075,34189,48,5521,454
6,2,4,2,14,11961,11961,52,2638,482
5,3,2,2,4,11649,11530,12,8290,522
18,6,12,6,10,79864,87466,214,70892,511
25,5,20,0,18,473605,0,1,3354,563
14,2,12,1,4,3960,2034,0,0,479
7,4,3,1,7,173781,8104,12,8104,615
4,2,2,2,5,1292,1292,28,765,556
9,3,6,0,8,188635,0,11,0,658
19,2,17,3,12,490290,46521,4,650,502
28,7,21,0,8,48536,0,9,0,555
19,9,10,7,25,977513,139482,85,59816,443
33,6,27,2,11,307127,45817,155,15806,449
36,10,26,1,17,91340,5135,177,5135,533
64,7,57,4,15,610918,48074,106,27760,506
23,4,19,0,14,24035,0,0,0,640
14,1,13,0,4,3899,0,8,0,548
7,5,2,5,14,47078,45862,52,21883,436
9,6,3,0,5,289086,0,0,0,674
7,3,4,1,7,16531,30682,27,0,644
30,11,19,6,69,864822,332791,58,12144,466
10,4,6,0,4,0,0,16,759,673
17,6,11,0,12,51214,0,22,895,628
10,7,3,3,11,167059,64026,41,31113,466
4,2,2,2,4,5880,5880,42,3706,508
20,6,14,6,10,24961,32305,0,0,409
10,6,4,6,15,19595,28215,72,13271,674
23,10,13,8,16,564496,72878,201,9565,450
7,5,2,1,7,94698,41478,22,41478,614
8,6,2,0,6,90601,0,0,0,700
17,6,11,5,8,357030,38245,119,10991,477
10,5,5,3,8,69535,6084,51,2550,436
4,2,2,2,6,14357,14357,0,0,460
8,6,2,2,8,14205,8658,36,5145,465
5,3,2,2,31,1288002,61220,43,0,556
10,6,4,3,8,65336,14962,53,2988,439
20,10,10,3,14,64432,21973,0,0,457
29,13,16,4,11,758846,54014,151,2395,524
12,8,4,0,14,444442,0,8,40,645
24,4,20,6,16,119410,113494,126,23274,463
11,5,6,7,18,100312,99517,140,30282,480
32,9,23,10,11,71451,52449,159,15952,382
12,3,9,0,17,46748,0,0,1641,639
19,9,10,3,14,217330,27268,54,16961,494
11,7,4,3,13,375498,19003,7,7384,442
7,2,5,1,8,26503,26503,13,26503,551
41,13,28,0,12,477594,0,8,0,598
30,6,24,4,9,42821,22824,198,20760,426
12,7,5,3,12,103281,76465,18,63815,457
11,8,3,5,6,196746,105974,139,1476,452
26,4,22,2,12,40557,16838,309,13358,438
14,7,7,0,10,1995699,0,10,0,590
10,4,6,1,4,188669,4591,0,0,495
15,2,13,3,11,63731,26812,22,1250,499
10,5,5,1,5,51486,12804,23,0,575
44,10,34,5,13,158909,28369,71,3434,459
19,6,13,0,7,19385,0,4,901,509
14,9,5,6,19,117247,33262,118,9723,436
5,2,3,0,14,198412,0,0,0,600
56,4,52,1,4,11571,1535,6,1535,528
9,3,6,0,13,25586,0,0,0,661
4,1,3,0,7,0,0,0,0,639
141,16,125,4,38,464928,6469,21,2248,583
15,7,8,0,18,245568,0,7,0,644
3,1,2,0,6,0,0,0,0,647
19,8,11,5,9,103023,42790,115,512,486
15,6,9,3,10,47839,19744,82,8898,485
28,16,12,9,24,240929,232560,215,140419,436
15,11,4,6,8,21426,1496,27,3103,552
7,2,5,4,9,5315,15629,51,4064,599
3,0,3,1,4,0,11972,28,0,630
27,8,19,7,13,85049,93365,82,48064,519
11,6,5,6,14,251979,35304,176,4627,467
14,8,6,0,14,601031,0,0,256,628
10,6,4,1,18,10995,5018,33,37650,609
6,3,3,0,7,9377,0,0,0,680
15,6,9,3,12,280349,5110,62,871,443
13,8,5,3,3,90800,13261,19,6900,475
15,4,11,6,8,38347,38347,66,18785,478
8,5,3,2,9,14861,4839,19,0,446
39,7,32,3,15,38892,4699,8,3097,507
8,6,2,5,5,24156,5477,157,3470,494
9,7,2,6,5,53061,34120,35,10809,431
6,3,3,3,6,3923,3923,43,2486,431
18,11,7,0,12,319726,0,2,4,594
13,5,8,4,9,28794,35144,77,1842,447
24,14,10,10,11,421609,2904554,209,0,443
25,5,20,6,10,55296,55296,297,26460,452
7,2,5,0,5,25522,0,2,0,688
33,10,23,5,8,26428,18695,206,9212,473
14,7,7,5,19,385333,16574,82,7275,403
3,0,3,0,17,0,0,0,1533,562
22,14,8,8,13,586396,24174,30,1130,522
3,1,2,3,3,32805,44688,40,20923,488
46,13,33,12,35,292999,101330,129,19795,417
14,6,8,7,8,16352,16740,61,6740,422
10,4,6,3,5,12650,1716,41,32247,514
7,3,4,3,8,160272,120517,38,13651,466
18,6,12,0,11,528660,0,2,5843,571
15,2,13,0,13,16015,0,8,0,550
37,11,26,10,10,56058,51981,273,14247,410
28,3,25,0,14,29847,0,19,3297,667
4,2,2,3,7,46311,57851,74,0,517
17,5,12,1,8,80130,3452,20,9505,513
14,8,6,3,7,148021,76673,49,39640,651
87,15,72,6,10,113123,24532,10,7552,500
6,3,3,3,10,129042,49685,34,3347,482
11,3,8,0,4,96589,0,0,0,546
6,2,4,1,10,4028,4028,21,4028,576
5,1,4,1,9,1390739,21632,28,2031,502
11,9,2,6,10,119896,118666,75,86712,385
20,9,11,1,11,45164,6199,17,6199,434
39,7,32,3,12,70124,9982,56,10213,503
10,5,5,2,9,53457,22623,29,0,557
10,6,4,8,14,960011,296087,17,34647,457
9,4,5,2,22,13997,13997,30,4617,570
6,1,5,2,17,24087,4530,86,3721,559
83,11,72,1,17,271186,5304,9,5304,424
16,10,6,1,12,896235,43596,16,0,568
5,3,2,3,18,523503,100942,0,0,644
12,4,8,3,11,17750,4550,13,1554,473
13,6,7,6,6,19196,19755,84,5433,445
16,10,6,7,13,53179,32725,114,9501,462
32,11,21,10,12,170235,114747,0,0,454
48,3,45,2,10,5371,6233,81,8480,567
10,6,4,3,10,93695,10411,90,124065,426
12,5,7,4,8,16674,11952,53,4999,457
7,4,3,3,25,458426,41928,132,37094,493
16,9,7,0,10,352930,0,7,0,657
40,6,34,8,12,76331,103937,226,46264,467
19,12,7,1,8,2045877,6129,4,0,499
5,3,2,1,11,78040,49411,9,49411,449
16,6,10,6,7,30400,25420,172,1712,412
11,6,5,1,6,36293,85,17,378,460
41,8,33,3,13,86518,25619,37,41707,500
8,5,3,4,13,23397,31966,39,13845,547
18,6,12,5,14,143060,143059,65,89217,481
11,9,2,0,23,22980,0,26,2590,601
4,2,2,1,11,20857,10963,22,1011,647
13,6,7,5,10,15867,10740,23,6826,480
46,12,34,12,14,91038,106335,530,16303,436
18,8,10,0,18,216298,0,0,1405,619
6,2,4,2,15,12192,19503,48,0,531
15,9,6,3,8,164840,5987,111,1659,445
18,9,9,9,34,444353,97862,115,13500,445
18,8,10,6,6,38527,12139,23,7381,489
7,3,4,4,9,44293,42269,4,1205,440
15,7,8,6,13,310819,51711,234,21721,446
10,8,2,6,18,38641,43184,98,3393,495
29,9,20,4,12,424539,30724,74,6234,469
8,2,6,0,40,17007,0,49,0,437
87,7,80,7,4,80845,64193,133,14387,443
31,16,15,0,10,514864,0,11,0,637
10,5,5,1,6,3184,2933,140,309,579
6,4,2,1,9,13720,1887,19,0,466
9,6,3,1,6,183023,2128,7,2128,487
40,24,16,8,19,1115466,579871,232,8470,515
17,5,12,1,7,28324,4803,46,4803,350
49,9,40,5,10,257243,203352,76,168490,455
20,8,12,1,10,40528,9520,69,15487,477
16,4,12,3,8,35212,23246,147,12750,455
28,8,20,4,4,76070,25663,37,3172,409
10,8,2,6,4,71847,61507,83,20366,460
15,8,7,0,16,379185,0,13,1143,671
26,7,19,3,18,923272,14114,67,4210,536
131,12,119,8,11,75433,32074,88,7979,417
28,17,11,0,24,749185,0,34,2222,601
10,1,9,1,5,24080,24080,25,910,457
52,9,43,5,13,270904,47120,32,22030,384
8,5,3,6,8,62498,40043,95,7795,515
11,8,3,5,13,787843,149172,38,2171,470
23,4,19,2,9,38914,18493,52,15418,443
7,4,3,4,6,15513,7027,44,3320,476
66,15,51,5,6,111283,11911,41,24986,476
74,34,40,17,24,612211,155528,247,36666,433
14,9,5,3,9,107107,11424,60,1548,454
9,7,2,4,8,229648,19111,139,7656,491
5,0,5,0,11,0,0,39,23739,433
23,13,10,0,11,513904,0,0,0,534
18,11,7,8,12,48586,48586,86,15252,608
22,13,9,0,11,1598443,0,15,0,589
7,2,5,1,13,58134,1075,5,3068,629
7,5,2,3,10,277715,31043,67,6469,488
5,2,3,2,8,12246,6858,30,0,462
5,2,3,0,8,39446,0,4,0,587
18,3,15,0,7,22445,0,2,2022,501
9,3,6,0,4,15268,0,12,301,523
15,2,13,2,11,8972,8972,127,13976,583
12,4,8,4,8,16452,16452,216,9081,525
15,7,8,2,9,26086,3283,228,5990,541
22,5,17,4,6,60021,7446,115,1190,528
22,7,15,2,13,299077,14479,43,4068,553
28,3,25,3,12,7758,41399,37,286,529
12,6,6,10,16,84732,101986,105,17514,488
8,3,5,2,14,24821,19862,19,46377,555
5,2,3,2,8,78808,78808,92,4244,568
19,5,14,3,13,96467,54274,37,50358,448
13,8,5,0,5,10299,0,1,491,636
25,11,14,0,20,1020141,0,9,0,641
26,5,21,0,17,118090,0,19,1344,595
8,3,5,1,17,85068,13299,8,0,479
52,9,43,2,10,120858,22750,36,3864,518
5,2,3,1,8,42852,2297,4,2297,562
27,6,21,1,14,39413,10556,35,10556,539
10,3,7,2,7,32759,29859,24,16859,639
32,14,18,6,9,256806,61350,141,35948,422
6,1,5,1,7,763,763,63,1022,520
4,1,3,0,19,0,0,2,0,736
5,3,2,2,6,517356,33024,46,0,469
12,5,7,5,7,45813,50736,74,2459,494
9,6,3,5,17,348660,99731,71,14,453
8,3,5,1,8,384534,9277,48,0,614
24,10,14,3,11,711135,34613,71,2670,383
9,5,4,3,6,101786,18363,65,4325,479
8,3,5,1,14,32947,17265,10,17265,534
14,6,8,2,9,59599,15161,7,0,426
17,4,13,1,9,34662,1083,4,0,652
15,8,7,4,7,26252,10417,143,6904,443
9,7,2,4,14,134605,134605,83,41342,616
21,10,11,0,18,29127,0,24,16060,544
29,7,22,9,9,33648,39022,448,11668,437
9,6,3,5,9,31165,31165,239,14533,456
14,8,6,2,13,67064,1818,25,1980,603
6,4,2,3,16,950650,177309,65,0,502
5,3,2,0,7,25141,0,0,0,657
10,6,4,6,9,343918,37618,106,6886,486
30,11,19,1,11,1661681,4306,16,5216,501
20,9,11,1,10,567575,2555,15,0,540
12,3,9,3,6,22844,24848,51,12517,502
16,14,2,12,8,87735,84468,77,12134,455
40,12,28,1,13,338782,208,32,19885,594
8,5,3,4,3,14335,13851,61,2843,453
8,2,6,2,8,11901,11901,42,10219,520
67,4,63,4,13,28484,39651,95,24098,455
7,4,3,0,10,14535,0,8,0,606
6,3,3,4,16,30962,32417,28,12336,482
5,2,3,2,9,8435,8435,0,0,533
6,2,4,1,6,16423,16423,50,6600,534
27,9,18,5,20,324853,13836,128,7142,453
16,4,12,6,6,27970,26177,106,15142,431
16,7,9,1,14,99282,2858,1,2305,555
11,6,5,4,11,289424,554586,103,0,507
7,4,3,2,19,15631,8384,48,6900,532
27,17,10,0,20,465154,0,35,565,655
64,11,53,2,17,355820,3005,74,6942,573
12,10,2,7,19,685493,180482,146,997,527
15,13,2,9,4,274056,265880,91,0,437
10,3,7,0,9,23174,0,7,3937,579
3,1,2,1,10,4992,4992,22,4992,575
15,8,7,0,17,602139,0,11,2480,637
8,5,3,4,8,644155,220186,39,0,476
15,3,12,0,9,47160,0,55,2391,549
26,7,19,5,10,50136,46051,89,22533,451
2,0,2,0,5,0,0,9,0,652
6,4,2,0,4,40991,0,0,0,661
13,6,7,1,10,19089,2040,27,2040,513
9,5,4,5,12,22730,15690,30,6300,490
19,5,14,3,13,8035,7669,52,5718,427
21,9,12,6,9,334503,27100,99,10257,432
6,3,3,1,14,1237,154,4,0,697
7,4,3,2,15,701954,144523,40,79698,570
11,5,6,0,8,64,0,111,3820,487
13,8,5,0,16,591411,0,13,4059,575
5,1,4,1,8,83723,83723,23,83723,471
34,4,30,2,12,46574,7940,67,7000,615
162,12,150,11,15,302345,223514,201,19288,430
14,7,7,0,2,154696,0,2,0,578
4,2,2,0,8,0,0,0,0,670
5,2,3,1,10,277041,2941,13,117,461
10,7,3,3,8,40096,18531,3,649,529
40,6,34,6,8,52501,46125,124,22693,502
15,11,4,6,12,879515,237003,52,184300,474
12,5,7,1,11,14233,6875,7,7108,523
7,2,5,0,12,183197,0,2,4,532
38,8,30,5,12,104391,87075,108,55287,440
11,4,7,3,8,145530,9215,23,0,469
11,7,4,7,8,36275,33701,126,8554,466
83,18,65,12,26,484623,256895,578,10446,530
27,6,21,3,9,49016,4356,127,8688,521
26,4,22,2,11,20341,8086,77,7106,486
42,10,32,1,12,202876,40655,43,0,453
8,1,7,1,6,20887,4049,7,3840,651
10,1,9,0,16,24030,0,15,0,661
10,6,4,0,7,92311,0,0,0,686
11,5,6,3,12,33656,8494,18,3562,488
10,6,4,4,12,237929,26120,22,1687,443
34,6,28,3,11,212133,76606,24,2487,423
8,6,2,0,6,39554,0,8,0,521
9,6,3,7,5,18314,21141,94,3602,380
8,6,2,6,13,42335,21458,55,4458,439
11,3,8,4,8,61759,70061,62,18684,588
15,5,10,1,8,33322,4352,4,4352,535
13,5,8,5,10,125146,1019588,11,124566,497
18,7,11,3,9,72804,17572,83,1324,424
38,6,32,3,14,246674,12063,54,7161,522
16,10,6,2,8,1181260,8087,20,2814,534
32,16,16,3,14,576988,650,22,52,520
12,5,7,3,9,291064,14824,73,0,454
8,5,3,2,3,24902,21842,160,13526,474
15,5,10,2,16,127364,146318,22,0,531
30,14,16,0,13,1253710,0,11,1105,574
30,9,21,15,9,1354099,1920236,172,395814,411
11,2,9,5,12,581899,28350,0,0,474
26,5,21,6,20,1412962,332694,88,0,489
8,2,6,2,8,11006,8900,21,9365,417
30,5,25,5,8,18580,18280,149,14457,454
21,3,18,1,17,14169,5974,26,5975,552
6,4,2,2,3,36203,3992,10,3603,522
23,11,12,2,14,29319,9723,6,6128,565
10,6,4,0,8,357592,0,0,0,580
29,10,19,5,20,128628,5505,0,0,510
39,4,35,2,14,62447,26612,3,1234,629
29,5,24,7,13,503201,39501,125,3251,474
12,5,7,5,15,37611,85169,53,2898,561
8,5,3,3,18,688745,95555,48,70184,566
13,1,12,0,18,0,0,95,27743,593
9,4,5,2,8,17018,12817,211,12808,529
163,5,158,3,13,177238,40257,92,12873,624
25,11,14,8,6,94875,49240,119,13578,376
33,5,28,1,8,25447,5300,64,6387,528
5,2,3,2,14,27282,22069,23,1472,613
8,2,6,1,8,19126,13806,25,698,468
4,2,2,2,4,3366,2754,47,0,519
6,4,2,0,4,3434,0,0,0,615
12,3,9,2,11,13056,26464,36,2413,511
9,3,6,1,12,63092,62274,11,62274,547
23,8,15,5,18,72033,39545,19,17802,542
27,6,21,4,13,39806,26395,45,22186,457
30,2,28,4,14,64435,64435,133,16660,531
11,7,4,2,31,95418,9869,22,2694,570
42,10,32,8,13,599215,296733,140,106107,429
13,8,5,5,23,1074192,34659,74,5975,561
17,8,9,0,9,313311,0,0,0,645
44,7,37,5,20,74124,87689,28,223950,507
8,5,3,1,7,23740,116,7,116,571
15,5,10,4,9,103310,87938,100,2324,505
32,23,9,21,20,1508894,1092513,366,3219,507
11,6,5,2,6,17505,1950,72,1628,507
17,6,11,5,7,31204,23193,73,6959,445
6,2,4,1,8,39198,14700,9,14700,641
11,4,7,2,9,54584,37325,36,31989,520
12,4,8,1,8,81258,1292,1,1292,522
18,5,13,1,13,336866,6334,28,3252,489
11,4,7,3,29,34745,34745,50,4143,623
11,7,4,4,12,197395,29074,112,4439,529
29,8,21,1,13,329996,5657,31,0,503
15,10,5,4,10,98721,22257,0,0,439
33,23,10,4,9,1307184,17271,6,0,560
6,4,2,0,4,36416,0,0,538,668
10,8,2,8,8,160330,37514,169,11300,427
4,2,2,1,10,487474,1303,16,0,579
8,5,3,2,27,168014,153016,40,120042,482
5,2,3,3,9,118854,119319,0,0,482
9,2,7,4,8,1034,35702,93,0,507
12,8,4,4,9,208656,7392,27,0,517
10,6,4,0,6,71613,0,0,0,640
29,10,19,0,13,225187,0,24,1137,667
20,6,14,4,19,88539,82790,119,44577,508
183,9,174,1,8,29707,2488,198,2971,498
47,15,32,11,12,213245,153352,177,11125,495
13,4,9,3,11,304427,21392,44,11092,414
8,2,6,3,8,156312,76936,0,0,602
15,7,8,0,15,1462423,0,10,0,677
8,4,4,0,9,89447,0,17,0,538
15,5,10,2,6,19109,9057,21,2912,479
21,5,16,4,19,254787,36552,1,3880,469
21,5,16,0,20,383242,0,0,1071,555
14,3,11,4,4,12840,9221,12,4133,398
6,4,2,1,7,2786,2786,12,832,496
6,4,2,4,14,63786,63786,96,20773,469
18,8,10,1,13,432216,937,5,937,555
3,1,2,2,7,20372,11389,27,0,641
10,4,6,0,9,258218,0,14,0,589
36,17,19,2,14,153325,4002,27,10706,531
46,13,33,7,9,57485,45766,226,22696,421
8,4,4,2,13,28562,9923,63,0,555
14,7,7,3,14,68927,7396,5,2923,509
10,5,5,2,9,388784,397,17,0,504
15,6,9,6,13,246256,74871,125,0,515
5,2,3,0,11,318074,0,18,860,538
14,11,3,1,15,587574,1525,2,2113,532
10,5,5,5,18,30878,31234,58,12712,464
7,4,3,2,7,9423,9423,43,9139,640
3,0,3,0,3,0,0,0,0,689
10,6,4,4,13,130382,129872,61,72931,440
18,4,14,0,7,24816,0,146,1785,621
28,9,19,6,14,35354,30956,53,9901,481
11,3,8,4,18,104982,104982,64,67498,499
15,10,5,0,15,810872,0,29,549,453
32,7,25,2,19,68771,4690,47,6005,453
11,2,9,2,9,62326,58842,51,0,501
11,6,5,1,16,53037,2050,29,2050,529
19,9,10,9,17,279360,52372,142,3083,434
13,7,6,7,16,77713,84279,136,49002,441
14,5,9,6,8,92145,56994,0,0,447
7,2,5,1,8,4639,2139,24,2139,644
12,4,8,3,7,42934,42933,37,36732,544
40,13,27,6,16,154012,36645,119,88517,476
108,13,95,14,15,56465,64964,493,9182,447
8,5,3,2,9,10357,4197,52,3124,473
10,5,5,4,9,89807,89807,56,15605,438
4,2,2,2,8,323,25844,29,323,505
12,10,2,7,9,88225,59901,115,6315,449
49,9,40,0,12,194630,0,92,3952,454
34,12,22,1,15,947128,5730,15,5730,594
10,8,2,5,10,673405,238035,5,6496,370
26,5,21,5,9,9046,23928,180,12328,442
8,3,5,3,14,59694,41844,21,21141,497
12,9,3,0,10,266402,0,23,0,530
66,9,57,4,14,914099,16323,189,6388,567
39,8,31,6,13,75049,32322,104,3992,455
61,6,55,5,9,36118,36768,43,18533,466
8,4,4,1,18,295773,53,3,1345,512
9,6,3,3,7,57132,14575,59,6835,534
16,13,3,0,9,225798,0,3,1504,568
17,9,8,7,6,90490,80279,27,7667,432
10,4,6,0,9,340854,0,9,4191,569
14,10,4,4,16,540856,93347,67,7991,474
16,6,10,3,14,179280,15758,20,12217,514
17,7,10,0,8,235941,0,27,0,675
61,18,43,9,13,340500,104711,180,32078,420
17,3,14,3,7,12342,24506,61,0,513
14,10,4,2,23,1405831,190605,26,425,456
34,3,31,2,10,7354,7354,307,10311,631
16,11,5,0,11,454577,0,3,0,629
10,4,6,0,12,5677,0,4,860,623
8,5,3,3,18,878714,174680,106,139355,441
7,5,2,5,6,30989,30751,48,8910,467
12,9,3,2,5,94655,12447,28,11757,480
9,3,6,0,4,3393,0,2,219,659
24,12,12,14,36,336266,481383,302,79517,505
17,6,11,0,14,5536,0,2,0,714
44,10,34,3,9,130519,93973,51,9475,458
22,7,15,4,25,290127,178347,120,0,503
7,5,2,1,7,107895,2243,11,5162,416
7,4,3,4,7,22324,22576,294,11138,525
6,2,4,2,7,26706,26706,44,13353,435
11,3,8,1,8,9423,1071,13,1071,644
17,2,15,2,10,53215,15140,95,5155,526
5,3,2,1,10,13486,3901,3,0,536
7,2,5,0,7,41163,0,0,0,540
14,9,5,0,6,129436,0,0,0,672
37,9,28,2,8,187381,184,82,1506,517
17,5,12,2,11,25622,16810,8,15227,517
13,3,10,1,19,17448,14948,0,416,518
8,5,3,1,8,39464,897,110,969,498
21,4,17,1,9,39548,949,5,4363,503
6,4,2,2,15,384402,153491,46,149739,449
24,14,10,9,14,381394,54696,82,15700,431
27,11,16,0,19,1698340,0,19,0,615
11,4,7,0,12,216873,0,0,0,658
41,10,31,8,12,2854757,2387166,114,161069,444
8,5,3,3,8,14289,14289,360,9284,526
26,7,19,0,7,441737,0,19,0,464
5,3,2,1,12,5509,3437,9,3437,471
8,4,4,1,6,81967,8341,26,4429,560
12,6,6,3,9,8845,3464,66,2314,424
12,6,6,7,9,77724,67930,110,22334,480
12,2,10,7,8,32717,98683,7,23684,507
19,5,14,3,8,19314,3720,62,3428,593
20,13,7,11,13,70700,68717,215,22142,403
26,9,17,7,4,139144,45702,99,25103,452
7,5,2,0,7,74334,0,0,0,670
6,2,4,0,8,390021,0,2,0,621
12,5,7,2,7,18671,103162,23,0,667
24,14,10,10,11,374225,2902799,202,186593,491
11,6,5,0,8,20807,0,14,0,560
27,7,20,2,11,17223,8844,30,3942,463
46,6,40,4,11,36608,16899,81,2000,473
10,4,6,2,13,16689,2274,1,1219,560
14,9,5,4,14,912072,242734,61,20125,367
7,4,3,3,12,418924,12118,12,9109,486
25,8,17,4,69,50923,6561,131,18996,429
16,2,14,0,16,1665,0,0,2222,581
7,4,3,3,28,128341,245508,135,117167,462
27,4,23,1,6,12661,2468,54,3282,509
56,7,49,1,9,31548,675,29,10520,634
32,5,27,5,8,80167,42728,142,30920,498
18,10,8,3,12,326111,91668,54,71676,446
4,2,2,1,8,7721,7721,7,7721,648
15,5,10,5,9,100951,99521,6,24995,435
8,1,7,0,11,5380,0,31,0,578
9,3,6,1,12,71827,503,18,0,478
13,9,4,8,7,393855,73542,415,8092,477
6,2,4,0,10,14220,0,0,0,694
7,4,3,3,11,85187,115722,62,63471,469
13,5,8,0,9,25363,0,23,551,609
19,5,14,2,13,117892,36501,48,15848,459
6,2,4,1,4,15856,3730,17,3730,513
12,8,4,7,9,45453,42778,94,7296,442
22,4,18,2,11,26840,24753,42,14389,477
14,11,3,0,7,287606,0,2,89,552
18,9,9,6,6,28464,4835,34,2224,508
20,10,10,2,4,60851,13388,44,8360,424
9,4,5,7,8,24155,30142,16,2498,438
14,7,7,4,12,24931,20444,59,13629,477
20,15,5,11,6,379932,152514,131,50397,483
31,17,14,0,18,413168,0,3,0,616
53,21,32,5,13,202834,62826,137,2606,517
18,6,12,2,30,83062,17699,45,11064,538
13,9,4,1,14,161707,5096,69,7610,427
24,6,18,4,18,60102,15083,25,9881,464
56,11,45,3,16,687272,29166,114,18186,469
11,8,3,2,13,166236,1578,14,3560,475
5,2,3,1,10,27766,2717,18,0,643
16,13,3,0,15,497390,0,11,0,605
8,3,5,2,4,21636,13841,0,0,541
6,2,4,0,5,11921,0,1,1250,622
7,4,3,4,5,14579,14579,139,9589,608
3,1,2,0,6,7131,0,0,0,690
8,6,2,5,6,83789,82198,43,70173,468
6,3,3,2,12,2119902,588180,37,0,522
9,5,4,1,6,13980,1622,32,1622,575
14,6,8,0,4,13781,0,16,0,508
9,4,5,2,6,223709,29837,26,0,453
22,5,17,4,12,410187,35289,0,0,442
81,26,55,2,29,4661719,22720,47,21652,546
30,5,25,0,16,199570,0,177,1629,570
4,2,2,2,9,5012,5012,16,2509,549
23,13,10,7,16,793394,306910,79,117631,396
6,4,2,2,9,11783,3599,1,1439,508
15,5,10,4,12,9524,9394,75,27198,448
9,6,3,3,11,712837,41383,0,0,462
80,11,69,7,30,682270,73390,446,43715,447
10,5,5,1,12,519369,462203,83,0,493
18,12,6,3,8,394368,7739,28,565,465
6,3,3,2,7,275817,21483,6,20745,517
22,12,10,1,11,221217,410,4,833,476
33,6,27,3,21,147163,42067,144,1710,606
8,5,3,2,13,35913,32317,16,916,544
21,8,13,10,7,99072,116698,332,7424,482
11,8,3,0,21,311925,0,3,0,644
15,7,8,2,14,397461,491,0,0,659
8,1,7,1,7,807,807,3,516,489
8,1,7,1,6,8838,8838,17,8838,518
12,4,8,5,9,26040,40184,124,0,550
11,4,7,5,8,35529,35529,141,10300,507
31,12,19,6,10,362729,18184,145,6875,486
14,5,9,4,15,475861,10526,65,18330,423
2,0,2,0,21,0,0,15,0,679
3,1,2,0,12,6848,0,2,0,648
9,7,2,1,22,591189,40852,0,0,580
33,19,14,8,10,714372,488985,0,0,444
11,7,4,1,7,51668,281,52,5658,482
8,2,6,0,15,124322,0,37,0,559
26,12,14,12,14,461074,518178,179,12800,450
40,6,34,3,12,179389,10655,41,7708,579
7,3,4,1,20,88274,62422,17,62422,581
25,10,15,5,17,3109631,231016,0,0,482
10,6,4,5,5,47936,37306,252,16029,525
4,2,2,1,12,48585,24560,7,24560,578
12,3,9,1,12,2083,338,38,9721,495
5,3,2,2,8,16384,16202,8,2076,474
11,8,3,0,16,252125,0,2,0,642
5,2,3,2,8,6924,6924,0,0,544
17,6,11,1,6,294195,647,28,348,549
16,6,10,4,8,137250,131550,88,81509,446
8,5,3,0,11,185455,0,0,0,700
40,14,26,11,13,276010,69762,192,14568,491
7,4,3,5,13,77857,47291,38,0,673
11,5,6,4,15,10717,5482,26,1132,449
10,3,7,2,14,224251,11647,38,15149,509
84,11,73,15,13,167261,123644,383,16806,411
28,4,24,3,6,224453,23928,53,9982,483
6,4,2,0,13,499468,0,0,0,592
3,1,2,1,4,454,454,3,454,630
16,9,7,0,4,49311,0,6,0,590
5,2,3,2,21,18217,18217,0,0,636
6,4,2,3,15,596375,47135,31,17719,470
13,9,4,6,7,36597,29231,325,13628,444
7,5,2,6,6,89956,89954,46,9883,450
11,5,6,4,7,20907,22586,0,1528,452
12,5,7,1,7,758004,6751,31,1961,589
10,3,7,1,13,88805,3091,25,0,522
21,6,15,3,10,302274,6742,19,4907,528
18,9,9,7,8,80216,65946,137,3747,422
5,3,2,1,8,87623,113,0,0,647
23,3,20,5,7,21809,88415,201,2438,466
11,6,5,0,5,59158,0,27,4403,545
12,4,8,1,9,25794,110,1,0,650
10,2,8,1,11,6106,1303,20,764,644
6,3,3,1,5,34047,4762,4,4762,555
93,11,82,8,6,60550,38703,114,9999,382
14,7,7,2,11,452015,36840,4,14660,453
11,8,3,7,9,45426,45273,472,12256,459
26,3,23,4,8,35457,38656,94,26100,516
16,12,4,2,14,1345208,7013,7,4501,574
4,1,3,0,13,0,0,6,271,696
34,21,13,12,12,1072882,177255,232,31428,418
22,13,9,0,8,323908,0,12,0,551
7,5,2,1,14,103635,1380,10,0,470
47,20,27,0,12,2699555,0,8,18173,497
31,10,21,7,10,361667,130186,87,13193,443
6,2,4,2,11,86086,97665,41,0,483
22,2,20,0,12,16502,0,62,5054,414
10,5,5,1,14,397517,3003,28,1310,599
18,5,13,7,9,79517,67259,127,11253,424
11,9,2,0,8,167753,0,0,0,531
17,9,8,0,6,219602,0,16,0,599
16,5,11,3,9,42028,42028,226,12354,512
2,0,2,1,3,0,3999,4,3999,496
16,3,13,1,8,30561,12064,21,12064,683
10,4,6,3,10,15349,22444,55,2160,453
8,3,5,3,15,17524,2699,84,2703,528
4,2,2,0,20,7578,0,9,0,692
7,3,4,1,2,18546,36155,8,36155,562
7,2,5,3,9,0,27864,0,0,559
4,1,3,0,4,4023,0,0,0,620
6,4,2,0,13,1075046,0,2,2025,572
34,8,26,3,11,338026,11473,20,0,446
7,4,3,4,13,1845564,487277,51,13914,520
70,9,61,6,17,704723,124374,276,46912,454
13,5,8,4,6,16810,7602,9,4593,436
65,10,55,5,15,181017,59015,157,35185,477
12,8,4,1,9,73692,796,15,1770,596
17,13,4,3,9,1952931,1276,21,0,467
7,3,4,5,7,18554,30324,53,9308,519
17,10,7,10,10,356105,69329,132,19210,476
9,7,2,1,6,516253,4700,3,4700,438
38,7,31,4,18,80752,25650,206,2650,503
8,2,6,2,11,7042,8707,0,0,496
8,4,4,0,7,4092,0,1,0,651
24,9,15,2,14,1207585,15417,63,8340,486
4,2,2,3,9,9262,19008,8,191,487
5,3,2,0,3,13409,0,0,0,609
26,11,15,2,15,126304,3371,36,1144,506
25,14,11,1,23,675744,5714,16,600,619
11,5,6,4,11,5659,5659,8,4878,539
17,8,9,5,13,281283,35796,87,370,457
10,7,3,4,24,90083,38694,83,572,520
37,16,21,12,13,294018,286091,250,1504,422
75,4,71,2,9,26766,8872,14,5840,478
43,12,31,2,6,28966,5099,23,3004,498
20,6,14,6,11,67113,55777,153,17783,423
23,9,14,5,14,681881,39522,61,13333,493
14,2,12,2,3,30873,11341,18,884,418
10,5,5,4,15,47343,16590,23,55480,376
15,9,6,0,4,232576,0,2,0,602
8,6,2,4,5,200987,43541,2,8027,467
17,8,9,1,9,97167,21585,27,0,520
54,9,45,2,9,427889,1392,260,1795,511
6,4,2,2,10,185076,2346,8,1840,553
11,7,4,5,12,41542,26992,76,7983,530
14,4,10,5,14,35600,21854,59,11665,424
9,6,3,7,35,128987,108916,0,0,453
7,4,3,2,9,14912,1398,17,767,389
14,6,8,4,18,52316,49542,89,3930,469
33,7,26,4,16,400216,47305,39,3915,510
21,9,12,5,9,146282,9045,56,756,524
41,11,30,6,15,550092,90854,48,33956,458
18,7,11,6,17,1218714,1894872,80,1126595,376
13,4,9,1,8,10890,6118,32,7071,489
15,7,8,5,17,52928,50695,361,47938,555
11,9,2,0,6,519386,0,0,0,631
11,6,5,0,5,199350,0,4,910,436
20,7,13,6,5,51311,51311,133,0,485
72,9,63,2,19,80599,7995,174,6989,513
27,15,12,2,15,658361,835,38,3530,456
12,6,6,4,11,44036,28861,94,18742,468
29,13,16,16,10,107699,184005,285,22665,438
11,2,9,1,14,37586,37586,95,37586,645
9,5,4,2,19,51476,72737,55,50970,541
17,9,8,3,11,377711,17864,40,10334,605
21,4,17,3,13,343635,91590,144,97104,421
10,3,7,0,8,16124,0,1,1429,590
14,4,10,1,4,14492,789,2,849,478
147,52,95,0,12,114811,0,17,0,577
35,8,27,1,11,416703,213,14,8113,514
8,5,3,5,12,15202,13061,37,5368,433
19,9,10,0,17,435800,0,13,2097,667
19,8,11,4,8,17052,14938,171,12196,508
19,15,4,0,5,1972844,0,0,0,642
7,4,3,1,10,464901,604,0,0,613
13,9,4,3,11,5525,5097,43,0,500
32,13,19,1,15,1084584,521,0,0,633
41,11,30,9,19,1561446,380858,223,11948,434
8,3,5,1,7,37819,37819,15,37819,575
4,2,2,2,7,21646,21646,43,636,675
23,10,13,3,13,369114,71251,1,35,460
13,7,6,7,15,423655,73918,118,2717,471
15,5,10,4,11,13835,12781,40,4244,462
25,7,18,8,16,44582,49958,364,17820,459
12,9,3,8,8,38922,49646,214,10710,442
8,3,5,1,9,604315,32957,7,0,677
5,3,2,3,15,24516,27041,50,12258,458
47,1,46,2,18,11301,7548,20,8960,625
9,5,4,3,11,413984,163327,106,43178,478
5,3,2,0,17,183683,0,0,243,687
35,12,23,8,10,67952,26868,74,9552,479
22,13,9,5,10,498183,4974,26,1730,462
7,2,5,5,6,173905,173905,84,44914,598
18,6,12,4,12,138702,137643,65,0,455
19,7,12,8,10,67078,67078,76,1738614,438
5,2,3,1,5,1938,1938,27,1938,572
8,2,6,1,17,100389,3316,20,18641,515
11,7,4,3,14,96002,34405,27,28670,429
7,3,4,4,11,26168,34193,70,0,475
9,4,5,0,4,60876,0,1,247,654
30,13,17,1,31,602808,2696,4,569,632
16,7,9,2,26,176762,5423,50,4655,520
3,1,2,1,12,8517,8517,25,4598,532
85,12,73,7,19,167498,109276,301,53905,433
20,11,9,10,19,319269,294606,82,9799,484
2,0,2,0,4,0,0,10,2200,601
11,4,7,4,17,255672,33731,60,0,628
27,10,17,8,5,84056,27206,345,10275,506
14,5,9,3,18,225242,21359,81,2048,473
6,2,4,3,5,26152,28201,64,3452,533
18,5,13,1,8,31519,1414,17,1414,574
6,4,2,1,10,109767,11147,14,11147,607
9,5,4,0,5,390194,0,10,0,468
4,1,3,0,2,16373,0,0,0,571
9,4,5,4,16,81252,89840,63,27807,444
6,4,2,2,10,38982,1171,0,0,567
15,5,10,2,8,226345,27911,15,8127,496
14,4,10,1,8,247466,3343,0,0,606
8,2,6,2,4,89596,7899,11,7643,523
6,4,2,5,6,62611,51289,294,14856,579
7,5,2,3,8,115260,15910,48,0,497
3,0,3,0,4,0,0,0,0,601
7,5,2,3,10,338416,27718,92,5089,584
19,3,16,3,14,40379,36763,29,15427,482
9,0,9,0,3,0,0,0,0,617
9,4,5,1,12,17683,9326,17,9326,575
21,14,7,5,17,224231,23051,14,86,470
49,9,40,5,12,107136,16856,159,7035,451
10,1,9,0,13,164927,0,0,0,715
9,5,4,3,15,157664,44402,52,0,498
18,10,8,0,7,65854,0,9,223,531
19,6,13,3,18,72121,164717,69,341,558
6,2,4,1,7,30558,2337,34,2337,509
6,3,3,1,10,20770,17875,0,554,525
7,2,5,1,6,30060,2493,10,2493,510
24,13,11,11,8,58931,42790,161,11872,423
5,3,2,2,6,12355,21209,26,0,532
8,4,4,4,8,11185,22073,43,6531,441
12,4,8,0,9,168880,0,7,684,530
15,7,8,4,6,29470,18496,193,13896,473
13,9,4,0,8,2571,0,5,476,659
11,7,4,1,10,57716,80,7,80,473
26,6,20,6,12,22401,36068,330,5850,517
43,14,29,0,14,301039,0,30,6549,640
14,11,3,1,4,395663,483,1,0,659
23,6,17,2,13,319157,7603,0,0,585
5,2,3,0,18,14337,0,2,1449,578
12,4,8,1,12,227804,1082,13,1082,445
10,6,4,1,14,149787,35443,19,0,639
10,4,6,1,2,10080,4150,1,7499,486
17,5,12,4,11,52785,45904,73,8058,418
18,9,9,12,6,628723,901662,203,177822,420
19,0,19,0,6,0,0,26,1941,632
23,12,11,4,15,1098491,208443,61,102744,439
14,8,6,1,18,933404,11502,13,11502,475
23,10,13,0,15,410394,0,0,0,561
40,12,28,2,13,301640,2485,30,4749,416
9,7,2,1,15,605206,60442,7,4236,681
19,9,10,4,14,334050,26382,1,10307,513
5,2,3,2,69,43018,25246,14,15722,476
7,2,5,3,6,242524,242524,40,0,491
12,7,5,6,16,402877,77041,36,31356,511
26,13,13,8,8,322976,47120,157,3190,439
17,12,5,3,15,144105,14825,12,10435,649
27,10,17,0,8,223846,0,5,564,593
30,8,22,2,11,100813,6396,50,5400,527
26,7,19,6,7,108235,37698,75,9876,484
8,1,7,0,13,0,0,0,0,749
9,4,5,0,20,271062,0,14,0,624
14,4,10,4,13,185003,182935,58,7252,490
8,5,3,2,13,368949,14198,0,0,504
15,12,3,1,6,40661,301,7,1231,488
8,5,3,5,6,649030,212097,0,0,412
6,4,2,3,4,74159,12016,17,10244,532
9,5,4,0,7,209120,0,12,0,620
13,7,6,6,19,556905,183844,115,44501,469
6,3,3,2,20,4245,4003,58,1660,488
5,3,2,3,7,1305,14046,47,161,575
28,8,20,5,15,59543,59543,330,18128,432
10,2,8,1,11,458082,3564,0,3564,670
4,2,2,0,4,9284,0,0,0,575
12,4,8,3,5,3575,29146,44,0,621
29,8,21,7,10,76942,88970,304,18695,428
18,8,10,0,12,753168,0,0,0,574
20,1,19,1,17,12637,12637,95,12637,671
15,5,10,6,6,53086,51856,88,9450,413
65,11,54,2,13,80413,14638,65,11330,609
21,15,6,6,9,573804,45756,67,10788,469
51,5,46,5,20,88329,28290,246,14546,533
84,12,72,7,11,395377,103070,89,15596,459
86,11,75,0,17,1519394,0,0,0,643
8,2,6,2,13,62615,18880,8,13540,430
25,9,16,1,10,131149,10650,91,13450,470
3,1,2,1,6,5666,22784,41,0,530
53,8,45,3,10,132539,9373,324,6664,490
11,8,3,0,13,308466,0,1,0,696
19,2,17,3,9,49022,51075,20,43078,558
25,6,19,4,18,11657,3426,87,4041,477
7,5,2,1,5,25986,528,0,0,476
26,22,4,19,7,123533,92157,295,12314,404
7,3,4,1,13,13680,13580,35,14430,649
21,5,16,3,17,285633,22764,17,14627,572
14,11,3,0,17,792983,0,7,38089,523
4,2,2,0,5,48798,0,0,0,592
14,4,10,1,7,47683,3226,60,3226,617
132,2,130,0,8,1524,0,0,0,635
31,3,28,5,13,235884,13116,0,0,457
9,5,4,2,9,11336,1528,4,4882,464
23,5,18,1,14,381831,2217,40,428,480
6,3,3,3,10,206403,10440,28,0,508
19,12,7,6,17,166497,74912,58,54712,419
15,6,9,5,8,279893,39487,201,1353,500
42,10,32,4,18,160936,46911,106,11601,414
38,4,34,4,15,42696,42696,108,26808,545
5,0,5,0,8,0,0,28,0,510
36,3,33,2,9,5432,2237,38,1038,489
9,4,5,6,6,24519,56529,86,20151,489
10,4,6,4,18,22390,21093,50,14259,468
13,4,9,0,6,14960,0,10,0,612
15,4,11,0,10,193917,0,1,180,670
31,16,15,1,8,158637,506,14,2972,497
13,4,9,1,8,41586,3071,15,521,662
4,1,3,0,5,13709,0,6,0,578
3,0,3,2,5,6691,11286,15,0,573
7,4,3,0,10,36136,0,0,0,647
16,6,10,6,9,39448,55502,30,6347,490
18,5,13,5,10,11616,90249,8,256,678
18,5,13,4,11,7475307,7475307,98,1132,541
5,2,3,0,8,1943,0,2,1092,628
12,6,6,3,12,39787,15844,296,12500,449
5,3,2,0,5,320711,0,0,0,644
9,2,7,1,9,9242,9242,14,9242,628
15,4,11,4,13,252323,3138,145,1749,520
18,15,3,11,16,1183034,878316,112,145658,433
25,6,19,5,13,18407,13488,48,7143,496
34,8,26,7,16,192413,130463,22,13342,466
19,11,8,2,4,223987,11372,44,8256,452
43,9,34,1,16,129325,13580,10,0,609
11,4,7,2,7,38583,26492,53,22321,491
10,5,5,0,7,358232,0,2,0,632
14,5,9,5,7,512756,44052,41,12070,603
30,10,20,0,12,2625330,0,51,8909,535
4,2,2,1,14,30056,12386,21,12386,557
21,2,19,1,10,10571,4797,18,8099,496
6,3,3,1,8,1259,17463,0,0,686
7,4,3,0,17,318725,0,0,0,688
7,3,4,3,11,10104,10104,27,8571,395
14,4,10,5,6,218608,29513,93,12703,601
11,2,9,1,11,12767,11767,21,11767,645
8,5,3,4,12,31427,33484,137,37022,480
24,11,13,3,7,173559,889,64,622,511
7,5,2,5,8,65280,57277,51,23548,455
5,3,2,0,9,117523,0,0,0,679
5,3,2,3,8,8696,8695,113,6499,473
7,2,5,2,10,21453,21453,26,11869,552
6,3,3,2,13,10344,10344,31,7842,609
10,8,2,1,5,157115,959,9,959,526
47,10,37,7,18,643985,401192,251,11209,468
8,4,4,5,2,33028,19538,79,8760,379
9,4,5,1,7,29512,7521,35,7521,488
19,9,10,12,10,202595,219205,167,25142,456
23,8,15,4,8,220191,5866,103,1629,453
10,2,8,2,6,36528,1613,16,2638,591
19,10,9,0,15,9077,0,0,52,648
14,7,7,7,5,47938,48850,364,17712,453
14,5,9,1,9,641330,7623,38,7623,466
13,6,7,0,8,5957,0,0,761,656
37,7,30,5,12,26136,12439,106,6503,466
38,14,24,7,16,493009,81226,289,28481,420
38,9,29,1,9,30425,867,25,853,521
7,3,4,2,14,3428,17126,27,940,563
5,1,4,1,9,0,9991,14,0,655
5,2,3,1,8,18047,25,16,1354,626
15,9,6,6,16,576226,122581,158,28347,539
10,7,3,4,7,31614,30910,81,3577548,412
16,5,11,1,8,11173,10527,343,800,535
11,7,4,0,9,382357,0,1,0,609
86,15,71,4,19,326159,8249,348,4394,494
16,8,8,5,23,527191,261767,118,74376,484
20,12,8,6,14,1094673,55027,113,2260,506
7,4,3,1,13,462242,457,0,0,531
55,10,45,3,12,321146,851,325,6592,523
29,5,24,4,12,40428,27996,19,8820,428
9,0,9,1,6,3865,3865,27,3865,599
36,10,26,4,16,488293,42606,103,7848,471
36,5,31,2,8,12035,3973,381,2586,431
13,8,5,3,4,26512,11443,32,3853,444
15,9,6,10,10,456632,233343,151,25735,485
5,3,2,0,19,73829,0,2,36222,517
24,8,16,0,9,2718498,0,8,8943,682
17,10,7,0,10,162566,0,7,846,646
12,5,7,3,15,157041,66225,83,0,550
14,8,6,7,4,734183,464246,101,326328,457
9,5,4,3,10,255412,19241,47,8909,424
22,5,17,5,9,31205,45384,32,8007,580
18,9,9,0,12,3502545,0,18,0,505
13,7,6,4,8,92437,4915,25,2480,453
9,7,2,4,14,414212,58982,149,9824,498
18,4,14,3,16,566223,165304,112,3759,528
7,4,3,0,28,73289,0,9,3720,646
10,8,2,8,7,46072,46072,86,12712,515
16,10,6,2,14,527668,10224,71,5875,505
13,10,3,8,9,75476,63380,54,19315,414
51,2,49,2,5,7050,2134,29,1325,522
18,7,11,3,21,558366,151555,97,39940,475
5,2,3,1,9,6300,6300,24,6300,493
14,6,8,1,10,21319,4412,26,4412,489
16,9,7,1,2,79097,182,13,1797,502
23,9,14,1,8,228641,4033,21,0,524
18,9,9,7,8,40785,59518,18,8100,477
16,7,9,7,12,26863,53269,199,5217,502
8,4,4,2,7,22734,16772,148,11912,599
11,5,6,2,12,465726,5741,7,3881,625
16,11,5,4,16,266049,26117,119,15024,433
20,14,6,14,17,657203,273470,90,119032,380
4,2,2,0,2,15690,0,0,0,544
12,6,6,6,10,32557,51965,116,20919,467
32,7,25,3,9,77013,19608,66,10626,565
16,7,9,0,13,190674,0,5,4784,629
9,2,7,6,12,35458,67977,66,5685,484
49,2,47,2,12,294728,8835,60,8676,488
40,13,27,5,14,448033,43365,180,28200,504
9,5,4,4,5,12329,10189,338,5788,505
24,14,10,2,8,189811,6726,7,3651,527
10,6,4,4,18,47461,36740,90,1704,532
25,9,16,7,9,23982,27051,132,7726,412
33,12,21,0,17,865540,0,10,865,658
14,6,8,4,12,41751,31835,90,10785,463
18,3,15,3,9,15899,8752,49,4841,417
78,41,37,0,12,5596394,0,37,98,455
15,5,10,1,17,12893,13470,66,0,629
11,3,8,1,6,19777,1619,9,995,539
7,2,5,2,6,5347,5347,29,0,495
26,4,22,0,19,20773,0,0,2954,659
12,7,5,6,18,1571846,56347,0,8832,534
8,5,3,4,4,19105,16734,208,5028,523
18,3,15,0,10,240049,0,1,1265,609
9,6,3,0,10,48840,0,1,69,703
29,6,23,2,7,32990,386,26,2946,517
8,3,5,1,7,3397,1397,10,0,508
7,5,2,2,5,37911,5848,13,0,458
27,12,15,6,7,288479,40620,74,3597,485
13,5,8,0,7,68543,0,0,733,572
11,8,3,0,4,239455,0,2,0,543
10,8,2,0,19,450634,0,2,0,599
23,14,9,9,22,87918,110481,171,6748,356
3,1,2,0,18,0,0,0,522,621
8,3,5,1,8,86928,10031,79,0,638
34,6,28,6,12,164422,85449,86,36583,442
11,6,5,5,6,41253,47498,34,15375,440
26,6,20,2,8,67045,11785,69,4940,414
10,5,5,0,8,30440,0,0,0,512
6,3,3,1,21,15817,15419,110,6588,426
12,5,7,3,15,96137,21988,58,2463,598
15,6,9,2,22,955258,1288,17,6591,568
22,7,15,0,17,218256,0,4,408,528
29,5,24,3,13,9538,8077,0,0,509
3,1,2,0,11,2045,0,18,375,681
18,9,9,0,14,590168,0,15,0,557
47,6,41,3,17,710017,130412,128,42732,458
13,6,7,1,27,57435,1210,23,0,558
7,3,4,2,6,49677,7617,12,5719,581
17,14,3,0,12,274256,0,1,396,589
7,5,2,0,4,50403,0,1,292,618
18,7,11,6,5,391208,75262,109,4034,449
12,9,3,4,11,436032,8263,56,7844,563
21,12,9,4,8,611683,63269,21,2978,466
16,9,7,2,6,404867,4392,31,3990,537
19,11,8,7,9,566310,56644,52,0,439
59,15,44,9,11,585468,138604,214,22175,444
59,10,49,14,12,196349,224366,311,82658,436
22,2,20,1,14,70787,1910,0,0,528
16,13,3,4,16,492488,19366,95,8754,403
13,9,4,0,8,63903,0,2,0,638
3,1,2,0,12,0,0,0,907,664
39,15,24,2,18,1712745,4943,88,4773,480
13,10,3,11,7,107319,96340,155,11518,420
8,3,5,3,8,76763,10277,44,2076,475
5,2,3,1,11,6971,6971,48,7715,486
14,11,3,7,13,76863,74254,210,42116,427
11,5,6,1,9,12155,14138,13,1190,600
6,3,3,2,10,258599,1844,36,1250,482
6,3,3,3,5,16049,9967,54,3936,480
10,7,3,3,8,73033,25329,0,0,487
26,9,17,0,11,837148,0,21,2034,596
27,13,14,13,13,46958,44047,230,8731,451
19,6,13,3,10,334893,21476,52,4923,550
7,5,2,4,5,155558,13634,35,6939,447
16,4,12,4,12,57250,56530,75,4203,511
63,14,49,4,38,190868,66642,48,59752,587
15,10,5,1,15,344245,509,16,3564,592
16,3,13,2,12,77699,5946,21,4671,537
18,6,12,5,9,9417,3777,166,7791,431
15,4,11,3,7,30172,14144,164,4183,486
12,7,5,2,17,45682,30243,46,1559,465
10,7,3,3,12,44129,16807,17,13764,470
12,7,5,6,10,218002,61281,212,13424,470
11,4,7,0,16,28880,0,7,3774,444
15,11,4,2,12,387446,7105,12,0,540
8,3,5,3,9,13871,13871,4,1213,462
8,5,3,1,19,99946,13570,3,15145,573
12,8,4,7,9,115523,123099,119,24755,398
7,5,2,3,10,11102,9513,18,5081,510
3,1,2,0,11,348,0,3,0,630
5,3,2,2,3,107327,3253,11,340,571
13,6,7,6,6,32926,26386,81,12178,415
7,3,4,4,17,185685,78498,11,7461,543
9,3,6,1,18,2994,2994,96,5988,529
27,7,20,5,8,62191,95671,103,38894,411
11,3,8,5,10,25549,41132,100,11424,458
9,6,3,2,15,107972,87669,32,42410,470
13,5,8,5,7,94872,21113,92,0,530
6,3,3,2,7,18190,18190,28,5524,620
6,3,3,1,17,205688,22919,20,0,488
29,4,25,0,7,15518,0,5,3173,634
13,3,10,3,12,41874,36149,48,20610,403
17,15,2,14,6,25241,36836,227,7417,493
23,3,20,0,5,13514,0,4,8468,647
4,2,2,1,18,9442,9442,21,9442,438
7,4,3,2,6,22893,628,9,1665,544
7,5,2,3,14,27756,17635,13,1574,508
43,7,36,3,11,51757,35023,64,11404,458
18,12,6,1,9,157327,15033,34,3350,494
5,3,2,3,4,21991,15006,44,0,424
5,3,2,2,6,30863,13990,45,775,578
8,5,3,4,9,25039,25039,41,18320,535
10,7,3,1,17,22442,4047,11,4047,520
22,5,17,0,4,35255,0,0,0,458
16,9,7,9,6,489300,348435,121,0,502
21,6,15,4,17,16123,16123,138,14266,582
4,0,4,1,13,0,1955,5,0,614
7,3,4,4,11,17838,23587,66,7916,470
46,17,29,16,17,1523929,325578,304,43471,498
5,2,3,2,17,22940,21748,27,0,638
11,6,5,8,8,37738,57658,76,18018,418
22,7,15,5,26,10978,13365,78,4458,492
15,10,5,7,10,50423,42786,164,22607,404
25,5,20,2,11,188334,3248,11,5747,490
8,4,4,5,11,103028,129703,104,407,570
6,4,2,2,11,582076,31527,50,11000,516
14,4,10,0,8,5684,0,53,1008,608
17,6,11,8,12,34657,40476,69,21091,470
30,8,22,6,16,116038,39573,95,7477,468
10,6,4,2,30,499226,11043,2,0,708
6,4,2,3,8,29859,20794,49,0,470
20,12,8,10,8,668920,55233,428,21455,411
46,9,37,5,17,224100,32708,178,12050,447
16,9,7,8,15,378334,365967,108,274212,442
11,5,6,3,14,527815,169168,63,6031,463
9,6,3,6,15,21648,94927,51,3587,492
14,3,11,0,9,714887,0,6,0,630
28,5,23,5,3,19242,8965,57,4871,463
5,2,3,3,8,33125,41295,0,0,504
5,3,2,0,3,5343,0,9,0,625
14,6,8,1,15,463191,3989,100,3989,533
19,5,14,2,15,259159,17347,12,14543,480
10,4,6,1,12,9831,1733,13,0,452
21,7,14,2,8,14816,3979,26,3475,510
44,26,18,0,27,5233803,0,0,0,606
7,5,2,4,12,14634,12117,45,6570,401
11,5,6,2,13,25620,16342,41,11632,426
10,5,5,4,13,13469,17004,64,0,508
14,3,11,1,11,109978,78081,14,78081,492
13,4,9,2,11,14094,636,469,1969,590
7,3,4,3,8,27189,27189,70,7533,558
14,2,12,1,14,11019,6100,16,6100,539
16,10,6,10,15,1052313,1591317,153,695837,395
10,6,4,3,6,256086,7061,378,4189,506
19,6,13,4,13,77430,45055,38,18942,427
28,10,18,0,22,291153,0,19,2847,658
24,14,10,0,14,600188,0,0,0,599
39,6,33,1,5,16259,514,14,223,538
9,4,5,1,12,17192,3120,35,0,548
5,2,3,1,7,14121,8525,12,999,545
6,3,3,4,20,30903,30903,70,6309,643
60,7,53,1,12,25118,775,12,21647,600
23,11,12,0,19,700263,0,28,338,534
23,3,20,4,10,53492,26388,50,2650,457
25,12,13,0,6,263704,0,8,1779,573
7,4,3,2,8,211613,142288,0,0,551
24,8,16,0,11,221722,0,0,0,645
15,4,11,10,8,18588,24406,665,11590,492
27,14,13,0,12,937687,0,22,0,609
12,7,5,7,8,406309,177242,63,0,481
46,11,35,3,18,369375,19426,31,3477,502
19,6,13,4,14,52266,42013,56,14114,554
7,4,3,3,12,261949,31189,63,17809,467
10,7,3,3,10,79551,54889,45,47427,496
8,4,4,1,8,295118,993,6,0,601
5,3,2,1,8,293890,1392,0,0,518
12,10,2,0,17,307805,0,38,0,525
71,11,60,8,14,375458,141166,164,60131,507
26,16,10,1,11,508936,1132,7,1132,560
15,6,9,1,8,37767,285,23,0,539
5,3,2,3,8,3731,8261,60,1149,523
7,5,2,0,2,86007,0,0,0,510
7,3,4,2,4,15298,11708,27,10288,517
8,2,6,0,11,57035,0,19,129,658
44,3,41,3,14,39581,8053,377,914,413
11,6,5,7,8,58742,35624,124,9600,441
23,8,15,7,13,59123,90828,287,9032,488
16,8,8,7,11,35831,35212,148,6422,494
4,2,2,0,11,0,0,0,0,549
8,2,6,2,7,8360,7474,42,1171,632
25,18,7,14,8,99137,76364,251,7193,428
44,5,39,4,9,107723,18681,86,12127,515
37,5,32,4,7,33066,30813,87,4208,621
15,9,6,2,13,50929,7889,53,1350,567
11,3,8,3,8,8240,2987,26,1700,458
17,4,13,2,17,197449,1313,11,1694,558
11,6,5,6,6,28494,44932,356,14950,461
30,8,22,4,15,46771,42739,82,30000,538
17,10,7,6,13,228965,133601,121,25031,524
4,2,2,0,69,0,0,1,8,705
100,7,93,2,10,115964,365,254,1345,517
16,2,14,0,16,2363,0,0,991,664
9,3,6,0,14,15762,0,7,24145,467
10,6,4,2,19,326449,315913,43,305447,365
32,8,24,4,8,52730,10905,70,4983,492
15,5,10,6,8,29089,58094,127,16010,528
28,9,19,3,11,25923,14123,40,5015,451
18,6,12,4,18,38620,38620,352,14828,522
19,10,9,8,13,114748,90675,314,25633,428
10,2,8,1,8,803,803,9,803,539
48,7,41,7,13,71945,83588,186,46542,431
17,8,9,8,19,56874,53227,137,26288,479
8,4,4,1,8,295002,5140,20,1369,573
25,3,22,4,7,14899,16917,83,5954,468
7,5,2,5,7,26681,26681,324,15736,510
12,6,6,2,20,112777,41440,24,19253,453
7,3,4,4,9,292228,15676,19,3389,517
11,9,2,5,9,462368,145481,59,136828,427
22,12,10,4,12,339014,14638,46,3768,478
23,8,15,1,15,2756839,20010,31,1132,536
30,20,10,0,15,3116961,0,22,5039,495
22,12,10,0,16,999187,0,0,0,680
22,8,14,6,7,41089,39054,126,12076,510
14,5,9,3,18,41825,24839,28,11547,487
10,1,9,1,7,3007,3990,26,0,632
14,9,5,2,13,371439,11843,10,11211,443
48,7,41,6,11,46103,23029,168,4786,565
25,5,20,0,13,270222,0,5,15794,555
7,5,2,5,7,12521,8012,35,1621,416
13,8,5,0,11,412851,0,14,1581,511
5,2,3,4,7,14551,39615,54,14551,546
22,7,15,4,13,115980,20954,99,0,455
34,14,20,9,12,303000,94361,170,9968,415
45,20,25,16,13,345944,380617,252,131604,446
6,3,3,4,6,6241,19342,0,0,485
64,8,56,8,12,95798,134440,292,8167,433
9,3,6,0,7,14017,0,22,2142,622
123,7,116,0,14,32736,0,49,2292,535
11,3,8,2,10,291142,5655,13,0,501
6,3,3,1,10,36625,17033,25,900,537
4,2,2,2,4,9981,8319,0,62,402
4,2,2,3,8,17260,17260,61,4790,533
7,3,4,1,5,14165,1633,4,1633,572
36,7,29,3,13,388541,57393,90,2917,492
10,2,8,1,8,14631,669,28,10179,523
60,9,51,0,13,60810,0,8,6459,472
113,30,83,5,11,148853,24222,115,11986,476
20,3,17,2,10,9564,9564,20,3978,436
25,11,14,4,11,365356,92284,25,683,453
43,12,31,4,11,40124,14598,394,12324,484
12,1,11,2,7,190396,158322,60,8569,604
16,9,7,4,35,392218,44812,30,0,565
6,3,3,1,6,7230,41,5,259,513
19,10,9,4,36,248570,172156,101,0,437
7,1,6,1,9,2640,2076,17,2076,614
4,2,2,0,9,321,0,0,0,501
6,2,4,1,9,5901,5901,10,5901,543
20,8,12,7,14,240204,226289,349,34929,447
7,3,4,3,4,45093,10381,89,4410,466
18,7,11,1,10,31503,30507,17,335,535
34,10,24,7,26,29057,21433,116,7081,419
15,9,6,2,6,119530,1897,29,762,458
16,4,12,3,13,3394,18901,32,2883,600
26,8,18,4,11,38713,11500,47,12017,521
4,2,2,1,5,8641,2583,20,2583,618
10,6,4,3,14,29632,28632,70,15557,514
11,7,4,2,11,469510,21304,39,19844,475
10,5,5,0,25,298266,0,3,0,719
14,9,5,3,9,378153,29319,27,5092,442
20,12,8,2,23,830057,2480,36,1240,622
21,5,16,0,7,131915,0,0,0,586
16,4,12,0,11,84603,0,1,4022,498
16,3,13,0,20,198465,0,10,199,653
22,18,4,2,12,159591,2846,4,0,494
19,10,9,1,17,622393,95552,51,8573,494
4,2,2,0,12,34574,0,0,7177,688
16,6,10,0,4,22295,0,21,744,555
50,8,42,0,15,135092,0,6,5487,595
16,6,10,6,8,14177,25588,101,4683,439
46,32,14,0,16,5601329,0,1,497,648
22,7,15,3,11,321600,27035,125,21707,423
6,4,2,0,9,0,0,0,0,793
8,1,7,1,10,14206,4498,31,3309,481
9,6,3,5,12,70967,48290,77,0,451
11,8,3,6,8,398204,42366,29,18043,497
5,2,3,2,10,480,480,26,267,540
28,9,19,3,11,275538,7808,63,4422,481
26,14,12,2,11,175063,30102,47,20484,519
58,8,50,4,21,79788,22512,86,4000,492
9,7,2,0,13,590281,0,9,3903,603
10,6,4,3,11,86122,44184,46,24889,411
8,6,2,2,5,30077,793,24,4125,558
24,11,13,1,22,1248741,156,4,1008,432
17,11,6,4,21,789812,731836,35,4725,593
16,8,8,6,11,353742,31450,40,5995,417
23,10,13,1,8,180266,426,97,1044,532
11,5,6,2,15,1064844,276546,19,0,496
27,6,21,5,14,255259,47971,238,19162,439
23,10,13,7,13,127504,85138,222,0,469
16,11,5,9,6,92417,93496,175,30727,435
7,5,2,3,9,21545,21215,47,18330,505
36,8,28,6,9,265699,12181,22,8311,469
12,8,4,0,24,332481,0,31,2425,488
8,3,5,3,9,13858,9365,0,0,518
4,2,2,1,2,25975,5450,17,5450,434
15,5,10,0,11,227163,0,9,2641,656
8,3,5,3,19,124658,124658,0,0,664
4,2,2,1,7,17043,12250,95,12250,642
15,5,10,2,11,416906,4627,130,9656,445
10,7,3,6,13,144028,87439,84,20029,376
10,6,4,2,6,57694,14161,202,1145,505
11,7,4,6,15,183910,18883,104,14476,437
23,6,17,0,14,244294,0,29,8732,411
9,2,7,3,8,1313,24692,290,22429,602
15,9,6,5,20,281469,29173,51,183,465
14,2,12,1,14,1053,1053,1,4181,575
6,4,2,0,7,216717,0,0,0,655
10,5,5,4,9,13593,13593,59,4363,478
17,4,13,1,11,26900,903,100,2356,536
12,8,4,0,11,920599,0,7,0,640
31,18,13,12,14,854658,499095,109,11421,470
31,9,22,4,12,60900,14372,24,8581,582
24,21,3,0,7,90866,0,26,412,589
7,5,2,3,19,172695,25947,38,3848,619
16,10,6,0,7,382720,0,10,0,510
11,4,7,1,14,959049,14678,9,1706,620
10,5,5,3,6,19224,2190,46,1030,468
11,7,4,4,16,11970,3335,23,3960,463
18,8,10,0,12,146195,0,0,890,633
8,3,5,5,12,518407,162458,59,92394,524
11,7,4,5,6,29202,17789,130,1088,487
27,14,13,1,8,648524,9138,13,3702,464
63,11,52,6,11,194521,103013,104,78000,394
13,7,6,6,5,15077,8001,66,2171,384
19,13,6,0,27,596602,0,29,30,593
12,7,5,4,6,65467,33838,0,0,437
6,1,5,5,12,57735,58585,52,0,532
10,5,5,0,12,89551,0,3,0,596
37,5,32,0,10,615693,0,22,4949,562
20,8,12,3,7,30285,55364,45,5116,460
32,5,27,4,10,84542,27090,0,0,442
12,10,2,6,14,455800,188443,74,19280,450
30,11,19,4,18,436725,25224,83,6169,494
31,13,18,6,16,356342,281367,112,190687,418
28,13,15,4,10,350987,22968,288,8040,490
11,3,8,2,7,41971,40983,26,3710,490
11,6,5,5,5,15555,7420,87,3821,440
9,2,7,1,21,31680,31680,19,0,670
29,6,23,5,6,34750,33810,258,7492,504
15,7,8,3,10,41806,16082,103,889,472
8,5,3,3,14,22622,27804,224,21518,451
8,5,3,5,15,311499,50924,11,5474,433
7,2,5,3,13,20490,39925,46,19435,503
9,4,5,4,6,23262,23262,320,11707,478
14,11,3,2,8,529924,2035,20,0,491
4,2,2,0,4,348,0,16,0,468
23,10,13,10,9,104759,112015,142,23120,419
9,6,3,5,12,27232,26415,72,8147,406
14,4,10,6,4,25088,25087,60,9000,435
19,6,13,5,13,43477,39803,70,21156,451
5,3,2,3,8,3731,8261,58,1149,523
21,9,12,3,12,385721,14743,67,15424,481
16,8,8,4,14,523317,56697,0,0,522
15,7,8,1,7,15844,360,22,1221,531
5,3,2,1,11,196285,54477,12,173958,466
10,3,7,2,12,24922,24922,56,2593,509
16,5,11,0,11,49050,0,40,4885,549
3,0,3,0,8,0,0,15,3154,582
16,7,9,6,25,377715,42852,135,16800,503
8,6,2,2,5,12883,5482,44,4190,486
13,5,8,0,12,42222,0,0,7540,563
14,9,5,2,5,45858,933,39,780,518
9,4,5,2,10,382827,8515,15,0,426
15,6,9,2,14,288418,94079,81,0,519
23,4,19,5,9,67039,69487,73,48344,428
17,7,10,7,7,99940,98680,60,84142,476
16,6,10,1,9,67519,1135,242,2911,620
21,5,16,2,8,26547,25642,154,21099,590
51,12,39,3,11,68680,10947,41,4118,502
11,8,3,6,19,112052,75585,7,6541,534
35,7,28,4,7,27350,8800,71,2552,496
8,4,4,1,6,44249,25998,11,0,527
8,5,3,2,11,38520,9651,44,2472,488
13,10,3,7,25,49624,49624,134,17947,455
27,16,11,0,28,2602004,0,31,5501,613
12,4,8,2,16,373399,7801,0,0,536
22,8,14,4,8,78198,18179,227,5410,362
5,3,2,2,8,5328,5328,30,4980,417
33,18,15,12,19,362193,256448,451,36185,447
22,8,14,0,26,92199,0,0,0,544
56,9,47,8,9,71756,29600,358,8617,487
17,6,11,0,15,44417,0,1,6707,641
16,6,10,5,16,23862,23862,98,9005,490
11,4,7,5,16,15445,15445,173,5234,486
26,10,16,5,26,109138,69394,7,7398,452
4,1,3,1,6,14470,3746,6,0,473
7,0,7,0,7,0,0,15,7200,606
15,8,7,5,6,146317,83068,111,0,434
23,10,13,0,19,1416762,0,44,865,537
16,11,5,1,6,408202,96398,23,96398,670
10,6,4,5,8,18226,18706,57,7699,521
28,10,18,9,19,815520,314280,127,0,415
14,4,10,4,6,53476,35252,45,17509,495
28,13,15,7,7,435739,7356,118,1033,391
6,4,2,3,6,102988,3799,14,1900,471
8,6,2,6,11,302209,302209,12,9886,409
14,10,4,0,4,153149,0,11,512,537
22,9,13,5,10,245138,102368,80,20788,481
5,2,3,0,13,14482,0,12,0,659
8,2,6,2,3,2994,7144,12,994,543
17,10,7,6,10,402241,16828,100,8235,384
26,10,16,2,29,738937,392297,31,30,509
10,6,4,2,8,25580,3515,12,0,478
13,2,11,2,6,20000,11791,21,8292,456
23,9,14,4,13,646874,118286,130,97966,464
9,4,5,2,15,1166110,114042,55,1130,525
13,6,7,4,12,210132,123907,3,8370,492
36,17,19,5,18,408194,22340,74,7207,462
11,4,7,3,15,20163,18327,17,4022,468
7,5,2,0,6,163179,0,0,0,567
9,3,6,6,7,41818,61967,113,14868,533
12,7,5,5,18,113491,37547,50,2082,453
28,16,12,0,29,647722,0,17,583,518
13,5,8,3,6,315027,17782,0,0,567
49,8,41,7,11,75726,50051,186,14037,450
11,7,4,2,9,58028,1956,31,421,521
13,10,3,9,9,72725,47750,104,0,481
20,6,14,2,15,37667,222,115,3825,592
17,9,8,9,16,504378,219583,124,4421,552
12,10,2,6,5,323298,34111,98,13683,411
17,10,7,7,21,638037,250530,49,32439,484
5,3,2,1,6,26177,635,1,635,539
16,6,10,6,15,44459,44459,358,15369,499
6,4,2,0,11,23390,0,4,2241,679
34,19,15,11,17,1006932,81307,148,15261,420
16,8,8,7,14,291817,41218,89,14350,468
5,1,4,0,6,8495,0,0,0,589
20,6,14,5,12,592442,32463,0,0,513
45,11,34,1,13,52139,3039,34,7900,647
39,37,2,34,12,23613,17716,87,29988,405
7,3,4,2,12,35880,42403,28,0,621
51,13,38,6,13,270325,25742,296,4488,449
32,10,22,7,13,254564,87055,3,970,466
3,0,3,0,12,0,0,0,0,595
9,4,5,3,8,393028,3062,49,695,405
11,6,5,4,14,568992,4463,74,4920,481
15,4,11,3,25,45589,36754,88,4440,453
8,5,3,1,11,10814,888,32,0,473
15,2,13,5,10,7684,28341,91,743,553
17,8,9,5,12,299080,58845,107,16787,478
6,3,3,0,6,1739,0,2,0,670
17,9,8,7,11,542509,21441,75,4247,427
8,0,8,1,11,5672,620,0,0,619
45,16,29,10,8,104168,73025,114,62130,468
5,1,4,0,5,3,0,13,2031,521
6,4,2,1,10,30194,3516,45,858,473
11,9,2,8,14,78167,78167,137,27957,445
18,5,13,4,9,12598,7764,49,5037,513
21,7,14,2,10,7028,1110,151,1118,532
24,12,12,0,22,428542,0,9,6739,655
16,3,13,3,20,9674,14723,14,4288,494
13,4,9,0,14,167427,0,0,296,689
162,14,148,0,12,354362,0,11,955,684
5,3,2,3,8,24155,21605,121,14109,495
8,4,4,4,6,252125,46418,257,15613,452
9,6,3,5,19,31546,30668,106,11624,417
5,3,2,2,19,588809,142992,6,56096,550
5,3,2,3,11,4967,4967,21,2177,492
10,1,9,1,9,0,11110,49,1385,535
11,8,3,5,15,553564,40665,70,16761,486
24,10,14,3,20,71930,21078,95,1400,497
12,10,2,9,7,305024,64760,463,14901,451
2,0,2,1,10,7871,7871,0,7871,650
8,5,3,4,4,191223,107758,67,0,518
12,6,6,5,11,585481,67248,87,0,521
6,4,2,4,8,17630,20267,33,6597,522
13,8,5,3,14,212096,2749,62,1311,462
15,12,3,4,22,164210,3010,10,3025,497
24,5,19,0,10,180651,0,0,2151,624
8,6,2,7,14,77153,77153,16,7899,460
13,5,8,1,8,5472,1497,31,8550,432
13,5,8,4,18,6483,18493,74,12228,463
51,10,41,8,8,42368,25309,258,7535,413
11,5,6,1,10,41524,4250,26,4250,535
19,5,14,6,12,32505,36781,39,14876,428
3,1,2,0,4,6043,0,0,0,639
16,12,4,12,11,1062486,44903,131,8520,419
13,10,3,9,7,112532,84044,0,0,503
12,5,7,4,25,114349,57359,17,26167,540
11,5,6,4,12,396444,15424,32,8986,459
28,4,24,9,18,50157,55541,165,17037,466
16,7,9,1,12,781870,4440,42,4321,488
27,15,12,6,16,604744,16435,128,2185,454
6,4,2,4,10,14400,14113,0,0,450
91,13,78,11,38,788944,720807,161,459000,379
25,6,19,1,6,319590,3171,4,0,640
19,10,9,0,11,820821,0,13,4440,431
8,6,2,5,25,8730,5892,96,971,426
22,7,15,3,10,318692,11683,286,9327,447
43,15,28,5,14,59419,16957,68,9112,430
22,6,16,4,9,399025,50417,30,0,439
31,9,22,8,8,437377,49508,254,10716,500
14,9,5,4,6,30167,4385,18,1406,491
16,7,9,3,10,41253,15436,192,12548,516
8,5,3,3,17,10746,21625,49,1422,495
38,11,27,7,26,188653,52537,117,4628,472
9,5,4,6,13,668034,83799,95,4500,482
18,5,13,0,6,160206,0,0,0,685
5,2,3,2,3,16278,489,13,743,551
16,7,9,4,8,39187,26323,29,5792,421
7,3,4,0,6,28013,0,1,0,603
15,9,6,0,12,163447,0,2,0,533
16,6,10,4,20,572601,25448,26,5361,397
18,9,9,9,7,19800,17864,111,8582,378
8,3,5,4,9,117235,20081,86,9580,491
17,10,7,7,11,645264,143991,54,1776,443
42,7,35,4,12,55675,27218,70,11508,596
16,4,12,2,11,276232,8679,118,7379,425
9,3,6,3,14,72717,40919,96,32817,513
6,4,2,4,8,4171,4171,43,3232,521
18,3,15,1,7,31622,14825,43,14825,521
18,13,5,8,13,268921,77902,9,12830,399
7,3,4,2,6,11096,5380,42,14480,486
10,4,6,5,14,23488,18487,39,5593,474
12,5,7,0,6,29347,0,0,0,480
28,11,17,5,12,622328,47679,186,13658,389
8,3,5,0,7,121049,0,1,1010,631
22,7,15,6,4,16307,15716,107,7253,481
22,8,14,6,12,81107,27343,34,7274,447
5,2,3,0,12,33140,0,0,0,632
16,7,9,3,7,109683,3101,136,2500,498
56,30,26,19,32,407398,106576,682,18460,434
42,8,34,5,9,201680,6550,339,3038,439
10,7,3,4,8,19413,5358,76,1023,514
16,10,6,10,15,144346,67269,101,0,460
19,4,15,3,14,17115,17115,40,9638,466
12,1,11,1,18,0,8647,26,3343,457
22,6,16,1,14,15464,1085,64,4580,489
7,5,2,4,20,258459,18476,37,13147,578
49,12,37,7,13,154776,54510,149,6642,491
69,15,54,9,18,125828,117813,186,20364,451
5,3,2,1,11,357631,751,26,751,565
24,8,16,6,17,259651,115166,181,11360,458
16,6,10,3,11,539390,127786,45,119788,439
15,11,4,11,17,451650,62582,142,11128,390
15,7,8,5,14,62005,59082,135,15794,454
8,6,2,1,8,290326,17098,8,0,678
45,3,42,1,15,28403,20848,21,437,551
34,6,28,4,6,21034,21034,123,16406,415
33,8,25,6,13,454992,62353,19,1886,508
23,9,14,4,16,30940,26312,57,6477,527
13,8,5,9,9,142485,187154,121,23881,454
8,3,5,2,5,7342,4293,40,1284,468
3,1,2,0,18,0,0,0,0,769
13,4,9,2,10,6695,5688,78,4203,613
12,6,6,7,6,41468,63322,258,22125,424
15,7,8,8,11,76795,67070,19,3560,439
12,7,5,3,9,78981,11936,76,984,502
7,3,4,2,9,11269,8404,31,644,612
13,5,8,2,8,13477,19713,57,12893,458
8,5,3,0,5,422980,0,4,3217,634
17,5,12,4,10,42562,15064,193,26928,450
10,6,4,5,8,30833,37373,97,11019,451
8,3,5,3,14,569864,38349,86,0,479
9,6,3,1,12,82287,332,25,0,564
108,6,102,5,16,70041,56091,74,1088,499
10,7,3,0,4,271211,0,0,449,607
12,4,8,2,14,46082,13958,11,13266,475
16,6,10,3,5,20869,1578,16,710,440
10,6,4,3,13,165438,133161,83,278,560
13,7,6,0,8,549541,0,45,0,444
37,7,30,6,23,176533,90352,99,3735,450
60,9,51,2,19,373460,6496,66,8553,439
18,7,11,0,6,41174,0,7,1750,660
4,2,2,0,9,13290,0,0,1000,668
16,12,4,13,6,1185756,1295288,208,188122,412
8,2,6,1,5,10595,1992,39,1992,482
9,7,2,4,14,95597,24717,58,10419,432
8,4,4,4,7,19357,18627,76,8522,471
14,10,4,10,6,72108,51832,406,9810,458
18,7,11,1,16,213588,69509,2,0,666
12,7,5,7,7,48105,51689,290,12950,492
15,9,6,0,8,221319,0,11,168,632
12,1,11,1,9,5029,6245,12,1265,641
5,2,3,3,9,17499,28349,42,3724,497
19,9,10,0,16,560017,0,17,331385,623
5,1,4,1,17,6524,6524,0,2177,499
33,7,26,7,10,182491,37918,204,10242,496
16,9,7,8,10,129356,68789,158,0,570
9,2,7,3,15,12908,14892,4,7673,513
36,9,27,3,17,85726,4944,69,4473,606
7,5,2,2,7,25973,12789,111,23378,509
3,1,2,1,5,4651,4651,0,0,626
10,7,3,4,11,219744,19861,70,1850,448
41,6,35,2,11,16242,7143,36,3576,501
7,3,4,3,10,67285,67244,71,3406,541
97,4,93,1,7,43942,15843,198,15843,480
4,1,3,0,6,14704,0,6,1392,643
13,3,10,0,7,12197,0,0,0,608
40,13,27,10,6,159240,27447,70,8980,464
24,12,12,6,20,682204,132838,28,807,468
37,8,29,6,9,632739,195253,1,2932,490
9,7,2,2,10,277271,3427,0,0,604
15,6,9,6,16,71128,52648,36,30341,421
10,5,5,4,9,72622,51053,76,10769,450
15,2,13,0,13,22073,0,25,0,588
20,0,20,2,9,6323,5607,15,3200,562
7,2,5,3,14,64994,32139,38,11059,480
25,10,15,0,9,768794,0,2,0,616
10,5,5,5,8,458549,513551,55,204111,471
12,5,7,2,5,4244,204,12,0,544
8,5,3,3,7,16032,9088,77,7136,505
23,7,16,1,8,62922,297,13,0,565
8,2,6,1,10,74754,10112,24,10112,560
14,12,2,6,9,117747,74410,107,12924,511
7,2,5,3,10,11041,11041,25,3780,446
46,11,35,7,12,108648,124442,83,87919,419
13,4,9,5,11,79930,97971,35,3761,481
32,7,25,2,13,135012,8454,59,7599,592
16,7,9,2,16,306905,15654,72,8111,506
9,5,4,5,15,28923,19460,47,11192,474
18,3,15,1,13,7077,3818,44,3921,463
9,4,5,1,8,2926,1605,10,1605,646
13,7,6,8,18,182741,140347,162,10195,483
8,5,3,0,5,23452,0,8,352,612
6,4,2,3,8,336806,32785,28,1696,459
18,7,11,8,16,438973,362234,200,2682,537
79,4,75,2,16,238523,3789,7,2193,509
7,4,3,2,6,92001,3229,14,0,521
22,5,17,4,13,36529,37357,144,957,574
8,6,2,5,15,42476,42043,93,12600,433
3,1,2,1,18,981,981,5,6435,566
4,2,2,2,6,8344,8344,47,2303,614
9,3,6,5,10,45992,65578,24,22346,503
32,8,24,1,12,144179,20189,98,28131,558
20,5,15,4,9,31198,16837,29,13351,434
4,2,2,3,6,17532,20922,95,9416,456
7,3,4,2,9,30206,16416,22,13416,647
52,13,39,7,9,453037,62881,58,7990,407
19,8,11,3,11,266079,2675,17,2647,528
13,7,6,0,11,333760,0,0,0,697
10,3,7,1,10,17141,241,12,382,541
14,6,8,2,10,375810,2137,14,764,490
18,6,12,6,13,388851,29868,77,8784,551
12,9,3,1,14,959953,214193,12,214193,561
25,9,16,13,13,1438234,573850,237,7331,419
12,6,6,2,13,41031,27317,8,24905,405
89,20,69,0,7,158323,0,6,4353,598
7,5,2,1,14,40344,449,3,623,529
21,15,6,4,15,621732,23375,15,13594,522
6,2,4,5,7,93902,140701,0,0,476
10,6,4,0,12,24238,0,1,542,612
17,5,12,1,16,59284,34,1,3045,603
3,1,2,2,4,15977,6031,15,6193,592
24,11,13,0,9,248855,0,28,0,547
7,4,3,3,7,10992,26496,37,2988,440
31,17,14,3,19,697968,102068,95,0,530
4,1,3,2,10,9354,16795,0,0,629
7,1,6,2,8,30017,30017,17,0,556
17,5,12,3,24,332374,13550,15,1325,498
11,3,8,3,10,9041,27994,26,25326,469
17,8,9,1,13,870540,589,32,4365,486
14,6,8,6,20,239239,247830,124,63299,461
11,5,6,8,7,280000,290429,131,6649660,479
24,11,13,2,8,1020360,5843,0,0,525
23,8,15,1,12,27207,44,11,5685,549
18,6,12,1,4,200140,2237,7,3512,496
19,11,8,11,9,71071,44855,97,10031,434
7,5,2,1,13,53670,6356,24,6356,463
16,8,8,0,13,178817,0,18,850,610
10,5,5,0,7,74452,0,14,0,551
17,8,9,2,13,30976,6408,10,5931,473
22,7,15,2,9,188031,15938,31,6035,500
14,7,7,9,17,1181550,1124121,178,265402,398
17,4,13,2,5,24634,5274,16,4411,479
21,11,10,6,16,37557,38922,114,1652,464
16,12,4,14,7,45833,62372,182,14081,394
16,4,12,3,17,123684,26127,23,6988,508
15,4,11,0,14,361929,0,51,0,470
4,1,3,0,7,10910,0,19,643,641
5,3,2,3,11,28494,28494,226,14937,533
358,17,341,9,13,452368,75087,84,20159,450
15,2,13,0,9,218143,0,30,1478,569
12,4,8,3,10,13915,12966,28,6300,597
66,11,55,0,15,285606,0,0,1800,608
22,7,15,0,16,834798,0,26,0,502
6,4,2,1,6,40845,69,6,1863,650
14,9,5,8,7,25942,21188,766,9108,527
20,6,14,6,9,27253,14828,131,7198,423
12,3,9,1,4,24733,1003,19,1403,514
15,8,7,10,12,175942,99152,165,16099,443
43,9,34,0,16,141514,0,22,1977,662
11,6,5,0,22,23634,0,19,52,673
24,6,18,4,9,1697271,154222,54,14115,435
7,5,2,0,9,4645,0,17,640,577
25,8,17,1,16,309141,13653,31,3335,628
14,9,5,0,7,108790,0,0,150,667
8,2,6,0,7,749,0,17,2219,622
24,3,21,3,9,60225,60040,50,263,470
9,5,4,5,8,78154,75659,18,6397,514
7,3,4,0,9,184733,0,16,0,632
5,3,2,2,10,3488,3488,25,4170,471
11,6,5,3,10,44591,126614,29,0,667
16,8,8,3,10,130999,45785,43,1575,494
12,5,7,0,12,190472,0,6,4560,615
6,3,3,3,17,112113,112113,34,1209,555
25,17,8,4,21,1019677,12638,50,2803,529
23,14,9,3,8,446904,4345,48,876,433
15,6,9,5,17,27699,39499,61,11059,466
19,11,8,8,10,282358,109248,98,21618,382
16,6,10,4,16,223035,34633,59,13950,486
25,17,8,1,18,1344252,224141,3,0,564
16,7,9,1,16,612813,3886,0,0,418
40,5,35,2,10,67057,7684,45,5480,538
13,10,3,7,9,193958,35364,100,15177,488
25,11,14,4,18,642266,26129,67,10714,461
18,5,13,1,13,14531,8665,25,8665,551
9,4,5,0,5,160658,0,0,0,623
8,6,2,5,8,27373,20679,101,3021,488
61,17,44,9,10,329875,73730,155,17224,387
10,4,6,3,7,44015,14902,93,8318,540
10,7,3,0,8,240789,0,0,0,621
13,9,4,6,14,33643,31873,212,16811,446
11,6,5,6,9,37177,45907,54,21967,385
16,9,7,8,6,48950,27434,210,7005,392
28,8,20,5,5,31009,11220,70,2988,439
9,5,4,6,18,270525,101514,228,14761,631
61,19,42,17,17,468794,554936,644,99252,422
13,7,6,4,13,573132,72296,51,14884,446
10,4,6,2,11,359577,52813,16,49229,482
10,8,2,0,8,227348,0,0,0,535
6,2,4,0,12,19136,0,14,4554,552
15,5,10,3,9,215771,8661,67,646,465
16,4,12,3,16,31344,30144,52,10985,515
40,27,13,15,15,423495,111527,284,58948,414
8,1,7,2,6,47126,12376,37,0,552
15,10,5,1,16,814632,5813,16,841,667
10,7,3,4,15,261405,14233,21,43393,474
20,5,15,5,17,40225,32571,29,10672,484
10,7,3,1,9,63815,2277,4,2277,568
10,4,6,2,11,531362,48266,29,26231,481
35,20,15,18,14,1705559,831977,342,147903,426
6,3,3,0,24,0,0,0,18439,599
8,6,2,4,14,86343,86342,88,51094,514
27,12,15,1,12,287338,1195,13,0,543
10,7,3,7,6,53060,38513,53,15797,463
12,3,9,3,11,48462,48462,64,32112,486
26,9,17,3,21,260027,10747,84,6225,665
6,4,2,2,9,19589,17872,31,0,489
11,8,3,6,8,353687,27710,37,11669,511
10,5,5,1,8,23208,1737,37,2943,640
11,8,3,5,11,28536,28246,99,5318,419
39,7,32,5,14,72288,28530,53,4458,389
25,10,15,2,26,945686,842,2,363,595
8,2,6,2,7,7666,6389,28,5113,618
9,3,6,3,13,65783,65783,10,9201,486
14,6,8,0,11,294414,0,287,1892,600
16,9,7,6,69,380539,65780,100,21578,452
11,5,6,5,13,21162,39593,72,5829,449
10,8,2,1,5,153633,658,17,0,521
14,6,8,2,11,279019,14388,4,8305,477
15,8,7,5,21,135990,135176,67,424824,437
40,13,27,6,69,278075,66327,98,24110,432
17,4,13,2,14,73691,5231,26,1738,497
33,4,29,3,9,376337,52926,89,3577,557
26,7,19,6,22,204185,124966,73,63021,452
8,5,3,3,16,104876,10926,60,2812,489
7,4,3,2,18,261553,27508,111,25035,486
20,8,12,4,30,776009,522870,50,226533,583
2,0,2,1,6,0,5423,25,0,521
31,5,26,0,7,175921,0,8,0,640
18,8,10,2,15,699669,5667,64,0,538
10,5,5,4,5,41383,44370,63,6448,468
28,8,20,8,18,340743,76909,132,27150,485
12,4,8,6,5,36817,36817,83,16653,530
20,9,11,0,18,88997,0,28,3560,625
30,17,13,4,19,1182770,23018,39,0,538
28,12,16,9,12,59992,54768,156,866785,461
56,9,47,2,3,137191,47510,20,40094,511
20,7,13,2,11,21707,72333,41,2033,612
11,8,3,5,14,76680,20430,27,7209,447
31,18,13,4,17,1036273,171730,8,57992,562
6,1,5,0,3,42005,0,0,0,628
20,6,14,6,21,403860,72237,97,19303,464
13,3,10,0,16,0,0,2,1441,682
12,4,8,4,14,51429,57097,75,12972,550
33,17,16,0,8,64935,0,2,1337,617
5,3,2,0,6,41702,0,0,0,618
24,14,10,1,15,387031,2252,24,2252,490
8,6,2,5,25,8730,5892,101,971,426
10,7,3,5,16,26265,26265,148,23560,471
6,4,2,0,13,65243,0,13,0,509
121,11,110,3,6,106805,17318,48,6811,493
8,5,3,2,10,184323,4400,10,0,480
23,8,15,5,11,182770,11918,87,5715,480
5,3,2,1,6,1580,1580,43,2395,484
31,11,20,10,19,103158,100102,346,34158,463
27,10,17,4,18,420986,25798,0,0,465
16,8,8,7,14,448177,72171,68,18778,389
9,5,4,0,15,136298,0,3,582695,560
60,7,53,6,7,59530,27405,43,9451,409
6,4,2,4,10,157479,157479,69,75629,616
13,2,11,3,6,13705,13705,84,7147,488
12,6,6,4,25,2112532,40595,68,0,496
12,6,6,3,9,53875,53480,53,6912,466
4,2,2,2,11,3195,5222,54,2611,542
28,7,21,2,9,34633,5961,34,888,463
9,7,2,3,5,20957,1734,23,955,558
12,7,5,7,12,344278,258537,46,85530,474
7,4,3,2,15,383892,76717,20,8549,531
6,3,3,2,8,16299,18944,44,10544,518
35,8,27,7,7,39986,20768,134,6903,444
21,3,18,6,11,35021,39949,155,2945,487
8,5,3,6,9,425278,79032,7,17265,442
15,12,3,6,5,421845,7286,42,1122,465
9,4,5,1,17,49746,988,1,4163,617
10,7,3,2,11,166275,7599,16,327,459
11,6,5,0,6,86602,0,0,0,580
10,6,4,3,7,59563,36084,44,16604,439
17,5,12,4,8,14464,11610,25,4320,545
25,11,14,8,14,131635,127406,173,37805,426
14,5,9,4,7,83360,8485,4,4793,429
16,11,5,0,5,882476,0,16,4342,489
12,4,8,3,9,43850,40240,35,12987,506
140,12,128,0,8,74114,0,0,836,610
11,9,2,6,9,72572,57081,105,26590,438
16,5,11,3,7,441038,20889,128,5876,467
10,5,5,5,9,32092,20733,50,14139,415
3,1,2,1,9,3945,3945,21,0,641
127,6,121,0,8,22544,0,0,0,550
32,13,19,2,18,114608,2350,3,6312,561
14,5,9,1,17,83939,13066,34,1944,515
11,6,5,4,13,29730,13220,27,6650,423
10,7,3,1,18,368470,368,26,811,550
12,9,3,6,8,55806,36546,185,23377,411
20,10,10,2,19,131864,17587,78,479,568
24,6,18,5,13,22160,21747,267,5155,488
8,5,3,4,11,363688,40963,37,0,523
17,2,15,0,12,25688,0,4,0,630
20,11,9,4,13,562701,29241,55,0,494
15,10,5,7,11,276901,238436,161,2470,450
18,7,11,2,5,212312,4620,21,82,513
25,8,17,8,19,287701,77536,30,6011,463
13,10,3,2,7,93388,20720,0,0,502
8,3,5,2,7,15581,14701,6,855,431
9,5,4,2,8,118747,28789,55,0,459
21,11,10,0,16,276965,0,0,0,628
22,10,12,1,7,20520,470,11,2440,672
20,7,13,0,13,32648,0,1,0,694
25,5,20,4,5,16627,14364,0,0,398
16,3,13,1,16,318464,32755,1,32755,693
5,3,2,4,7,11893,17266,151,12380,481
16,7,9,2,13,262630,14838,56,4439,522
25,11,14,1,13,301067,28317,13,40614,498
14,7,7,0,7,8639,0,0,0,646
21,8,13,5,14,79008,16538,69,12610,454
11,6,5,5,17,83264,51589,0,0,516
13,6,7,0,7,42952,0,14,0,595
19,6,13,4,23,180442,68703,42,3964,454
6,1,5,1,5,28735,1256,7,1256,610
10,7,3,4,15,10201,9311,288,3970,509
12,5,7,4,9,177737,12771,78,907,525
9,6,3,0,4,118033,0,0,0,621
28,11,17,3,20,625022,20531,3,1504,456
10,3,7,2,8,72286,13670,20,11955,466
10,5,5,3,14,14468,13220,99,23326,501
9,2,7,1,3,14726,2713,19,751,539
9,3,6,2,5,13930,12948,163,9412,520
20,8,12,6,16,205262,81718,107,0,521
32,20,12,12,7,57391,64304,234,52,439
10,4,6,1,9,232650,9770,48,9770,571
10,5,5,6,9,95654,111885,87,48965,502
5,3,2,1,6,150918,150000,14,0,517
22,8,14,6,5,35699,4465,118,1023,440
30,14,16,9,4,128561,52186,117,10383,452
39,10,29,10,8,49964,49515,159,30067,519
19,13,6,5,10,177776,9930,6,3448,496
23,13,10,0,15,584175,0,5,0,579
21,10,11,2,15,54507,18217,97,15947,455
14,12,2,1,20,393624,2461,0,0,527
9,4,5,4,26,102473,128453,0,0,490
12,4,8,4,7,118842,27919,25,16491,560
10,4,6,3,6,13563,8852,48,2150,599
28,8,20,6,13,237318,29468,127,10379,490
15,8,7,7,6,33916,25983,55,8447,421
17,7,10,2,13,125020,25268,4,13044,518
16,11,5,8,10,210025,33634,67,10207,458
51,11,40,5,14,446117,85962,114,1667,446
12,5,7,0,10,49147,0,25,0,532
6,3,3,3,16,93241,134814,33,92129,476
17,8,9,1,17,9638,1665,34,13311,424
20,10,10,6,11,133546,75750,138,0,492
5,3,2,0,15,722,0,14,0,593
22,7,15,5,17,505049,164873,340,6117,519
15,8,7,3,13,275944,7071,9,1353,418
22,12,10,4,14,57912,5544,63,1291,553
9,7,2,2,7,50319,2527,18,2431,438
10,7,3,5,10,17642,15728,74,1237,417
22,12,10,0,15,1107689,0,13,0,617
23,15,8,8,8,90713,5603,39,4005,454
6,3,3,0,11,5864,0,0,0,562
6,1,5,0,7,0,0,0,0,761
19,9,10,6,7,70927,1496,34,1543,596
23,11,12,0,10,893704,0,6,0,663
21,12,9,0,5,371542,0,0,0,621
4,2,2,1,17,2288,1425,17,1425,597
17,11,6,5,20,863148,280191,176,2400,488
4,1,3,1,11,20013,258,1,0,622
6,3,3,2,7,0,66331,0,0,519
13,3,10,0,10,67793,0,0,3553,650
31,13,18,0,13,835829,0,8,324,623
11,9,2,4,7,62405,6491,0,0,464
11,6,5,3,11,405586,154603,65,12114,579
24,4,20,2,20,0,27875,78,1175,537
13,5,8,2,11,19428,8513,4,6421,514
32,5,27,2,18,776983,40436,51,1148,534
10,3,7,3,21,285271,117684,28,27070,566
10,7,3,0,14,2569107,0,0,0,609
8,3,5,4,9,8800,26284,31,17484,579
27,8,19,6,6,27189,29609,277,12226,413
5,1,4,0,9,2302,0,1,677,594
10,6,4,0,7,145768,0,2,0,542
22,16,6,2,18,9284744,190789,30,175,529
11,4,7,3,6,19640,34393,29,18271,448
26,8,18,1,21,511390,21899,0,740,434
7,3,4,2,13,565525,30383,51,3862,510
39,26,13,2,14,568417,2616,44,3333,449
5,2,3,1,14,7314,7314,96,12314,556
37,8,29,5,8,39580,16604,88,6342,439
28,15,13,0,10,214199,0,57,616,550
12,6,6,6,8,52555,37091,38,11463,521
61,3,58,2,17,443706,57820,47,30757,525
36,4,32,2,13,77389,69449,40,0,462
3,1,2,0,6,20142,0,0,0,693
6,2,4,6,8,98454,139158,0,0,613
26,5,21,6,11,213556,223134,152,67209,495
24,16,8,16,9,102896,103883,400,12245,378
9,6,3,5,20,386667,76981,84,12922,476
31,10,21,2,26,654848,1888,16,6365,474
53,14,39,10,27,919266,66168,148,41500,435
11,9,2,0,3,88945,0,0,600,628
14,6,8,0,11,60239,0,26,12762,422
6,3,3,0,3,17910,0,0,0,602
16,7,9,0,8,47486,0,0,0,610
5,3,2,1,16,279002,37959,23,0,518
26,9,17,3,11,500130,93326,64,87671,464
9,7,2,1,12,27081,2067,0,0,521
6,4,2,0,8,55037,0,3,540,648
4,2,2,2,16,29677,27876,0,0,590
30,2,28,1,13,6101,3335,54,3814,509
13,6,7,0,17,693156,0,20,4314,539
22,4,18,0,11,5522,0,2,5398,512
93,3,90,2,8,4733,4278,27,1250,615
8,5,3,3,9,18533,5120,0,0,466
10,7,3,6,14,34612,51918,280,19279,506
29,18,11,2,9,334112,6254,65,1175,494
5,2,3,0,11,59147,0,0,0,665
50,10,40,5,5,116116,89306,62,48490,445
236,7,229,2,7,45888,6500,19,6011,484
4,1,3,0,3,16346,0,4,0,596
27,10,17,1,17,615859,14530,33,1397,596
22,8,14,8,15,56789,65428,141,16448,430
9,7,2,2,14,34314,26004,17,24709,528
26,8,18,3,16,370903,19776,32,13021,448
10,2,8,2,14,4823,4823,33,3023,441
57,11,46,3,12,160352,7715,18,6627,519
18,12,6,12,6,578545,567299,53,13178,409
4,2,2,1,9,17092,13555,31,0,567
22,9,13,1,17,154064,8113,10,8113,486
40,11,29,5,6,138546,14951,34,31172,574
11,7,4,8,9,75024,81446,21,17863,446
20,4,16,6,10,78283,94492,130,9456,437
21,5,16,3,7,14861,12626,131,6908,532
6,4,2,3,6,19243,13834,95,8860,517
26,9,17,7,21,201698,243034,159,1644,471
39,3,36,0,13,212596,0,19,0,541
9,5,4,1,22,79528,448,0,0,643
14,9,5,5,5,19557,8972,121,2399,521
42,23,19,4,69,59125,13590,97,7755,582
9,7,2,9,7,43940,43310,107,8086,456
23,6,17,2,8,174692,44356,121,33281,520
36,14,22,4,12,136191,7734,80,2608,489
29,8,21,3,3,19328,6476,25,4824,412
12,7,5,3,4,43944,308,6,229,540
3,1,2,2,9,789211,51680,6,39141,551
53,17,36,11,15,666810,171665,200,67000,416
3,1,2,0,14,0,0,0,0,710
6,3,3,3,7,27440,27440,130,10019,522
23,12,11,13,7,23057,23028,78,5340,435
3,1,2,0,11,5937,0,0,0,638
17,12,5,4,8,46106,8741,69,4215,426
34,8,26,8,10,106772,13256,166,13520,424
13,7,6,7,12,29052,29052,28,20024,393
12,3,9,3,16,131742,219076,72,0,493
26,13,13,7,15,1620281,266570,0,0,450
8,3,5,1,9,605408,41963,0,0,535
9,3,6,1,7,0,10262,40,0,551
22,7,15,6,7,47055,36067,103,10151,465
10,5,5,1,27,521432,4291,9,4291,526
6,3,3,1,11,576,6966,0,1192,636
44,10,34,9,9,74149,63069,207,8348,537
20,6,14,6,7,33237,31994,78,15872,414
6,2,4,2,8,14862,14862,120,13105,635
10,5,5,4,8,31697,31155,50,17379,515
9,4,5,4,12,65659,65659,0,0,455
38,9,29,3,15,201879,40460,57,19041,533
29,5,24,3,14,18774,16056,52,11602,487
4,1,3,3,6,8772,14432,35,6332,578
8,6,2,6,10,326034,37704,41,13210,525
11,3,8,2,17,27112,24112,36,20737,528
24,4,20,3,18,168783,166743,43,158744,444
13,4,9,2,9,89291,14178,0,0,466
23,3,20,0,18,10255,0,8,4698,658
8,6,2,5,16,253888,19494,90,4996,445
16,10,6,9,20,578063,677856,202,0,457
5,3,2,1,6,225108,1566,12,0,613
14,5,9,0,9,305900,0,0,2651,672
8,5,3,1,4,9716,362,124,975,471
18,15,3,0,3,570877,0,1,150,583
7,2,5,0,18,0,0,17,2106,643
9,4,5,3,4,25958,4782,41,1449,464
13,7,6,5,6,56997,4256,27,8946,486
9,5,4,3,7,26996,22203,38,12154,586
32,26,6,1,10,888461,1330,5,1330,466
11,6,5,1,9,58273,174,0,0,484
53,8,45,4,5,182684,23339,35,9391,437
24,4,20,2,8,59077,4543,100,3638,486
28,10,18,8,30,188018,204865,132,32437,430
25,2,23,2,10,41580,8099,30,1468,498
3,1,2,0,9,0,0,0,0,739
25,8,17,4,12,347375,21145,0,0,447
22,12,10,11,16,152895,139546,257,27458,454
27,4,23,3,6,32224,29929,217,15870,512
11,9,2,0,8,78446,0,8,0,456
33,13,20,1,20,760917,411,15,411,466
10,5,5,3,6,20628,1985,107,3640,495
33,7,26,8,14,549454,86563,144,16978,476
7,5,2,4,11,93062,4322,5,2628,508
19,6,13,0,14,76412,0,4,351,583
10,2,8,2,9,5089,5089,39,3220,540
5,2,3,0,13,647201,0,11,0,539
9,7,2,0,9,222901,0,0,0,600
20,4,16,3,6,8484,5220,34,3528,508
47,9,38,4,14,340462,12753,76,7493,530
8,4,4,1,11,44677,8025,12,0,561
7,1,6,1,13,1126,1126,24,1126,539
5,2,3,2,6,5906,5906,35,3573,493
15,7,8,4,14,53387,66722,163,27969,451
29,9,20,4,11,18285,11330,206,3140,440
11,6,5,3,9,242969,49505,45,17445,427
23,20,3,0,11,345374,0,3,0,587
10,4,6,1,11,254098,29703,26,1029,510
28,11,17,7,10,70234,54813,105,23663,450
22,10,12,8,9,329165,121149,67,19769,382
24,11,13,2,12,194156,4960,28,11735,612
9,4,5,1,7,3838,171,2,203,630
20,9,11,3,18,300326,118453,88,4681,527
17,5,12,6,11,642176,154603,89,3000,519
14,4,10,5,9,28410,22569,102,8763,415
54,18,36,6,19,604182,24205,36,8901,466
15,9,6,0,15,743309,0,1,0,516
3,1,2,1,28,1010,1010,2,1010,540
33,22,11,16,13,105500,53138,439,7441,414
22,10,12,2,17,109613,1280,36,971,580
11,4,7,3,16,115326,115157,67,443,492
19,8,11,6,8,1238212,288076,63,0,446
20,2,18,2,9,35849,35849,134,24654,476
7,5,2,2,12,245573,22866,33,11654,514
9,3,6,2,9,8926,8926,43,6182,640
4,2,2,0,4,8685,0,42,734,630
17,9,8,9,21,478300,133881,8,16217,512
44,9,35,4,19,394324,229290,99,1513,501
13,7,6,2,15,147070,4180,7,6328,578
23,16,7,7,6,218860,56605,47,23277,447
19,7,12,4,23,1979,8366,102,7737,485
41,6,35,0,11,34036,0,24,2108,566
21,11,10,12,15,487826,285377,48,37414,494
33,5,28,1,11,17906,12875,1,473,504
23,7,16,6,13,17474,14691,128,8364,411
10,7,3,5,12,28924,28058,122,17709,478
15,7,8,1,14,257131,10053,42,22,504
5,3,2,2,11,20281,15018,27,8904,570
17,5,12,3,10,182806,7506,56,5526,605
8,3,5,1,2,14221,12262,6,12262,651
11,6,5,5,10,383047,32287,112,7208,449
29,6,23,2,9,54513,14043,33,13662,484
8,4,4,0,5,0,0,16,0,703
10,4,6,5,9,39679,53729,75,805,460
22,11,11,8,10,433160,31829,24,4996,418
13,4,9,0,11,213496,0,0,518,591
36,7,29,1,13,49328,19020,52,19020,534
20,8,12,5,14,310688,16623,64,7432,524
14,7,7,6,6,71681,23229,22,8352,440
28,5,23,1,14,693322,937,9,7328,472
7,4,3,0,4,131479,0,1,1273,579
14,12,2,1,18,499842,131,4,0,654
6,2,4,2,12,55975,55975,27,0,550
31,9,22,5,12,40421,610,9,2278,531
34,21,13,1,25,1518514,1560,38,12711,555
7,5,2,3,5,18518,17826,131,13054,453
20,10,10,2,11,263321,6169,22,0,577
12,3,9,3,14,17029,19503,19,15392,417
21,10,11,2,8,48506,442,18,888,521
20,9,11,0,19,695385,0,12,0,612
24,5,19,1,3,13980,6843,2,6843,460
4,2,2,0,16,20571,0,0,2067,604
16,10,6,2,18,59598,468,16,16294,587
17,10,7,0,9,465002,0,25,0,533
17,4,13,0,6,425361,0,32,0,640
17,6,11,0,18,447060,0,34,4257,427
24,8,16,6,8,61696,54149,40,30755,415
6,3,3,0,3,174773,0,0,0,642
21,16,5,2,25,2442653,77853,48,48770,573
10,7,3,1,3,51034,1820,1,1820,560
17,10,7,7,69,199018,355480,98,16040,439
9,6,3,1,6,37835,3292,1,3292,485
10,8,2,6,15,322809,112973,124,6230,489
14,4,10,1,18,188436,24676,37,24676,550
56,8,48,7,14,109696,147064,219,33051,437
21,12,9,13,6,190099,93155,137,12779,377
14,5,9,3,7,21242,2766,250,713,481
6,3,3,2,13,12619,12619,205,11259,533
21,12,9,4,15,457018,25795,80,7494,492
14,4,10,3,7,7989,6864,52,4818,468
7,1,6,0,15,4666,0,0,0,645
30,15,15,4,9,191242,340310,34,0,519
38,9,29,2,3,52923,1160,748,1410,492
20,8,12,0,10,337116,0,3,2000,626
7,3,4,2,6,25594,19953,123,19690,585
13,8,5,4,6,37397,6744,29,6251,452
12,10,2,2,6,117775,342,4,312,584
9,6,3,5,16,391529,104447,24,86534,441
5,2,3,1,4,409966,2712,2,8762,519
10,8,2,2,13,202133,5320,26,0,474
11,7,4,7,4,33882,27450,73,10378,436
12,3,9,1,16,205987,3293,17,3293,616
28,10,18,1,13,241033,154865,6,950,615
10,4,6,2,21,50869,1932,57,5646,518
13,9,4,6,8,335135,19522,13,3675,451
30,9,21,0,10,351491,0,7,1005,663
4,1,3,0,4,31691,0,1,3265,623
8,2,6,0,8,294388,0,3,471,654
5,1,4,0,13,2484,0,2,0,710
26,5,21,2,11,46176,33753,35,27208,528
27,5,22,6,8,51944,23593,70,12413,460
8,6,2,6,14,106292,96167,96,7191,493
7,3,4,1,12,342428,4593,99,4593,515
24,7,17,1,14,35715,4447,15,4447,483
13,3,10,2,8,7385,2200,44,1298,518
36,8,28,0,10,423818,0,227,4178,601
22,9,13,5,15,87364,60536,93,2364,570
34,6,28,1,21,451456,895,65,26987,498
12,6,6,1,12,124906,15540,0,0,464
13,8,5,0,11,27153,0,8,600,589
5,2,3,1,5,10803,1676,13,0,512
6,2,4,1,4,16020,3080,13,3330,571
10,3,7,0,9,59121,0,1,0,617
22,14,8,0,13,633406,0,0,0,575
6,3,3,1,9,144131,597,44,597,667
22,8,14,1,6,446062,758,1,2552,574
6,3,3,4,7,19243,23912,30,15787,491
11,3,8,3,6,3393,3393,189,14663,475
27,7,20,3,69,180257,16420,51,5722,389
39,10,29,2,8,203156,9265,46,455,553
4,2,2,1,21,494113,150607,25,150607,576
34,4,30,2,11,32052,14728,31,1631,494
22,2,20,1,13,21366,21366,0,3920,551
57,11,46,4,15,218759,5122,150,55828,473
36,5,31,1,6,12501,4214,1,1053,539
21,8,13,0,13,92496,0,1,0,607
6,4,2,0,4,1804943,0,0,0,656
11,6,5,6,11,478944,122907,82,11386,427
12,6,6,3,23,813165,7697,0,0,465
5,3,2,3,15,488600,27554,0,0,462
17,8,9,4,8,58365,22889,64,6686,439
16,5,11,4,10,65194,40384,73,30353,447
10,6,4,1,8,298534,190,8,0,682
33,9,24,5,9,280591,8041,192,4441,495
3,1,2,0,7,11132,0,9,0,636
16,6,10,1,10,149600,2100,7,0,452
10,7,3,7,6,78965,75401,121,10687,552
15,11,4,8,17,859594,156801,50,50584,390
7,4,3,4,7,51238,34427,188,20805,485
6,2,4,2,9,135973,118585,0,0,478
5,3,2,1,9,4837,2500,40,2500,516
12,8,4,7,10,24810,64195,40,23307,426
12,10,2,1,29,60481,1819,24,1200,558
8,4,4,0,17,142262,0,0,0,669
11,5,6,1,12,438489,94927,34,8502,510
37,7,30,0,7,298154,0,4,1264,597
38,8,30,3,14,261444,260351,63,205040,444
105,6,99,3,16,77471,4942,42,3375,536
6,3,3,0,15,117740,0,0,0,504
11,6,5,4,10,13051,26686,35,3981,451
21,6,15,0,16,17773,0,1,4508,555
11,7,4,2,7,253563,79807,53,0,487
8,4,4,0,8,72798,0,2,427,655
84,9,75,4,15,59937,11773,29,6581,478
246,10,236,5,10,36001,8319,63,5252,494
40,10,30,9,14,134449,207854,252,38695,384
7,4,3,6,15,304488,138907,46,0,487
19,2,17,2,11,18404,17049,80,11297,569
9,2,7,1,8,9324,5835,102,5835,527
23,4,19,1,13,9586,6200,53,11500,414
8,6,2,4,9,38439,4829,33,1878,481
18,9,9,4,9,429410,80326,0,403,439
5,1,4,0,4,74143,0,0,0,664
7,5,2,3,13,4953,7194,34,4412,457
14,6,8,4,15,32454,27525,88,9783,540
13,3,10,2,8,18891,9693,17,7277,555
6,4,2,2,14,28805,21233,34,0,577
26,13,13,18,9,184255,201669,51,26754,475
34,10,24,3,25,175537,142475,74,3613,457
25,8,17,0,7,450111,0,15,1662,671
10,7,3,0,13,119725,0,14,0,586
32,9,23,5,16,116907,58000,102,21306,447
53,12,41,0,13,303217,0,9,5889,664
8,6,2,5,6,398228,48354,80,5312,544
3,1,2,0,12,0,0,10,735,667
51,8,43,9,12,51546,55181,101,10407,481
11,4,7,3,6,7902,7304,0,0,484
40,14,26,4,6,266011,7386,22,573,480
3,1,2,1,11,230,230,5,7470,479
12,8,4,5,11,287210,54640,59,23212,466
5,3,2,2,6,602959,12372,66,0,631
22,13,9,5,16,28748,16667,106,3303,430
5,2,3,1,17,297896,5928,0,0,473
5,3,2,2,5,13520,458,14,344,524
21,12,9,11,14,388149,188437,137,86220,447
7,3,4,1,6,311889,12802,12,0,682
7,4,3,1,3,21714,793,14,793,544
18,5,13,1,10,46396,9405,30,3273,482
18,5,13,0,17,2912,0,9,0,665
2,0,2,0,3,0,0,20,0,583
5,3,2,2,7,3655,3357,14,3193,592
14,7,7,0,15,754972,0,37,100,545
10,8,2,1,6,159477,14466,7,0,484
15,3,12,1,6,19622,352,35,2856,499
22,12,10,3,6,1442710,3732,22,0,480
16,3,13,3,10,61495,60504,15,2674,484
4,2,2,1,10,7637,6637,1,6637,608
7,0,7,2,17,0,87392,49,2136,595
3,1,2,1,8,3747,3747,0,0,536
19,7,12,6,7,48120,46179,137,32199,474
9,2,7,1,6,3486,3486,4,3486,542
7,5,2,4,8,87247,24952,16,0,409
20,7,13,5,8,42199,62539,267,30095,446
162,11,151,9,6,568297,64251,133,3641,463
8,3,5,5,9,16688,31723,0,0,465
11,6,5,0,5,69897,0,20,43483,533
6,3,3,2,5,11226,9741,27,5900,514
15,4,11,1,10,94176,1034,0,1356,666
15,5,10,2,11,5251,7380,23,1468,502
14,7,7,5,9,38869,24534,39,17932,377
10,6,4,3,7,193331,101326,0,0,457
7,4,3,1,30,52858,6537,0,0,694
10,6,4,6,11,107158,30349,86,7312,516
8,6,2,6,26,127945,126390,71,66036,523
3,1,2,0,8,22242,0,1,0,696
8,3,5,0,8,14458,0,0,0,641
25,13,12,5,12,822738,230261,37,0,453
9,3,6,1,8,7419,6972,0,0,609
56,4,52,1,12,11218,9106,23,9106,511
34,14,20,5,11,85887,42267,102,17211,440
10,7,3,5,4,415995,266652,120,0,491
8,5,3,5,14,67939,52894,175,14881,479
25,15,10,4,17,8327464,12664,71,0,469
39,17,22,10,10,543672,42700,195,15771,427
6,4,2,2,14,28178,20476,97,31450,474
9,7,2,8,11,587910,49380,148,6005,529
10,3,7,1,11,242513,3392,0,0,558
16,11,5,6,20,231688,69092,81,8443,414
3,1,2,1,7,1338,1338,17,1338,603
23,2,21,0,16,2010,0,0,1102,728
21,6,15,7,9,109390,109390,203,29562,484
17,7,10,8,14,29948,71979,0,0,462
6,1,5,0,10,1069,0,0,0,628
4,1,3,1,7,4890,4890,41,4890,528
3,1,2,0,2,4283,0,6,0,594
4,2,2,2,2,72341,7764,55,3845,558
25,5,20,4,15,45209,31406,79,26617,493
5,3,2,2,10,347124,10370,57,7351,490
10,7,3,0,2,380651,0,0,0,599
5,2,3,0,7,12525,0,0,0,670
11,4,7,2,7,125146,6833,9,0,501
5,3,2,0,4,20831,0,1,0,497
13,7,6,6,15,89838,87055,106,25056,400
6,2,4,1,12,6660,5891,12,5891,595
9,2,7,0,8,479466,0,10,0,621
12,8,4,7,19,67355,67355,86,25500,493
9,6,3,8,22,41285,31447,0,0,498
8,4,4,1,13,135740,3184,0,3184,632
23,9,14,1,4,38838,3975,23,3975,539
41,10,31,0,9,240233,0,9,0,645
4,2,2,1,8,1066,1008,15,0,548
25,9,16,4,13,375889,21006,57,2043,525
11,8,3,2,8,13623,611,37,1594,520
6,3,3,0,3,226,0,0,0,625
18,6,12,5,16,13086,11212,113,3486,455
20,11,9,10,17,73203,43269,81,12299,443
8,2,6,0,9,26809,0,10,0,608
16,9,7,11,8,424368,405139,247,0,442
17,6,11,6,17,165137,193361,134,94710,521
9,4,5,2,10,819454,5276,18,777,550
12,2,10,2,7,11844,11844,223,10944,493
15,7,8,6,8,310424,45936,128,3375,462
15,2,13,0,8,95832,0,10,0,485
3,1,2,1,7,1579,1579,26,1579,574
47,7,40,4,15,626401,249193,211,97377,427
18,11,7,3,22,263596,27211,73,0,531
61,15,46,10,12,1050136,92626,117,14225,450
22,7,15,3,13,344439,21681,46,3975,481
18,14,4,11,10,421855,43541,111,5892,411
14,7,7,7,9,329134,96351,1,807,442
4,2,2,1,3,12050,113,0,0,506
8,6,2,1,10,102773,83208,0,0,425
29,12,17,6,13,98434,81584,195,13059,488
45,7,38,2,11,29414,8114,34,6110,539
8,6,2,3,4,50175,782,140,2124,539
4,2,2,1,7,2030,1800,30,1800,550
23,15,8,0,6,121057,0,56,818,612
10,8,2,6,6,91918,31636,74,2834,462
6,1,5,0,23,86789,0,0,539,747
20,5,15,2,6,51364,1136,38,698,443
20,5,15,3,5,10066,7222,16,3810,438
13,5,8,4,7,64920,91107,73,53772,496
27,3,24,1,8,30993,6061,30,10727,679
13,5,8,6,24,74202,91502,85,0,547
9,5,4,5,4,244896,7591,61,2251,444
3,0,3,1,5,4137,4137,24,4137,644
11,1,10,0,13,0,0,0,3712,673
19,13,6,0,14,54005,0,9,418,598
32,1,31,2,8,3196,8223,1,3196,494
15,7,8,6,19,301282,37041,139,20091,411
5,3,2,0,30,24565,0,0,0,760
22,2,20,3,11,12094,20231,69,7854,534
16,5,11,3,11,27364,21882,284,19443,526
19,9,10,3,12,74120,30242,45,27161,517
27,15,12,0,7,374729,0,2,803,558
26,7,19,2,5,59481,1172,5,2517,510
19,13,6,0,14,452232,0,2,0,628
34,19,15,0,7,412995,0,17,578,437
6,3,3,3,14,29311,29311,47,18846,506
13,6,7,6,9,29451,51431,64,7429,411
32,6,26,9,12,238667,326977,23,74418,419
45,9,36,4,7,587754,18565,16,5985,478
27,6,21,2,10,21955,3962,62,3510,654
16,8,8,3,8,16882,14752,123,10080,516
10,2,8,0,7,17157,0,2,1790,663
17,14,3,2,14,384514,9553,0,0,577
3,1,2,2,3,12130,11622,79,7116,519
10,7,3,0,12,1472055,0,5,0,607
25,9,16,5,19,344559,22159,68,935,466
15,3,12,2,2,2362,5400,6,4861,410
22,12,10,5,14,728491,160002,128,67323,439
14,6,8,3,33,777070,46444,18,0,599
300,6,294,6,16,58579,58579,406,14251,452
23,6,17,1,6,49930,1659,3,1659,630
6,4,2,1,22,9780,4195,28,0,595
9,5,4,7,9,16216,110971,44,7783,423
12,4,8,2,15,113117,40842,54,17541,521
9,5,4,5,13,11627,11165,95,2480,646
14,7,7,2,27,671530,176632,33,169524,495
20,5,15,2,17,69670,2749,18,2275,514
14,5,9,3,9,30594,23374,35,18077,504
17,7,10,3,7,16263,1702,243,1672,517
16,13,3,10,7,175125,101333,119,688,433
3,1,2,1,8,0,33230,20,0,713
4,1,3,1,5,3899,3899,22,579952,528
18,7,11,6,5,37923,59019,112,22923,511
6,3,3,0,4,10713,0,42,684,567
3,1,2,1,10,15419,2138,0,0,510
8,2,6,1,12,148250,19728,22,19728,608
8,5,3,2,11,465484,19726,30,10245,432
30,7,23,0,15,532265,0,13,5550,581
4,1,3,0,6,0,0,24,0,659
25,10,15,1,11,615060,658,64,580,487
35,4,31,3,10,36261,6962,118,1811,503
19,7,12,3,15,320411,11972,103,3281,446
95,6,89,1,15,299077,11098,25,4363,628
28,14,14,2,14,2165502,104363,36,3047,446
8,6,2,0,16,172892,0,0,0,492
6,3,3,4,5,124180,184904,68,96293,507
7,5,2,2,6,260883,11912,80,7559,454
27,7,20,1,13,52092,24026,42,0,648
30,15,15,11,14,424964,36729,157,7920,414
22,12,10,1,17,1218564,118859,41,18085,609
42,10,32,0,12,62418,0,13,2736,637
22,8,14,7,11,219158,162123,91,1689,412
24,15,9,7,11,93551,34601,73,4156,418
10,2,8,0,16,0,0,23,1929,507
76,4,72,2,9,45559,2511,185,49871,418
20,6,14,5,19,337050,11055,46,5374,435
12,9,3,6,16,480753,29162,34,9958,409
9,1,8,1,4,484,484,9,6264,511
38,16,22,11,15,1528742,164846,198,45540,442
14,5,9,4,11,11544,10918,33,4000,482
22,5,17,5,17,280585,10215,8,1078,498
33,14,19,13,14,644142,228077,48,6723,460
10,3,7,5,4,219429,219429,42,15305,465
25,11,14,13,16,122606,91513,130,18617,435
20,8,12,0,15,316040,0,36,5418,598
20,11,9,0,20,489459,0,40,0,500
28,7,21,5,16,95711,59901,112,25408,466
5,0,5,0,5,0,0,0,0,617
11,8,3,9,7,57111,99533,312,33945,401
12,6,6,1,9,33705,7650,11,7650,541
7,3,4,1,13,16000,67141,15,12000,560
8,6,2,5,13,43309,43309,109,16063,417
7,4,3,2,14,51196,8539,32,6106,395
6,4,2,4,3,12383,12383,37,4680,439
13,4,9,0,18,12590,0,5,320,630
18,7,11,1,13,78274,16142,64,0,453
16,6,10,7,17,294392,217574,70,65314,599
15,4,11,2,8,112316,28383,0,0,499
23,10,13,3,12,1069549,107047,14,20898,424
15,4,11,1,16,295399,94192,27,0,543
27,8,19,2,9,52889,16984,319,20860,427
5,3,2,2,8,9296,9296,18,7096,483
16,4,12,5,6,31556,22178,126,11882,499
5,0,5,3,8,6823,18053,0,0,607
6,2,4,0,10,0,0,4,2147,664
21,7,14,0,18,50137,0,0,15019,684
5,3,2,3,6,82744,82744,72,0,541
9,4,5,0,15,1751,0,4,322,592
5,2,3,3,7,25071,37656,17,19632,456
16,7,9,3,9,60164,15758,289,13764,484
6,4,2,6,5,26900,40687,132,6321,482
41,7,34,8,13,161618,161618,168,6326,388
58,10,48,0,18,448170,0,92,1250,510
22,7,15,2,10,85865,13075,13,8321,451
5,2,3,1,10,11455,2011,24,2011,453
12,4,8,0,19,779715,0,2,4837,518
27,11,16,0,7,23068,0,3,900,566
19,10,9,8,15,452289,71148,33,6551,417
11,6,5,1,5,44933,3866,17,0,557
10,4,6,6,9,139139,214720,61,68674,493
18,8,10,4,29,969992,282315,59,65726,537
20,9,11,6,12,214510,138285,122,21799,538
6,3,3,4,9,9940,20820,157,16634,544
7,4,3,5,10,34767,34767,162,9158,448
14,11,3,10,14,328370,312234,176,40800,433
7,2,5,4,9,9654,10557,192,8253,534
13,3,10,0,14,6060,0,3,1452,606
139,20,119,0,16,4461424,0,114,2473,583
9,3,6,2,10,122305,1365,22,2480,471
8,1,7,0,18,0,0,4,4107,677
8,3,5,4,26,48632,80005,100,1013,611
4,2,2,2,6,17151,26941,0,0,595
23,8,15,7,9,20719,20719,309,6646,416
42,19,23,9,16,310159,89115,138,28535,420
4,1,3,1,8,0,5041,28,0,597
24,10,14,10,26,1651630,362342,143,33686,453
9,4,5,0,12,11682,0,22,5774,475
26,12,14,1,15,1284776,17905,101,3902,459
8,6,2,5,11,77000,77000,2,14816,466
20,15,5,15,23,507579,69088,235,8215,421
11,6,5,2,7,52994,2047,5,1139,535
9,5,4,5,14,239130,451689,113,128387,498
11,4,7,5,9,36411,51736,45,15109,546
18,4,14,4,14,9037,9037,79,4881,546
14,8,6,1,20,82974,20170,31,6256,586
10,5,5,3,5,33186,2994,89,3197,489
33,19,14,0,12,1067021,0,10,3266,489
15,6,9,3,6,37777,21128,190,12400,433
12,3,9,0,21,40291,0,0,0,683
17,5,12,1,14,17209,4799,0,0,459
28,19,9,0,30,1537083,0,3,0,640
35,3,32,3,13,25689,20479,32,10659,478
7,3,4,0,7,23031,0,51,1876,556
15,4,11,0,10,1102,0,14,1607,598
15,5,10,5,10,32303,36948,19,18987,518
27,12,15,0,5,16222,0,24,467,657
35,21,14,4,16,600930,3712,52,5556,557
3,1,2,1,13,0,4690,10,1034,500
36,7,29,1,13,233102,114,67,2259,529
7,5,2,2,7,45369,16234,7,876,521
20,3,17,4,12,15081,26681,61,4533,467
5,2,3,0,17,503863,0,8,21663,570
28,19,9,1,18,341718,2265,23,2265,519
9,4,5,1,13,21303,15761,8,16832,497
13,8,5,3,8,106769,16893,42,6168,566
13,10,3,10,14,30986,26117,93,13201,377
30,3,27,0,9,212698,0,0,743,691
46,6,40,0,34,348865,0,37,2470,561
62,9,53,1,14,20570,1057,19,2685,575
28,9,19,4,9,84587,14030,29,6686,451
21,4,17,9,16,254496,182865,94,3140,485
26,9,17,6,9,47744,69252,58,28135,404
26,10,16,11,16,469721,484318,199,147910,449
24,6,18,6,10,276833,55737,175,3734,468
9,2,7,2,6,10508,10508,108,8677,587
363,10,353,1,19,386661,522,9,386,483
5,0,5,0,9,0,0,3,0,685
18,8,10,5,13,136763,124223,133,3975,487
6,3,3,3,7,17547,17547,216,15194,608
20,8,12,7,13,255181,79038,54,12556,404
22,10,12,6,8,187298,41941,189,25850,492
8,4,4,4,8,57055,79705,129,35603,547
14,5,9,2,27,466300,13967,21,2477,518
8,4,4,4,6,19744,12420,95,527,471
13,6,7,4,6,17579,12893,91,7909,515
42,17,25,7,12,149739,41383,4,3974,492
4,2,2,0,7,14727,0,9,0,652
30,10,20,3,4,54286,14234,51,8190,534
39,12,27,13,10,175020,128996,468,32655,410
46,10,36,6,15,577898,246754,132,97377,427
7,3,4,2,13,21808,3362,2,0,639
16,9,7,5,9,50111,8303,90,3948,524
1107,46,1061,4,13,193698,41397,177,24077,499
35,7,28,0,18,434311,0,0,1802,598
4,2,2,0,4,8771,0,0,0,602
9,5,4,5,4,240152,154614,119,4216,443
36,18,18,5,8,1064545,93245,19,0,444
21,6,15,9,13,62178,97891,133,23688,450
11,8,3,1,3,84344,2025,9,222,573
21,5,16,1,8,24437,3452,127,3452,640
14,3,11,2,7,15178,12765,55,3100,422
25,12,13,1,9,292087,42337,43,0,443
33,4,29,0,11,8610,0,43,2500,461
11,7,4,3,5,341628,98947,70,0,476
16,8,8,0,12,348181,0,2,234,677
39,14,25,9,42,98799,55430,56,11989,425
18,3,15,1,9,29561,29561,25,0,538
21,8,13,2,8,46935,4739,24,1394,514
15,12,3,8,3,117185,28397,111,8268,412
13,7,6,5,14,63984,63984,74,28658,388
11,7,4,3,14,302190,34625,33,17847,442
23,12,11,12,16,263583,236272,287,76097,434
19,8,11,0,14,764251,0,33,0,612
7,4,3,3,7,9345,9345,26,1337,428
8,6,2,7,13,45217,53494,112,14043,537
9,4,5,0,20,70971,0,0,748,687
4,2,2,2,18,41774,41774,48,35524,493
13,8,5,0,8,493133,0,0,0,546
28,9,19,6,19,20464,39946,102,11232,471
35,15,20,2,69,663255,448,11,200,486
7,5,2,5,7,53478,88017,68,30687,438
9,3,6,4,17,479986,69331,0,0,526
17,5,12,4,16,12209,17927,19,10700,417
16,8,8,9,14,76932,56059,116,10416,455
17,11,6,0,8,1063702,0,16,0,597
6,3,3,2,7,28285,28285,103,18344,592
15,8,7,2,9,138576,40954,65,0,585
19,12,7,2,19,250359,58128,63,10888,529
5,3,2,2,11,1033305,9851,59,1046,457
19,3,16,1,8,91333,9601,181,9601,611
6,1,5,4,7,58899,146075,98,58899,527
5,1,4,1,9,512,512,34,250,507
10,6,4,7,4,307852,340081,116,5995,486
11,8,3,3,3,467841,2562,21,1374,438
9,6,3,0,9,281401,0,7,0,533
10,7,3,6,9,28109,27414,0,0,451
40,18,22,0,15,254260,0,3,3768,614
20,10,10,3,2,73399,16194,3,9289,463
7,5,2,5,4,30022,33134,68,0,554
16,11,5,1,9,522854,1685,21,0,651
11,2,9,2,8,6355,45483,34,0,629
14,11,3,7,12,108110,49206,234,13274,482
23,3,20,1,5,75891,8318,21,8318,498
12,6,6,1,14,29639,58,22,0,598
25,11,14,2,7,289978,3175,204,1149,423
7,5,2,3,20,14502,12710,33,4979,478
6,4,2,3,8,333690,20600,57,12673,549
19,2,17,2,15,69803,70547,47,4203,387
35,7,28,1,10,25475,16000,16,16000,545
4,2,2,3,4,73813,54239,41,4827,538
20,17,3,9,14,1587186,333116,24,11887,446
14,10,4,4,13,410638,116453,66,91097,461
4,2,2,3,11,266354,46915,36,0,489
15,3,12,2,9,7542,7542,94,7089,470
15,7,8,0,11,72055,0,18,0,643
6,3,3,1,69,20729,1912,18,1912,648
6,4,2,3,19,82354,21895,7,78458,525
9,3,6,2,9,16494,16494,36,11860,455
10,2,8,1,8,4878,1513,13,1513,522
17,7,10,11,8,1006279,978818,51,230453,450
12,6,6,5,11,329124,19053,60,9490,386
23,6,17,8,9,109440,78888,27,23168,484
23,17,6,0,8,1093682,0,3,0,468
8,5,3,4,7,86794,35859,25,0,492
5,1,4,0,4,0,0,0,264,680
12,10,2,0,5,427942,0,3,0,540
30,11,19,8,27,388272,73501,135,8263,456
8,5,3,1,7,205482,758,3,758,577
8,5,3,3,12,87484,59450,59,52763,424
12,8,4,8,14,177279,177279,580,75515,481
3,1,2,0,8,0,0,0,0,644
13,5,8,0,13,196945,0,20,0,671
9,7,2,6,9,48474,70907,104,37611,659
15,8,7,0,13,252715,0,0,1944,605
14,7,7,3,18,108938,37590,90,4762,578
11,7,4,0,11,221720,0,0,0,704
8,5,3,4,10,29363,29363,23,13477,500
4,2,2,0,3,41894,0,0,0,652
22,11,11,9,14,324786,62170,228,23279,373
15,8,7,1,18,33074,901,26,1307,445
8,5,3,1,4,102557,9271,23,9271,488
15,4,11,0,8,11081,0,16,643,576
9,5,4,0,6,16452,0,0,0,615
28,9,19,0,7,37694,0,81,1835,581
18,15,3,12,15,163798,61578,309,22131,536
11,4,7,0,11,201841,0,10,7446,628
13,10,3,1,16,275949,1657,2,1657,595
25,7,18,0,9,340542,0,0,1323,608
10,5,5,1,5,95618,258,29,1384,515
17,6,11,0,9,81007,0,14,228,617
9,3,6,1,14,189392,155,7,155,596
30,7,23,0,9,39088,0,57,8046,629
6,4,2,1,6,30622,1408,0,0,601
4,2,2,2,7,9692,7200,40,3785,486
8,3,5,4,12,256632,53936,0,0,547
7,1,6,1,9,24533,24533,5,24533,459
20,11,9,8,15,167473,137345,141,43795,463
6,3,3,1,17,27524,1795,2,1795,492
19,10,9,6,7,293044,44424,46,11236,472
5,1,4,0,7,7787,0,6,0,532
11,6,5,8,12,95021,144440,62,61750,454
15,6,9,0,8,252813,0,41,390,485
17,9,8,7,11,58593,28692,46,13323,447
16,4,12,1,21,398740,104303,19,104303,519
5,2,3,0,12,17757,0,0,0,608
7,3,4,0,17,16491,0,24,0,543
11,3,8,1,4,77333,16320,6,16320,600
5,3,2,2,15,26235,26235,43,13738,490
23,8,15,5,17,524433,22749,98,17924,397
9,5,4,2,22,116982,43049,60,131,547
7,3,4,1,21,626734,23880,14,0,651
6,1,5,1,8,2928,2928,0,0,520
560,8,552,5,10,28105,18871,79,4755,390
20,7,13,3,16,22938,6766,74,0,562
14,8,6,4,13,458265,13441,67,5500,468
17,13,4,9,12,309431,28476,141,10064,417
13,10,3,5,7,284028,27791,115,4766,391
31,15,16,12,8,114589,91441,281,37475,384
15,6,9,0,16,573714,0,3,1706,534
11,8,3,0,8,275060,0,0,0,684
7,5,2,5,4,47314,46184,55,19931,490
15,7,8,1,6,33688,2811,12,3170,478
6,4,2,0,13,31900,0,1,0,654
19,14,5,11,12,105739,105199,186,39568,375
22,9,13,0,10,97475,0,27,2000,498
21,7,14,5,11,366669,20050,68,2623,570
7,3,4,2,8,27919,26376,45,853,441
20,5,15,5,6,40116,13787,16,4481,363
22,11,11,10,15,528255,90466,472,21740,502
3,1,2,3,5,96891,96453,38,0,630
17,11,6,6,9,306172,14606,83,8464,447
12,6,6,4,6,19473,13348,0,0,488
10,2,8,1,18,482731,45589,30,0,457
28,5,23,5,14,21966,21966,607,16818,518
33,9,24,7,12,117474,78464,148,33426,442
14,11,3,4,19,938158,5121,36,3859,463
20,9,11,0,19,821974,0,5,7983,612
28,6,22,3,12,37963,11794,40,5383,419
3,1,2,1,5,3780,3780,5,0,475
15,1,14,0,11,1575,0,7,535,623
38,12,26,10,12,383084,159517,124,13694,447
24,18,6,2,24,5431877,74706,22,72990,409
9,4,5,3,17,25349,25349,105,0,517
30,16,14,1,26,364882,143637,20,2268,533
13,7,6,3,26,174155,3231,17,22577,520
9,4,5,2,13,9801,6902,24,5022,600
17,11,6,0,11,97683,0,0,0,626
45,10,35,11,18,374530,128034,390,49195,476
35,12,23,12,10,84124,61598,72,10682,406
13,3,10,0,7,26754,0,0,0,677
5,3,2,1,8,10606,588,28,4635,588
3,1,2,1,9,6460,6460,32,6460,644
22,9,13,0,7,158926,0,1,1380,675
13,10,3,1,12,90145,467,2,467,650
8,5,3,1,8,28548,2895,0,0,456
9,7,2,3,7,95789,59958,50,29524,496
22,16,6,11,12,111035,111035,285,42306,423
32,13,19,10,18,430752,135739,157,16684,393
15,7,8,8,4,37736,28246,68,10888,437
6,4,2,1,13,22556,22556,49,0,489
6,4,2,4,3,229636,19333,44,0,504
6,4,2,1,6,333853,21619,0,0,398
11,6,5,5,8,80712,27532,52,12083,440
11,5,6,0,9,357508,0,1,0,550
8,3,5,2,5,20667,4896,0,0,445
11,6,5,2,18,170027,73851,37,72857,527
9,4,5,1,10,588735,21542,33,15387,624
24,11,13,2,35,116306,71767,0,2140,500
38,11,27,5,19,927819,661394,0,0,492
26,16,10,1,11,865917,1450,31,15430,532
11,5,6,3,8,6089,6088,32,2170,478
13,6,7,11,11,1176644,215720,43,20493,442
25,15,10,0,12,194856,0,33,1449,664
3,1,2,1,4,167010,144713,21,2705,488
12,4,8,3,18,9287,12657,0,0,677
12,4,8,3,7,78766,18598,53,3293,624
23,14,9,16,7,155609,194469,462,88011,471
11,1,10,1,14,0,10161,0,1286,586
9,4,5,3,29,271350,45565,57,1439,551
24,5,19,0,12,127361,0,3,332,553
4,0,4,0,10,0,0,0,0,619
41,25,16,0,12,1661106,0,0,0,584
8,3,5,3,8,28316,28316,64,24634,521
20,5,15,2,4,57931,3821,17,0,527
10,4,6,2,13,3273,864,6,875,514
3,1,2,1,7,8989,6457,4,3226,565
42,15,27,5,15,116488,32439,64,7302,405
40,11,29,3,15,1166896,28577,79,7491,573
22,7,15,0,11,211749,0,24,0,583
57,11,46,5,18,332620,51441,214,400,515
5,2,3,1,7,291777,636,8,636,625
12,7,5,5,14,112539,117208,64,33488,481
41,8,33,2,15,378363,12307,59,2988,526
12,8,4,5,7,371288,85214,89,16470,450
11,8,3,1,12,429428,10414,36,3720,528
18,10,8,1,5,799338,4956,8,3439,570
24,14,10,1,8,1039172,230,13,230,511
29,5,24,0,13,9300,0,35,1780,724
29,13,16,5,13,305455,28103,135,15174,502
25,8,17,2,11,278695,26282,40,0,553
8,2,6,2,14,277968,28384,27,0,520
15,11,4,1,8,276827,3389,12,720,505
6,4,2,2,17,7458,2533,38,3255,545
13,7,6,3,10,710472,5956,52,16455,494
4,2,2,2,8,177554,15316,46,0,487
5,3,2,2,9,9292,7437,34,456,633
7,3,4,2,7,608486,34782,0,0,517
9,5,4,4,12,51131,54083,0,0,480
5,2,3,3,8,13233,19598,0,0,415
22,9,13,4,8,41472,35381,129,22240,439
15,6,9,7,7,21287,35001,164,3405,428
26,12,14,12,14,82172,69196,139,9298,451
27,6,21,3,6,96077,530,3,5000,493
12,6,6,0,10,6101,0,13,2350,619
16,10,6,7,8,556374,25913,108,8138,411
13,5,8,3,6,34775,2307,22,9233,491
74,9,65,9,10,79240,86982,301,18936,424
4,1,3,1,10,64400,58856,24,0,476
7,2,5,0,69,4973,0,2,4577,591
10,3,7,1,12,21326,15863,12,15863,585
8,4,4,5,7,18484,25983,88,7499,460
8,6,2,0,4,142015,0,0,0,661
19,6,13,4,7,38634,24598,73,9053,455
5,3,2,3,5,6165,6165,27,4014,470
9,6,3,4,9,401325,44399,39,13213,462
10,4,6,2,14,91729,91231,34,834,530
5,2,3,0,7,48608,0,0,0,681
3,1,2,0,17,11495,0,0,0,660
3,1,2,2,5,12427,12427,0,0,507
32,4,28,3,14,13071,9071,43,5520,489
20,8,12,4,17,230667,128949,105,7326,551
25,4,21,2,6,49086,3898,41,3538,566
9,5,4,1,11,210,210,10,2146,455
10,6,4,2,8,315629,19442,30,18862,484
13,8,5,9,9,335933,48333,214,0,549
16,5,11,11,8,29975,35124,680,11590,469
18,11,7,0,21,287093,0,3,0,540
6,0,6,1,9,0,7227,31,0,601
12,4,8,3,6,37163,37297,1,1156,453
19,7,12,8,12,51793,36352,0,0,443
7,2,5,2,15,5043,5043,28,4411,501
13,7,6,1,3,359012,8887,17,139,489
24,9,15,5,11,372735,29353,98,11110,439
20,5,15,1,16,585076,49108,31,4226,535
11,8,3,5,15,607712,43551,87,18912,407
16,5,11,1,20,145651,1398,6,0,572
25,2,23,4,28,22951,37910,44,0,513
33,13,20,5,12,167598,30585,129,14417,495
19,16,3,6,13,492332,38159,0,0,412
6,4,2,3,6,260923,260153,25,8415,405
5,0,5,1,9,0,9115,8,9115,613
15,7,8,0,13,158897,0,8,0,618
35,19,16,1,21,1547393,1364,12,0,492
11,7,4,2,5,277379,8739,11,512,465
35,12,23,2,9,68519,1274,8,1289,407
6,3,3,3,13,20014,19201,55,1306,497
14,5,9,4,9,64230,65810,96,7120,447
7,5,2,5,5,18734,25542,13,7908,504
11,3,8,0,12,1082201,0,80,0,522
27,6,21,4,9,111267,34811,20,5576,548
7,4,3,2,10,87806,43833,27,0,516
121,8,113,3,9,36242,16195,13,5967,477
24,5,19,3,11,30430,496,78,5058,528
31,9,22,1,10,1103211,1667,31,0,527
22,7,15,7,9,36506,44945,83,13599,446
20,7,13,4,15,686758,43473,111,5790,479
7,2,5,0,13,6819,0,10,0,584
4,2,2,3,13,36583,41777,0,0,493
8,1,7,1,10,5314,2947,0,1545,525
18,7,11,5,22,16099,16099,355,12167,419
13,9,4,3,12,330125,1659,17,1080,528
6,2,4,0,6,11268,0,2,0,665
16,7,9,1,10,13967,9545,73,4007,433
10,3,7,2,4,57878,55711,33,53542,463
14,6,8,5,8,40372,29022,327,17600,475
3,1,2,2,12,42734,18765,24,1549,587
28,11,17,4,12,216767,10792,13,2896,535
21,8,13,2,15,312353,2504,25,0,495
20,7,13,1,19,63002,412,50,412,531
13,5,8,4,10,369239,66103,65,31896,450
17,5,12,3,9,39714,4167,70,2392,497
8,5,3,3,12,30240,6739,250,5067,534
14,6,8,0,8,8731,0,12,0,589
10,8,2,0,20,105037,0,0,0,462
42,9,33,3,16,75401,34782,38,6033,446
7,3,4,0,6,8900,0,0,0,658
17,6,11,1,19,1254904,97,7,0,620
14,5,9,0,5,20892,0,68,1114,478
22,10,12,5,14,446794,70659,29,5054,441
4,1,3,0,9,0,0,0,0,717
7,4,3,5,13,14740,27913,55,13173,570
20,4,16,3,12,10504,20540,113,10036,640
8,5,3,2,6,14950,8394,12,1290,539
65,20,45,12,18,197273,104197,183,13087,443
5,0,5,0,9,0,0,1,0,685
12,2,10,2,9,35498,6216,5,1790,640
8,5,3,3,13,330801,16132,2,3836,525
6,3,3,3,6,43393,42839,0,0,489
7,3,4,5,8,19301,36858,77,13610,438
9,3,6,3,13,14779,12201,48,6831,465
12,2,10,1,17,5850,5850,27,1330,539
9,5,4,0,2,25258,0,2,242,509
15,9,6,2,21,501323,20256,21,17588,578
10,6,4,3,69,355152,65849,51,32881,651
9,5,4,3,11,17788,7631,53,5984,447
9,1,8,0,14,0,0,6,25725,611
14,9,5,3,27,250984,49371,47,0,472
22,7,15,2,20,64095,10886,29,4405,457
69,6,63,5,9,28492,27138,89,10276,455
6,4,2,0,9,399758,0,16,0,569
18,9,9,8,15,82404,57458,140,13880,423
24,9,15,5,12,239340,63182,113,32428,469
14,2,12,2,5,22836,22836,49,0,520
13,2,11,0,8,2910,0,5,774,714
12,3,9,0,3,14937,0,11,1414,475
19,9,10,7,17,694657,13769,35,1735,464
25,13,12,0,19,1404307,0,7,0,610
22,4,18,2,15,11970,10062,31,2273,633
4,0,4,1,11,7700,7700,8,0,530
6,4,2,4,5,17751,9831,2,3502,476
26,12,14,8,14,482944,96736,207,6246,398
8,4,4,1,17,52032,8841,91,16894,488
23,12,11,8,13,243705,74809,128,17329,445
53,12,41,2,16,69986,1699,205,13353,455
13,4,9,3,10,421093,18612,354,15552,510
13,6,7,6,7,7656,7068,319,4226,533
18,4,14,4,11,46993,5798,63,0,500
24,8,16,3,13,127872,10506,107,8565,443
21,10,11,1,13,138058,3442,42,3110,482
10,8,2,9,12,35941,35941,98,8316,526
27,6,21,5,9,18707,18707,250,13674,446
16,4,12,3,11,66740,18394,98,10492,506
24,6,18,0,8,386673,0,45,3331,525
12,5,7,5,14,38462,38462,110,12199,449
330,22,308,2,19,407785,106074,97,51104,501
9,7,2,0,6,304392,0,0,0,653
13,6,7,0,12,278817,0,4,1537,612
13,8,5,3,11,167123,26572,55,12062,454
14,6,8,2,11,511422,1317,12,0,532
15,8,7,5,11,29082,24768,88,6320,444
10,3,7,2,5,15378,15069,53,0,506
10,3,7,3,18,256981,256981,68,27813,503
10,8,2,0,9,106697,0,17,933,622
13,3,10,4,11,27349,38717,27,9576,537
6,1,5,1,14,65356,65356,6,65356,579
145,11,134,6,7,30137,65669,87,8629,460
8,5,3,1,6,407516,9991,9,0,622
7,2,5,2,15,3842,8141,27,16975,521
32,11,21,9,15,74147,51420,12,4386,447
25,4,21,2,13,24213,4789,204,3099,494
8,4,4,5,15,4642,12496,76,1141,542
4,2,2,0,6,71897,0,0,0,602
18,5,13,4,9,20516,19515,160,14744,482
9,0,9,6,8,138562,189878,49,0,582
5,0,5,3,12,53723,39273,48,3436,622
9,5,4,3,3,52690,48476,66,0,448
10,6,4,3,27,218288,129222,0,0,531
16,8,8,6,10,115828,88232,65,4220,538
15,9,6,1,12,786408,69,0,1092,589
17,7,10,0,4,63608,0,2,0,440
11,9,2,8,7,29407,25921,28,4980,429
16,3,13,2,12,14028,14028,105,6174,505
64,5,59,1,8,33788,8648,204,2329,463
13,8,5,6,3,55020,18542,66,8917,486
19,5,14,3,7,54434,4848,83,3859,534
26,11,15,0,12,774314,0,11,2739,498
19,5,14,5,6,200548,29303,111,0,566
22,7,15,2,13,299077,14479,43,4068,553
9,4,5,5,8,31275,32234,77,10360,503
34,20,14,4,9,1073488,229808,45,211575,443
26,10,16,4,13,133312,92894,49,9841,446
27,6,21,7,10,44454,79828,292,21641,504
50,13,37,2,12,648907,7939,26,7874,545
16,6,10,1,10,19027,1230,28,2105,469
25,10,15,1,12,419459,408,0,0,550
14,9,5,2,13,390065,1393,67,0,466
22,12,10,9,12,1417502,580783,207,8112,446
11,2,9,0,7,90839,0,9,0,650
26,18,8,5,7,240012,33960,227,9951,464
33,7,26,0,8,106061,0,354,7767,512
10,7,3,5,8,238569,67361,73,0,488
34,17,17,13,15,576031,203035,265,68182,422
7,4,3,5,14,136371,157225,102,59841,535
10,3,7,4,8,32052,57132,184,4828,522
30,7,23,5,15,45957,38182,200,20622,603
7,4,3,3,13,429897,10343,63,7262,528
27,9,18,6,15,112535,106131,101,83676,463
16,6,10,2,8,113220,7282,32,480,523
20,6,14,6,18,2981133,1174283,87,0,537
28,10,18,5,10,532367,52584,190,5596,455
15,9,6,0,8,209837,0,1,0,672
7,5,2,3,10,22360,16068,32,6712,440
28,8,20,2,12,263796,11604,38,16264,402
17,9,8,5,11,483717,157411,0,0,523
14,6,8,6,8,50500,48070,359,12257,445
12,6,6,3,19,14097,40473,52,0,479
11,3,8,3,27,23840,23840,0,0,610
29,10,19,5,9,227528,226401,137,83589,494
8,5,3,5,15,309845,127569,0,0,540
9,4,5,4,8,13407,9191,27,4650,527
31,12,19,6,14,907078,60218,8,1821,474
6,3,3,3,10,15809,11346,24,4801,478
19,15,4,1,19,152204,40709,45,22348,529
9,1,8,0,6,0,0,25,2012,452
12,5,7,4,5,14406,7292,332,5359,429
14,8,6,2,14,138673,6195,19,3255,558
5,3,2,2,4,4255,2825,17,1371,511
68,15,53,2,20,2826695,517369,62,4960,515
24,9,15,0,18,226735,0,90,4354,535
47,13,34,0,7,111734,0,16,7434,562
6,3,3,0,11,0,0,4,0,675
5,0,5,2,4,0,11140,0,0,529
19,10,9,0,16,331024,0,4,2341,570
23,16,7,7,11,258101,57793,380,12570,452
14,8,6,0,9,263444,0,0,0,651
18,5,13,3,12,54476,51512,57,23488,480
17,4,13,2,5,155550,13275,24,0,476
22,7,15,0,9,1030045,0,13,211,581
13,7,6,3,5,58823,13931,50,9692,421
11,5,6,0,13,143689,0,12,3384,496
9,4,5,4,18,430932,28755,38,11309,598
21,10,11,2,13,544771,71615,38,65848,567
10,3,7,3,14,80249,89727,77,59121,468
30,5,25,2,14,34190,12860,94,13000,481
11,6,5,0,18,96846,0,10,0,634
54,22,32,4,27,1551482,932262,81,815,505
13,3,10,4,9,203617,162151,98,95886,451
11,2,9,3,9,18865,28766,49,12568,527
8,6,2,4,3,86702,3381,5,559,468
43,11,32,12,12,540379,164444,134,25686,455
65,13,52,6,14,113482,45493,30,13767,430
8,5,3,1,8,24298,812,24,1595,576
31,7,24,8,19,77801,73525,67,11244,437
9,7,2,8,4,46121,44867,130,0,549
13,1,12,3,20,523485,24245,130,0,531
20,11,9,0,15,404268,0,3,0,600
7,3,4,0,3,26222,0,0,0,666
39,5,34,3,16,14548,14548,43,12371,524
27,7,20,0,12,150899,0,26,0,611
4,2,2,1,5,7958,6216,24,6216,664
7,5,2,0,9,24067,0,0,0,586
9,7,2,0,11,88554,0,0,257,591
17,10,7,0,17,426828,0,3,953,629
4,1,3,0,8,0,0,11,215,594
5,3,2,4,12,24971,29020,1,1399,451
10,3,7,1,8,572,2997,110,6650,486
15,9,6,9,9,167265,147127,200,23254,446
7,5,2,1,13,45108,4231,7,0,693
9,7,2,5,20,108383,145900,106,65635,538
2,0,2,0,7,0,0,30,0,630
3,1,2,1,7,8457,8457,24,12083,569
4,2,2,1,9,8732,6323,25,0,553
15,10,5,9,15,490275,360078,114,15465,517
15,9,6,2,14,522590,4869,19,291,459
10,5,5,0,7,39955,0,1,0,621
14,1,13,0,14,0,0,0,3457,635
12,5,7,3,8,7364,4754,38,3250,506
67,23,44,22,16,564736,421272,189,30849,453
38,9,29,10,11,262822,157005,240,43743,439
18,7,11,8,18,352879,81832,108,1973000,397
28,7,21,5,7,70904,11333,33,3690,364
7,2,5,1,8,50064,24778,30,1321,538
14,7,7,6,23,332588,157985,198,87744,481
22,9,13,0,20,1511507,0,29,780,673
25,12,13,4,7,25708,5795,104,410,509
17,12,5,3,18,288456,67243,0,0,542
56,5,51,0,6,26720,0,19,420,550
7,3,4,1,22,110508,5590,34,0,511
7,5,2,1,6,267676,795,9,2999,584
12,8,4,0,4,189265,0,1,1964,668
17,6,11,5,8,90108,20197,225,4390,462
11,1,10,1,10,41663,716,23,0,539
8,6,2,2,8,253490,23755,130,13796,481
10,7,3,1,12,99553,15295,24,15295,625
17,1,16,1,9,2422,2422,21,2422,556
38,11,27,6,9,107771,92861,138,2881,450
3,1,2,1,8,3915,478,2,0,531
5,2,3,0,10,0,0,3,0,668
5,1,4,1,12,3084,3084,20,3084,462
9,5,4,2,11,36775,9753,0,107,560
14,6,8,3,20,494314,57527,14,0,570
13,6,7,6,7,54541,27273,8,3772,440
7,3,4,1,7,11694,513,5,513,482
15,6,9,6,10,898771,262874,0,0,512
33,16,17,1,7,449186,1163,21,5261,546
44,17,27,9,8,505058,95737,118,16389,383
8,4,4,1,9,213642,698,42,698,620
13,6,7,3,8,314327,6906,47,1706,429
10,8,2,6,16,42977,42507,116,5886,393
28,7,21,0,7,22914,0,72,0,517
8,4,4,4,8,14955,17923,123,1700,470
19,12,7,5,7,418837,24288,63,11886,473
13,7,6,0,4,101405,0,3,0,655
10,8,2,1,16,209994,339,37,0,468
18,9,9,8,15,47023,46185,289,10790,451
33,14,19,10,29,640896,304511,115,27074,421
16,7,9,5,23,305254,219410,61,11133,447
11,5,6,0,11,93845,0,0,0,677
18,9,9,5,11,201029,120603,146,2480,439
8,1,7,2,19,8276,7016,26,1008,494
10,7,3,6,9,38444,37831,175,15825,450
16,8,8,3,10,37946,14976,47,7088,525
5,2,3,0,17,495,0,0,2430,636
11,8,3,8,7,88580,109577,139,6513,415
25,6,19,3,19,16327,4816,28,2898,536
28,11,17,5,11,331799,72692,105,55787,419
6,3,3,0,7,203687,0,1,0,625
80,17,63,6,16,54389,18250,248,11730,426
7,4,3,4,6,11959,11959,62,3042,438
4,2,2,2,12,11042,11042,61,0,587
8,5,3,3,7,17285,14385,0,0,437
11,7,4,6,6,47344,36744,40,24552,405
34,11,23,4,11,93958,6952,252,3934,451
16,7,9,1,14,851053,3768,18,11132,527
11,5,6,0,5,48222,0,0,0,571
22,8,14,7,9,46476,44841,130,27727,374
19,7,12,3,19,449299,27086,270,25011,469
7,3,4,3,6,52528,48348,50,0,493
18,7,11,6,11,25577,24242,29,4830,423
30,8,22,4,4,86681,1204,20,929,505
27,8,19,10,12,331870,116835,139,32723,443
25,12,13,5,24,385968,32771,77,4660,463
15,7,8,5,7,24636,21176,96,10235,455
22,5,17,4,11,292510,8824,50,3245,412
13,3,10,1,10,89345,9462,24,9462,495
19,14,5,5,14,348084,72065,57,29936,440
10,4,6,2,8,28054,28054,32,4685,462
7,5,2,6,7,37604,45406,127,0,532
13,3,10,0,10,14688,0,17,370,470
26,14,12,5,11,389502,173739,103,20359,516
28,12,16,0,29,1664157,0,8,0,658
10,6,4,0,3,129108,0,6,740,595
19,3,16,2,11,25284,9219,8,8269,551
6,3,3,4,11,34177,40173,0,0,473
9,6,3,6,7,101948,56671,85,8009,468
22,14,8,2,19,233573,3676,8,348,587
8,5,3,1,9,170101,101753,7,101753,582
4,2,2,2,7,4561,4561,38,4015,491
47,6,41,1,10,153459,60265,46,60265,595
12,4,8,1,15,305934,13275,7,13275,557
116,10,106,2,11,60460,3314,56,6849,575
11,7,4,5,15,29066,18336,47,7720,424
22,8,14,6,10,401200,30928,92,0,454
7,4,3,1,20,32312941,32275826,0,0,578
32,8,24,3,6,23811,10112,18,1839,491
7,2,5,2,5,6120,4293,22,2650,550
10,5,5,7,12,17426,21568,0,0,486
27,7,20,3,11,75693,7786,19,1827,460
15,4,11,3,7,47203,24519,41,13011,459
42,6,36,0,8,29629,0,2,0,636
21,9,12,4,14,265512,87896,55,25240,551
16,8,8,4,11,316733,19897,27,10837,417
17,6,11,5,19,129124,57444,75,0,484
31,14,17,10,69,373806,70956,201,7701,465
14,7,7,1,9,250403,106162,17,1510,471
32,18,14,1,20,1925551,26904,24,0,523
16,6,10,2,5,813389,11099,53,0,491
10,4,6,0,16,1139742,0,3,0,551
13,4,9,3,8,20639,10053,56,1693,477
11,6,5,1,12,48159,19720,39,19720,577
52,5,47,3,8,43652,56611,76,5380,517
6,2,4,1,17,9994,9994,0,136,573
9,6,3,4,4,123158,23224,58,1588,464
24,3,21,1,14,2835,584,21,17060,438
10,7,3,4,7,27752,27894,70,0,449
13,2,11,2,15,21330,8410,0,0,518
25,10,15,9,11,22965,14803,140,3753,469
10,5,5,0,11,159811,0,0,0,521
13,9,4,0,25,87361,0,16,0,561
35,9,26,7,19,602778,86519,312,25348,498
18,10,8,1,13,3702481,3414,15,0,475
10,5,5,4,9,34407,48769,103,31348,443
19,13,6,0,9,343002,0,4,0,620
11,5,6,5,18,45646,37848,1,1699,484
18,9,9,0,3,11813,0,2,241,605
19,2,17,2,11,7181,13071,29,19890,578
10,7,3,4,8,111549,70201,55,0,446
40,11,29,12,11,60264,45920,92,7900,452
9,7,2,6,6,25464,9204,46,5484,432
14,9,5,3,20,310969,28863,0,0,623
34,4,30,2,20,34190,18218,70,13899,543
30,9,21,8,13,85889,83121,85,41708,490
16,8,8,7,12,77705,136515,108,13890,434
19,8,11,2,10,106877,11311,55,4772,511
15,8,7,0,12,228067,0,27,8044,555
20,13,7,6,13,387558,52973,75,27285,383
29,4,25,1,18,17464,125,3,0,564
10,6,4,2,6,137258,21022,34,20852,486
13,7,6,0,8,78406,0,1,275,618
34,16,18,0,12,975585,0,5,0,558
11,1,10,0,8,1800,0,0,1800,631
32,4,28,3,13,18558,17898,151,10813,560
20,3,17,1,16,25324,25324,32,25324,532
13,3,10,3,8,16574,3723,39,390,497
5,3,2,1,8,84835,13300,23,0,544
19,8,11,2,14,577559,66866,25,3010,524
12,2,10,0,6,10160,0,0,0,602
4,1,3,2,7,2509,10699,29,2509,594
8,6,2,7,6,55333,54032,24,2603,516
17,7,10,7,8,31020,19733,144,7082,489
14,10,4,6,5,66027,18112,23,10147,459
94,10,84,3,19,318818,28653,14,2399,431
13,5,8,8,7,37040,66765,31,10119,395
44,4,40,2,12,153432,16419,123,12840,518
6,2,4,1,23,114072,54304,0,0,656
10,6,4,2,8,1592605,47591,31,400,486
15,8,7,1,12,306727,9598,52,8699,503
24,7,17,6,19,32300,28198,103,5692,455
10,4,6,2,7,10780,6512,113,5848,456
5,3,2,3,14,96516,96516,48,43109,453
30,4,26,2,11,130598,130485,42,3064,518
19,5,14,2,6,49215,311,17,592,553
44,17,27,15,10,422631,609188,261,116591,340
7,5,2,0,9,56527,0,10,0,650
11,8,3,0,8,283595,0,2,383,512
5,3,2,0,13,29815,0,0,0,550
29,5,24,0,10,217264,0,0,0,546
6,3,3,2,10,9653,9451,15,8863,433
36,11,25,3,7,53319,8399,86,3749,486
17,12,5,0,7,1784718,0,2,0,622
24,13,11,1,13,179213,1551,60,1957,459
12,5,7,5,11,630745,251588,106,182131,441
7,5,2,2,11,42430,16627,0,0,633
8,5,3,1,6,10269,500,29,3087,560
3,1,2,1,9,2719,1085,0,0,549
39,6,33,3,7,207140,6087,40,5867,558
10,4,6,3,5,15770,14540,138,3035,441
10,5,5,3,14,255328,18899,20,13963,490
15,8,7,5,13,29819,28159,58,475,525
9,4,5,0,9,1244194,0,1,0,620
3,1,2,1,8,6768,6768,23,6768,532
11,6,5,5,7,43744,43744,174,10991,503
19,7,12,4,13,650733,29093,14,1691,450
44,11,33,5,11,363858,130831,319,88416,506
11,8,3,3,7,74556,2394,29,602,483
13,7,6,6,14,848637,1338919,114,3662,462
49,6,43,1,18,283409,971,14,971,518
19,11,8,0,9,824143,0,33,0,595
17,5,12,7,18,38195,29645,79,3444,445
10,7,3,8,6,43345,56038,132,19754,426
11,3,8,0,20,24468,0,1,0,649
3,0,3,1,8,0,10253,12,0,619
31,16,15,0,13,790714,0,5,288,576
13,5,8,1,13,110059,999,35,488,541
29,8,21,0,16,7995,0,5,0,602
6,3,3,3,4,17655,17655,0,0,451
46,9,37,6,17,42048,41947,249,17788,435
32,14,18,1,12,397404,6042,249,5392,475
27,10,17,7,9,54110,37756,241,13354,511
15,1,14,2,11,8295,3810,7,438,492
23,11,12,4,6,555790,10364,0,0,392
11,4,7,2,7,13046,6426,19,4590,460
8,3,5,4,33,29117,39321,0,0,514
34,6,28,5,16,420015,420015,160,245180,432
33,11,22,7,13,82862,94850,127,30938,415
39,8,31,5,9,287162,51226,120,56000,450
15,6,9,3,9,29931,13227,47,1777,481
6,4,2,4,13,9405,9405,33,1400,505
12,2,10,0,5,92729,0,0,0,544
22,4,18,4,10,5428,5428,325,1541,485
43,18,25,10,28,929481,190941,128,87053,387
42,14,28,9,13,1362178,484315,188,35741,399
22,3,19,2,13,119044,141655,147,2768,547
8,6,2,5,7,89622,46642,1,853,479
6,3,3,2,12,14276,13578,10,8600,481
3,1,2,1,6,1467,1467,24,1467,642
39,11,28,5,19,293340,24748,185,8778,459
4,2,2,2,7,14043,14043,26,0,653
19,13,6,0,21,723843,0,8,0,663
20,8,12,6,9,26640,24312,258,13571,438
11,6,5,1,3,64111,4201,17,5348,457
58,9,49,8,16,175315,157257,203,109857,412
7,3,4,4,10,92197,92197,0,0,471
42,10,32,3,11,87392,7633,20,6229,482
7,4,3,3,9,192858,153707,73,0,509
11,8,3,5,14,230051,20640,210,10063,435
7,5,2,1,21,923927,112357,21,112357,643
54,8,46,2,5,45587,4427,33,1882,495
15,8,7,3,15,466562,10310,9,0,516
10,5,5,0,8,429761,0,1,0,684
15,9,6,0,18,35518,0,27,1516,488
18,5,13,3,16,21106,12033,71,10769,530
7,1,6,1,2,7304,7304,7,7304,398
33,4,29,3,6,27661,22337,146,19755,552
20,8,12,0,11,180877,0,2,0,578
16,4,12,0,13,556462,0,2,0,657
20,8,12,17,9,314245,489014,189,78880,444
11,6,5,2,7,25044,6161,4,150,540
35,11,24,7,15,304613,67107,108,12960,420
12,6,6,2,15,267270,18023,29,13505,493
20,8,12,6,12,52191,32370,116,9373,427
7,4,3,3,3,13851,12498,34,3149,446
12,8,4,8,8,28927,31747,549,12096,467
7,1,6,0,11,0,0,14,38507,615
17,4,13,5,13,428920,119169,71,56833,425
9,6,3,4,3,43209,22802,44,9379,383
17,7,10,3,13,43495,8601,49,7819,471
9,3,6,3,17,130804,159144,55,332,463
5,3,2,0,3,19266,0,0,0,625
6,1,5,4,8,6391,23768,68,16333,500
19,8,11,0,16,1111030,0,12,0,618
9,6,3,3,12,93119,37939,55,2275,499
8,5,3,0,10,113505,0,2,0,539
5,3,2,2,10,34039,22890,54,0,519
11,9,2,0,6,121400,0,0,955,558
107,3,104,0,13,1045,0,0,3575,676
6,3,3,1,8,9113,1786,0,0,539
17,7,10,7,6,56937,64174,152,28315,462
37,4,33,5,18,584505,154668,256,60990,449
5,3,2,3,7,4654,22236,20,0,463
4,2,2,2,8,9386,6060,17,0,628
7,2,5,2,6,20174,13608,0,0,484
17,10,7,6,14,391284,54962,123,19703,510
19,9,10,9,8,65928,71564,0,0,439
56,7,49,4,11,34404,12832,53,68717,514
23,5,18,4,13,1221339,142308,65,0,506
6,3,3,2,10,32384,2801,5,2570,477
6,1,5,2,13,12886,11679,38,0,493
22,14,8,1,19,111183,2081,43,2081,489
3,1,2,1,6,5640,5640,117,5640,624
8,3,5,1,17,333925,22129,41,5373,518
6,3,3,3,12,159023,82415,29,80490,464
6,1,5,0,10,7255,0,12,444,622
14,5,9,5,6,13449,13449,48,6115,494
28,3,25,3,16,18406,15050,56,0,462
38,11,27,0,14,54334,0,11,1907,606
30,16,14,0,16,295124,0,61,520,469
26,6,20,3,8,344914,32143,24,20656,545
15,10,5,3,7,63574,4887,30,3822,480
4,1,3,0,9,26516,0,0,0,600
21,6,15,1,17,225212,795,4,795,520
15,8,7,0,8,145530,0,0,1210,572
6,3,3,2,7,25412,3656,39,1997,462
13,5,8,3,13,17850,15667,26,10510,428
4,1,3,3,6,33874,33023,57,0,549
7,5,2,2,2,85423,31839,17,0,437
24,10,14,0,13,154882,0,5,2800,579
3,0,3,0,13,0,0,11,0,599
15,6,9,1,18,34962,20237,57,0,583
4,0,4,1,5,0,4998,16,4998,587
2,0,2,1,4,9200,9200,4,9200,523
47,11,36,3,17,818123,15761,52,11250,453
40,21,19,1,13,1045854,784,10,784,433
6,4,2,2,17,140693,40704,17,27190,573
24,13,11,8,19,69366,55605,228,12036,484
9,4,5,4,7,34947,81695,67,34947,539
5,3,2,4,21,106450,163174,56,90225,545
14,1,13,1,11,698,698,24,0,593
13,5,8,0,22,66863,0,0,0,648
5,3,2,1,16,480381,38245,30,38245,643
12,2,10,2,17,288757,24223,0,1557,528
14,4,10,6,7,24069,29612,95,3968,507
13,7,6,7,12,19774,19774,85,6286,475
23,11,12,5,23,386541,98563,104,35646,425
23,7,16,2,17,316397,8869,30,5295,488
17,8,9,0,8,345003,0,2,0,591
11,4,7,4,8,31855,40295,148,5634,485
16,11,5,9,18,531377,81854,190,3720,460
68,11,57,4,6,203137,269618,36,10626,526
10,3,7,4,9,295684,295684,61,278343,514
16,9,7,0,12,206849,0,7,0,592
12,9,3,0,7,296323,0,25,715,554
35,2,33,1,6,7128,4829,43,9550,477
377,11,366,2,11,40188,1888,25,1328,589
17,4,13,2,8,546847,23521,26,2723,446
5,2,3,1,7,40360,408,31,408,559
9,7,2,3,16,144037,49685,47,42384,462
17,8,9,1,16,130726,4836,1,357,625
14,5,9,0,14,443509,0,31,0,581
17,15,2,1,17,148358,370,11,1260,484
16,5,11,4,17,16538,16538,88,14420,445
7,3,4,2,12,28071,13421,81,8782,526
26,5,21,2,9,208794,1077,16,662,469
6,4,2,0,6,439181,0,12,9025,503
22,4,18,6,11,37581,39612,404,33084,490
16,6,10,8,8,15524,20622,94,5504,429
18,10,8,1,15,336186,8179,19,16956,554
32,12,20,4,45,871594,173532,255,29533,419
24,8,16,5,14,44626,10216,31,3101,538
12,8,4,7,10,111826,159770,12,48920,386
8,6,2,0,15,1145579,0,0,0,678
13,8,5,3,8,144518,94861,88,1595,434
7,2,5,1,20,55236,55236,1,3966,634
50,10,40,1,15,327021,1447,17,2452,489
50,18,32,5,14,451394,13268,146,7094,476
10,3,7,3,8,5190,5190,125,16653,455
11,6,5,0,26,1446616,0,1,0,562
21,8,13,2,10,50450,1492,57,72303,481
11,5,6,0,7,74908,0,31,0,516
4,2,2,0,21,0,0,4,11300,596
36,16,20,15,10,132032,82796,207,30871,418
23,11,12,5,6,557985,11608,0,0,457
15,11,4,2,5,318922,4975,21,0,480
13,4,9,4,6,38551,6897,55,3026,465
7,5,2,0,9,207980,0,0,0,666
20,2,18,1,8,30217,1111,11,1111,553
7,5,2,0,6,182277,0,0,0,654
2,0,2,0,14,0,0,2,0,560
12,6,6,2,8,180172,6259,105,3459,440
14,5,9,4,8,54872,3107,50,2920,515
21,7,14,0,5,132149,0,15,1260,592
8,6,2,0,13,236855,0,1,0,691
9,5,4,5,9,29570,29590,36,10164,451
13,10,3,2,13,73896,8864,7,382,425
12,5,7,5,11,262700,137577,80,100625,443
21,4,17,2,7,25435,18959,120,14732,475
37,10,27,8,10,63769,60343,597,28868,435
55,11,44,7,12,430760,37379,118,12993,424
26,15,11,2,69,261399,15238,48,14496,503
6,2,4,1,8,23686,2661,15,3416,503
42,4,38,5,17,51501,51501,59,2471,480
12,1,11,4,18,37250,21679,10,11344,597
9,5,4,2,12,50525,3101,54,1850,541
20,9,11,5,14,88618,42279,66,22326,395
30,11,19,9,13,244334,51681,152,23252,480
36,21,15,0,12,1102140,0,2,0,552
5,2,3,2,7,301362,10876,0,0,549
9,6,3,2,9,227078,8898,0,0,429
2,0,2,1,7,0,8820,24,0,507
29,10,19,5,22,398401,124532,41,8821,526
27,13,14,1,15,134082,3494,16,4086,555
11,7,4,6,9,76742,66315,67,0,474
25,6,19,3,17,37487,82827,48,6537,538
18,11,7,12,9,91565,59797,47,17080,363
6,2,4,2,10,25963,25963,20,0,525
20,9,11,4,13,440493,141400,153,37537,449
11,6,5,0,13,9876,0,5,0,629
17,10,7,7,14,716577,375796,165,183447,501
54,16,38,0,23,613702,0,47,9744,522
14,5,9,2,4,9140,3282,10,2316,513
16,3,13,7,10,615350,699878,66,0,472
10,7,3,7,6,47743,39172,215,16589,524
39,9,30,0,8,56624,0,0,6658,524
18,9,9,14,8,173545,220599,109,29136,496
19,9,10,8,7,41192,42386,293,16141,416
16,7,9,7,9,23658,22807,7,5152,414
15,12,3,4,18,105079,70519,8,1450,464
9,5,4,1,19,376268,72,1,0,685
15,6,9,5,9,29818,29818,461,14020,514
12,4,8,3,16,69840,37266,39,16168,446
17,10,7,0,8,277683,0,0,0,485
39,12,27,12,10,70606,66768,129,14064,406
9,4,5,8,12,66581,102023,159,20001,455
9,4,5,0,9,927,0,18,220,606
18,12,6,0,11,498742,0,16,9009,667
10,6,4,4,9,46928,26179,3,1511,453
11,9,2,1,19,262872,12094,23,12094,674
20,9,11,6,13,560453,46432,87,24872,414
6,3,3,1,13,113907,88375,25,4123,498
10,3,7,0,9,339571,0,7,490,652
19,10,9,5,26,1088538,58202,77,35862,453
9,5,4,3,14,294543,11185,29,9318,433
5,3,2,2,7,9410,3858,41,2327,570
11,5,6,0,22,2545,0,31,100,514
2,0,2,0,7,0,0,1,630,674
7,4,3,0,5,15491,0,0,0,674
7,4,3,1,9,82544,17208,5,0,473
42,11,31,9,17,131470,123537,141,43872,474
34,5,29,4,15,64237,35115,69,2906,466
11,4,7,4,8,20274,20274,69,3132,498
9,6,3,3,6,67863,19638,61,0,482
12,7,5,7,7,62329,77867,195,19320,495
22,9,13,14,11,83588,131239,257,24766,472
11,4,7,3,7,226227,98995,42,95369,502
39,19,20,8,14,166850,60535,243,18432,467
16,8,8,4,8,85791,20639,140,4464,455
7,2,5,3,7,249779,249210,46,0,486
11,9,2,6,9,33593,33592,95,3247,472
5,1,4,1,16,16406,1028,38,390,497
18,13,5,0,13,1254968,0,0,0,500
13,5,8,0,16,353735,0,10,985,640
10,7,3,4,5,339309,109228,49,0,488
15,7,8,5,8,34625,29836,174,18282,523
15,3,12,5,8,49396,100916,92,8021,555
17,8,9,0,12,321239,0,0,0,596
47,20,27,17,13,3228765,1428207,320,7043,444
12,4,8,2,12,909,13440,1,126,529
6,4,2,0,4,59463,0,0,0,613
3,0,3,0,9,0,0,0,1721,529
10,5,5,3,3,69436,37499,26,36198,488
5,1,4,1,8,4577,4577,2,4577,496
13,3,10,2,16,326768,43618,0,0,617
7,4,3,1,6,241450,1800,30,1800,479
11,2,9,0,6,7628,0,0,1275,661
4,2,2,1,12,709477,30949,0,15530,645
10,8,2,4,8,62759,13709,79,0,481
12,3,9,1,6,19154,1476,3,1476,471
17,7,10,8,15,316672,160378,90,197042,444
35,10,25,6,19,43893,19271,83,9997,463
15,4,11,3,8,129606,129606,0,0,595
13,2,11,1,16,1960,1960,35,0,591
10,2,8,1,15,199300,2008,13,1869,490
12,8,4,7,9,318697,38400,196,15093,415
6,3,3,3,14,11016,8601,14,4979,444
17,6,11,5,16,216483,155614,100,645,509
16,7,9,0,15,137710,0,12,110,598
57,10,47,6,16,91150,6551,89,3700,435
17,4,13,0,8,12416,0,200,1472,560
5,3,2,4,6,76988,91678,82,32318,497
5,3,2,3,8,23617,23617,43,17076,431
15,2,13,1,6,10007,9933,0,0,456
7,3,4,3,10,676877,178047,37,0,478
5,2,3,0,27,0,0,15,0,737
9,6,3,7,14,21643,25052,70,7813,470
47,15,32,8,15,222947,49281,162,21579,462
9,5,4,0,9,243278,0,2,0,652
15,5,10,2,8,47223,5920,5,3786,508
11,7,4,7,15,65104,33667,145,9076,471
8,6,2,0,6,9158,0,8,0,646
12,10,2,0,9,595594,0,1,0,547
7,5,2,0,12,258239,0,2,0,677
5,3,2,2,3,12738,2722,3,3354,417
16,6,10,0,15,203920,0,7,469,574
7,5,2,1,8,15969,2134,75,4972,521
6,3,3,4,7,472298,57401,114,17767,550
16,8,8,2,11,169187,5294,38,4133,510
11,7,4,6,18,67505,14335,76,948,453
27,11,16,3,16,989704,2618,244,4008,496
12,5,7,2,3,38537,12900,20,5281,490
13,7,6,2,18,294768,160695,34,1000,538
28,16,12,12,9,50005,38729,166,5890,422
8,5,3,2,8,7835,23583,101,22377,524
21,12,9,0,11,387903,0,43,3287,542
34,9,25,9,11,127855,123869,307,47359,427
15,9,6,0,4,427617,0,13,2314,546
7,4,3,4,12,32712,30293,144,17362,389
7,5,2,3,7,26256,5713,51,1728,460
8,6,2,1,2,114568,1004,4,0,486
14,6,8,1,15,150972,3155,0,0,507
22,15,7,0,18,1591408,0,0,649,636
28,2,26,4,8,69007,62781,57,6206,447
7,3,4,4,19,128717,181720,77,0,477
4,1,3,0,8,450,0,32,1560,649
5,1,4,1,8,31640,31640,28,641,563
16,4,12,2,7,30080,3338,39,2368,519
21,14,7,3,10,199221,11450,5,1275,497
18,12,6,12,5,30802,36258,420,4905,449
18,7,11,0,8,1105717,0,12,3553,538
5,3,2,5,7,133990,161124,91,81598,488
48,17,31,2,17,116844,1744,172,1660,538
37,11,26,7,8,467876,14779,132,2919,390
7,3,4,0,6,27678,0,0,0,640
8,5,3,0,15,208546,0,4,2195,569
6,2,4,1,3,1090,1090,23,1190,582
24,9,15,7,18,35557,16942,58,2145,461
6,4,2,2,7,8798,6960,19,6039,574
31,8,23,6,12,422976,120298,128,34645,394
13,7,6,4,14,361407,49336,24,3022,481
7,2,5,2,14,908,908,26,575,502
24,1,23,0,9,27830,0,4,1088,684
11,7,4,8,18,421110,68718,60,14475,409
13,8,5,6,16,62440,38588,113,15679,489
4,2,2,2,13,29783,29783,49,19655,621
33,5,28,1,8,47236,6992,0,0,503
19,1,18,0,8,0,0,23,1600,500
11,7,4,5,4,160532,67709,94,34165,513
83,13,70,4,13,444021,1390,233,5043,424
9,6,3,0,10,10422,0,48,1281,587
8,4,4,3,11,9525,9525,48,2898,493
16,5,11,4,14,15389,15389,288,17027,454
10,5,5,1,9,73225,297,10,0,532
18,15,3,0,8,2826151,0,1,0,606
5,2,3,0,3,4063,0,5,0,600
2,0,2,0,7,0,0,16,0,523
8,3,5,2,12,315352,17726,23,16961,529
9,1,8,1,8,3704,3704,272,3704,491
19,8,11,4,10,511607,195510,46,3706,423
10,4,6,0,13,175363,0,1,0,652
24,8,16,0,11,634281,0,11,5771,560
13,8,5,1,14,663814,12815,9,12815,503
5,3,2,2,4,256612,36597,31,0,464
15,4,11,2,9,22077,5858,18,21766,405
4,2,2,2,12,11361,11361,25,10161,517
24,7,17,5,9,1743692,29214,0,0,424
53,10,43,3,8,71110,2873,41,1640,482
15,3,12,3,18,24806,10258,19,5864,502
147,8,139,0,8,32602,0,176,1525,636
14,4,10,4,10,12781,12781,90,4490,481
37,10,27,4,7,246370,7282,91,5738,411
8,2,6,2,10,27756,27756,49,774,509
13,8,5,8,14,252005,148072,176,3000,459
8,5,3,2,20,28389,28389,18,26684,618
10,5,5,2,11,1989,1989,29,1160,440
27,10,17,7,8,88697,46909,19,8919,439
9,2,7,1,13,138735,6038,1,6038,524
14,9,5,5,7,289374,167146,50,106125,450
17,12,5,8,6,386834,75963,263,27713,399
19,12,7,0,19,334548,0,14,0,591
14,3,11,5,13,46877,74124,0,8018,465
12,3,9,2,10,52533,5299,16,549,462
5,2,3,0,12,7157,0,0,0,640
17,3,14,4,14,281588,30139,57,5739,476
8,6,2,5,6,270106,46611,81,0,460
3,1,2,0,8,0,0,16,0,634
50,14,36,4,11,460415,95598,29,3200,673
7,4,3,3,7,59812,23425,35,2311,495
10,7,3,0,12,430050,0,20,3720,466
7,4,3,3,18,30739,22888,57,15530,562
33,6,27,2,10,33810,9080,107,7268,340
29,10,19,3,16,329506,20478,38,13396,622
6,3,3,1,12,2753,1040,13,5200,548
9,3,6,1,18,11982,150,8,150,671
8,4,4,3,10,273714,4642,0,0,488
11,3,8,4,9,43577,49258,20,8942,606
13,10,3,7,7,383611,318809,85,1071,440
34,15,19,6,8,134986,23144,26,4157,441
12,5,7,7,9,438782,187337,133,58130,442
5,3,2,0,6,300077,0,1,0,552
17,6,11,3,6,49191,13060,252,7937,437
20,8,12,1,13,26382,1837,60,3352,594
5,3,2,0,5,405736,0,1,0,579
47,5,42,4,20,74567,16620,42,1729,457
33,9,24,0,12,452916,0,0,0,689
14,11,3,7,7,203020,57772,135,19558,439
13,6,7,1,18,38622,968,33,0,544
9,3,6,2,7,11280,11103,8,1241,549
20,12,8,0,14,53240,0,18,1600,641
2,0,2,0,8,0,0,0,0,565
20,7,13,1,8,803528,2200,15,2200,529
4,2,2,2,13,8583,12487,11,8234,559
10,4,6,2,9,9154,5311,27,4863,474
7,2,5,2,7,6621,15119,44,2440,457
7,3,4,1,9,7600,5648,99,5648,587
30,18,12,19,9,297055,191202,579,21849,369
22,4,18,3,17,84240,93976,44,68384,518
9,6,3,6,7,76703,96590,218,15842,478
16,8,8,3,5,602068,16048,129,30963,384
25,5,20,8,13,34964,53157,66,16966,453
6,4,2,0,2,294117,0,0,0,562
12,9,3,2,9,209423,105061,28,0,647
7,4,3,0,4,276096,0,0,0,476
15,7,8,4,8,176609,100263,27,47595,442
26,13,13,9,14,338255,268258,123,16945,495
15,3,12,3,12,34866,28358,78,370,506
21,12,9,7,12,52770,30892,181,2370,470
13,7,6,4,13,88735,52339,80,3000,502
93,4,89,5,10,49222,57266,102,20031,459
14,10,4,5,14,99534,37692,48,10943,397
59,10,49,9,13,88639,55841,344,20854,412
21,3,18,2,11,33297,25529,81,21338,454
8,6,2,3,13,310076,14040,60,8351,506
6,4,2,1,3,22572,775,1,0,584
11,7,4,0,7,48572,0,16,695,524
110,10,100,9,15,560078,146880,26,19923,428
9,3,6,3,13,14813,35742,37,0,515
20,7,13,0,8,157443,0,4,12062,529
19,13,6,2,22,1294625,42139,38,25700,524
17,6,11,1,8,325735,6810,30,158,496
7,5,2,1,15,45274,33390,35,33390,524
63,15,48,5,13,228638,55406,114,8380,468
7,3,4,3,20,13836,26474,56,335,485
56,24,32,14,21,482407,78439,250,4579,394
34,8,26,0,11,75633,0,32,3955,392
8,5,3,0,4,11311,0,1,0,627
15,4,11,3,16,197776,4245,0,0,525
21,13,8,9,13,88372,44251,1,649,446
9,6,3,4,14,334496,93522,33,947,481
6,4,2,1,12,138208,1766,27,0,520
5,1,4,1,14,900,900,10,2746,611
18,6,12,5,8,33106,28690,289,17080,470
7,5,2,2,6,158281,43320,0,0,412
20,4,16,1,16,330453,2905,19,2905,648
12,4,8,2,18,29428,4595,7,1636,538
13,10,3,8,21,99996,72952,104,22631,464
7,4,3,4,7,125825,38718,73,3397,444
5,2,3,1,12,1780,396,44,2062,529
39,10,29,0,12,255075,0,0,664,561
17,8,9,3,17,415612,61678,86,28710,498
17,8,9,1,14,26970,162,9,162,545
21,11,10,3,9,437228,597,203,459,527
9,6,3,0,10,93592,0,24,18941,498
16,10,6,6,6,46223,23383,107,2827,416
10,5,5,1,8,14917,78,44,165,601
8,5,3,5,6,42355,42355,216,14052,440
5,3,2,2,8,167757,85158,9,0,473
22,7,15,6,14,83569,40581,254,8522,454
10,5,5,0,9,87616,0,0,125,625
3,1,2,0,14,37445,0,12,11969,637
15,9,6,10,8,351642,440691,277,6915,502
3,1,2,0,14,10599,0,0,0,658
13,5,8,4,8,19080,19080,138,8059,487
7,2,5,1,11,4041,4041,96,4041,664
10,4,6,1,30,1086,9922,3,1008,723
39,19,20,0,21,669400,0,2,2555,561
9,3,6,2,11,17172,11216,17,10159,447
41,4,37,2,11,48085,888,47,10281,621
57,7,50,2,19,36504,13930,42,1250,610
3,1,2,1,7,0,17577,25,0,625
4,2,2,0,13,186377,0,0,0,688
16,7,9,6,13,17301,20289,103,3528,423
35,10,25,9,9,111430,69988,306,28731,378
2,0,2,1,7,0,10662,15,0,619
5,3,2,3,6,28117,4480,34,2768,459
27,8,19,0,16,931560,0,18,420,550
3,1,2,1,2,2090,2090,4,2090,416
11,2,9,0,5,17077,0,20,900,623
15,8,7,6,14,232109,9177,105,9692,389
76,5,71,5,19,307130,64638,0,0,635
24,16,8,8,13,823900,106579,107,5532,458
29,10,19,7,9,115469,71810,68,39236,500
8,1,7,0,19,0,0,0,8687,651
24,5,19,5,14,42236,55900,24,4321,498
8,3,5,5,14,40324,62499,89,28278,449
34,7,27,1,18,150719,5173,17,15835,373
15,4,11,0,8,41527,0,228,1175,482
17,8,9,5,6,23520,5824,79,3811,428
9,7,2,1,13,124840,38370,23,38370,606
10,6,4,1,4,109754,43091,28,1058,495
23,15,8,11,12,301075,84689,122,7460,419
92,18,74,7,13,741081,18755,655,4976,486
5,3,2,3,3,46961,29975,40,26189,399
9,6,3,6,4,17825,17737,175,9912,428
14,3,11,6,9,17793,23976,92,6227,506
5,1,4,0,12,9258,0,0,41245,637
18,2,16,0,11,453930,0,1,1726,640
5,3,2,0,9,55018,0,0,0,614
14,5,9,3,8,13975,18315,52,11165,594
6,4,2,4,12,10311,10311,26,5595,505
9,2,7,3,15,8729,18157,12,364,548
10,4,6,4,18,10246,16722,69,4302,492
15,4,11,4,9,27186,27186,213,9975,463
5,3,2,3,9,658833,717786,47,650484,493
13,10,3,6,8,336083,33001,0,0,506
8,4,4,0,9,16116,0,1,3400,676
3,1,2,0,3,14448,0,0,0,623
11,7,4,3,7,93545,51523,221,1359,449
10,7,3,0,5,181908,0,1,0,519
18,7,11,5,7,110349,83069,115,64346,401
5,3,2,1,7,11191,9561,25,9561,558
10,8,2,8,6,77225,77351,44,13074,495
5,1,4,0,11,214262,0,0,0,717
8,2,6,1,5,21856,4680,33,0,516
16,14,2,4,5,111406,8550,26,5032,399
19,5,14,1,7,72412,67388,0,0,560
7,2,5,3,6,9016,7024,68,5500,556
7,5,2,0,6,48207,0,0,0,610
53,17,36,1,9,731568,973,324,3368,455
42,7,35,0,10,81437,0,20,0,573
31,15,16,11,13,702561,225452,198,30218,445
23,6,17,7,11,468943,145628,37,6457,464
10,5,5,3,13,22415,17396,59,0,495
18,7,11,1,8,96443,4643,74,2018,425
42,11,31,8,13,244234,166854,284,24488,484
11,3,8,3,18,8681,8681,28,4234,500
25,6,19,1,9,797894,21511,15,0,634
41,15,26,8,3,117093,76740,62,19873,412
6,3,3,2,17,15317,11417,11,5942,548
17,15,2,5,14,256310,3114,18,1478,438
5,2,3,0,6,30023,0,8,839,654
8,1,7,1,14,12047,12047,95,22317,492
24,11,13,7,30,1638134,904204,191,513914,458
31,9,22,1,9,36127,2174,14,4337,516
8,3,5,0,13,35885,0,8,4042,581
16,3,13,0,6,11346,0,48,482,588
9,6,3,3,13,380600,31305,53,18036,488
39,11,28,4,13,194605,1128668,156,5519,460
17,8,9,4,13,104889,104889,54,10007,485
9,6,3,2,3,127713,12924,19,4751,480
46,10,36,7,14,386782,42143,240,14928,449
109,14,95,3,16,618036,18102,46,38550,519
42,7,35,7,17,355082,61601,177,8600,479
9,6,3,3,14,29932,2248,29,597,505
31,11,20,3,8,340657,16250,0,2697,489
8,5,3,1,17,1286968,331544,27,0,505
38,8,30,6,13,545149,127777,102,42737,543
63,10,53,1,9,68023,172,67,3699,469
2,0,2,1,5,0,3212,8,0,519
7,4,3,1,15,426879,104876,28,8067,562
4,1,3,2,8,35816,11818,0,0,515
29,14,15,0,6,999636,0,48,3121,589
8,6,2,7,20,432913,46900,105,11236,488
16,5,11,4,10,16095,17686,70,10242,484
5,3,2,1,7,20854,408,11,431,587
5,3,2,3,3,32625,26142,72,13304,454
6,2,4,1,9,39782,29889,32,72756,473
31,16,15,1,14,389772,1419,23,0,561
29,7,22,2,12,38816,15273,147,10287,401
41,20,21,1,9,330856,4722,30,4722,579
10,8,2,1,9,262548,214,59,4206,468
10,8,2,7,11,193087,28940,0,0,418
24,7,17,7,25,25796,24522,128,13317,483
23,3,20,3,9,1838,12172,60,10334,467
6,3,3,3,8,25964,25964,48,10418,438
11,6,5,4,6,150437,96415,79,6620,433
8,4,4,6,4,30944,33751,55,11794,582
20,16,4,2,7,546797,2478,41,0,511
11,7,4,8,6,238312,103775,72,0,457
17,6,11,6,13,473579,94572,102,31252,431
7,4,3,1,7,9990,2035,0,0,522
15,3,12,2,17,41843,3742,38,0,546
11,6,5,10,8,161070,204429,162,29040,462
16,4,12,4,14,12042,15139,67,3299,522
10,4,6,4,8,41867,41071,47,21833,477
4,2,2,1,6,34763,1133,3,0,623
8,5,3,0,4,29751,0,2,264,591
66,15,51,6,10,176886,88170,56,13932,405
15,7,8,2,16,419495,13941,7,9871,495
15,3,12,2,10,2757,2757,35,1654,550
8,1,7,1,6,11522,8961,55,8961,504
4,1,3,2,19,515818,511818,26,9582,543
19,11,8,0,13,2385440,0,4,0,549
5,3,2,3,6,195551,41841,0,0,617
7,5,2,3,8,11695,11695,288,6015,533
13,9,4,0,69,37636,0,23,753,532
47,8,39,4,18,36988,4224,81,1830,458
12,9,3,8,11,57501,57263,96,12071,439
12,7,5,3,14,23033,10309,59,6409,474
16,8,8,4,11,654082,34832,78,25950,445
72,12,60,6,12,56480,366590,291,3888,460
17,9,8,6,12,807960,34776,55,1320,446
8,3,5,0,20,226775,0,0,2793,561
12,8,4,4,9,432640,42453,34,32271,499
8,6,2,4,13,94098,92608,102,28400,502
17,8,9,0,10,196390,0,18,0,624
12,9,3,0,8,419924,0,0,207,613
13,3,10,0,14,38575,0,25,820,519
17,5,12,4,13,303498,28362,63,16403,446
3,1,2,1,13,8599,8599,23,8599,522
10,5,5,0,33,392827,0,0,0,616
7,4,3,3,8,12695,12695,78,6969,394
6,3,3,2,6,55566,11390,100,10348,531
7,3,4,1,18,20144,14850,7,816,536
5,3,2,0,7,0,0,241,12328,427
12,4,8,2,7,38622,9986,29,8726,617
14,10,4,6,14,955454,169784,170,41131,450
13,9,4,2,11,60859,2375,76,1648,462
7,5,2,5,7,47083,45973,68,21266,385
9,4,5,4,8,327789,22895,342,18243,503
24,13,11,2,10,375948,977,84,3210,454
12,8,4,1,11,173409,1152,25,1485,555
8,4,4,4,11,387673,29493,81,5185,458
8,6,2,5,3,218768,218768,52,0,476
14,12,2,2,15,1251685,233936,2,137947,504
12,9,3,8,9,63873,68752,117,15803,476
27,11,16,2,11,116853,11976,84,3196,471
42,9,33,1,15,568790,1,34,1804,580
14,10,4,9,15,140858,67902,197,23393,415
17,9,8,2,13,51352,23314,54,0,533
10,8,2,0,6,29539,0,3,0,543
64,9,55,5,13,102745,77356,166,29003,492
48,22,26,7,9,330796,47299,119,824,453
53,11,42,0,13,81913,0,58,850,497
14,10,4,8,8,111771,75982,97,25869,417
22,8,14,2,15,73899,15457,29,11282,500
5,3,2,0,8,13667,0,2,342,614
5,3,2,2,2,15703,369,60,1104,573
7,2,5,5,15,148866,154981,6,833,566
8,4,4,1,20,339055,3404,22,2622,525
11,8,3,3,13,72920,12489,58,3360,539
31,3,28,0,15,80851,0,0,330,586
8,1,7,1,6,2208,2208,0,1486,539
14,9,5,1,16,438238,37959,23,37959,577
10,7,3,1,10,546823,1204,9,0,499
17,1,16,2,9,4634,4634,205,7288,597
7,4,3,4,9,10233,18359,42,0,454
25,11,14,10,8,684985,54382,411,21455,423
6,2,4,2,14,8133,4803,3,4227,462
15,4,11,2,15,357874,128616,46,10187,514
15,7,8,0,15,59999,0,6,867,615
6,2,4,0,5,8455,0,3,0,688
13,6,7,0,10,196711,0,2,44,601
10,4,6,5,15,316726,375936,73,23,477
21,10,11,6,7,623307,66106,111,11179,442
16,5,11,6,8,118476,137574,33,17015,437
4,2,2,1,9,5779,5779,88,5779,663
10,4,6,3,8,12414,4530,34,876,477
6,3,3,3,8,9147,16136,62,0,530
7,1,6,0,10,0,0,0,0,761
8,1,7,1,18,6380,3980,30,3980,463
56,20,36,8,12,579096,168476,138,63070,437
8,4,4,1,8,314,2671,14,3215,506
15,7,8,2,15,51946,1676,12,976,552
3,1,2,2,4,147416,210642,35,147416,418
3,1,2,2,12,943793,121391,23,26550,582
12,3,9,0,14,13128,0,14,1655,655
5,1,4,0,8,1617,0,0,0,673
14,5,9,3,21,647378,639053,56,12854,527
15,11,4,2,7,128434,2690,23,133,463
5,2,3,1,8,22186,4303,25,0,553
44,9,35,0,13,391233,0,15,17968,432
16,9,7,8,7,64780,63975,117,17012,390
9,2,7,0,10,0,0,1,245,635
16,9,7,4,9,26641,18033,23,12304,476
17,10,7,3,15,76197,21545,39,3794,512
3,0,3,0,8,2825,0,24,900,618
12,4,8,4,9,49728,27177,26,14100,493
12,2,10,2,11,13602,13602,20,10366,631
15,5,10,3,23,253498,32502,59,64669,462
45,13,32,9,16,748810,329606,94,220,496
16,14,2,14,14,829033,441919,283,19125,446
11,6,5,0,8,142891,0,1,0,493
18,13,5,0,30,1265341,0,9,513,494
12,3,9,3,3,13363,8067,0,0,417
22,7,15,7,7,59804,59763,229,30283,392
11,9,2,2,10,349110,6439,37,2039,469
16,5,11,4,9,39311,27790,0,2130,451
24,6,18,2,16,6971,6971,169,7496,439
4,1,3,0,3,21129,0,0,0,677
18,11,7,5,16,49259,35769,29,27961,577
43,21,22,4,15,1246493,13415,36,9526,604
6,3,3,0,3,1488,0,44,492,620
8,4,4,4,8,20683,20527,136,9430,469
11,6,5,5,11,44339,62749,79,0,561
10,1,9,0,7,2600,0,1,0,618
10,2,8,2,14,10566,28480,40,22444,539
126,5,121,0,16,44980,0,7,0,575
30,4,26,3,12,11742,5736,69,1827,590
25,9,16,1,9,42005,1686,22,487,681
22,10,12,2,2,44234,13417,3,4852,428
8,5,3,0,9,242438,0,5,0,637
19,2,17,2,5,16674,16674,44,5761,488
3,1,2,0,3,1888,0,0,0,634
7,3,4,0,6,36919,0,0,0,663
14,4,10,4,10,13865,10484,85,3060,551
12,7,5,4,10,103207,134739,60,3023,439
14,11,3,9,7,54258,49624,20,952,408
5,1,4,4,8,23778,253809,108,0,506
5,3,2,2,13,107240,107240,48,0,635
10,8,2,2,8,276632,2817,29,254,472
5,3,2,0,6,57948,0,0,0,658
6,4,2,0,8,2792,0,38,7816,609
5,3,2,2,7,24986,10654,13,17308,491
44,6,38,6,10,38801,38801,312,15850,482
7,5,2,0,7,246443,0,1,0,513
5,2,3,0,5,8592,0,0,1250,596
30,6,24,1,15,100898,738,7,738,564
19,4,15,5,9,104035,80577,107,447,453
11,6,5,6,14,391107,390468,56,470,418
17,10,7,5,5,59966,7741,35,2950,541
6,2,4,0,8,59474,0,3,0,671
9,6,3,0,13,68407,0,4,690,679
3,0,3,0,14,0,0,0,0,521
6,3,3,0,8,97183,0,0,0,556
15,6,9,5,14,18472,35064,68,13699,476
9,5,4,0,5,64141,0,4,168,567
11,6,5,1,11,58205,2247,19,1639,571
6,3,3,0,5,1603,0,16,4017,582
4,1,3,0,14,256221,0,2,35063,644
14,2,12,3,7,5546,6787,34,0,543
8,4,4,0,4,38627,0,10,0,569
16,9,7,4,19,313710,131040,56,11358,497
41,12,29,4,13,1344263,15400,42,9707,418
34,9,25,8,12,14748,16134,273,6009,480
17,6,11,2,42,5295,3535,2,27172,474
43,16,27,11,13,821729,56120,278,18271,419
21,13,8,0,12,411820,0,2,930,502
22,11,11,7,6,226977,13906,270,5715,460
21,11,10,0,14,1085024,0,0,0,577
9,7,2,4,4,106779,65960,40,52400,449
9,6,3,0,20,1433,0,22,1156,456
10,5,5,0,9,878110,0,16,0,584
9,4,5,1,21,636170,64415,31,138952,523
5,3,2,3,11,22771,22771,56,11502,460
19,7,12,6,11,58092,40770,120,15714,473
34,11,23,4,7,76952,43599,36,39355,503
25,5,20,2,13,17789,6156,118,3270,542
19,9,10,11,24,222660,469309,0,0,505
6,4,2,3,14,132932,38317,30,18357,496
21,6,15,3,5,113142,21090,20,14977,572
31,11,20,7,21,439641,430324,181,143999,450
20,7,13,5,4,74851,50124,66,43510,452
3,0,3,0,6,0,0,0,0,614
10,5,5,0,7,44157,0,19,2022,626
8,3,5,0,3,159902,0,0,0,597
18,7,11,10,18,277384,205120,193,3860,504
22,16,6,8,27,2216797,255030,94,39237,435
46,8,38,9,10,110935,110601,303,60000,404
7,5,2,0,5,79790,0,9,0,534
12,8,4,0,22,3001221,0,17,3155,658
2,0,2,0,4,0,0,0,0,550
26,22,4,1,16,817245,1188,0,0,466
48,8,40,2,13,430818,68025,86,2895,516
15,10,5,9,9,236990,25730,110,11294,456
8,5,3,0,6,13971,0,6,273,655
90,11,79,1,69,492952,2000,22,2500,456
9,4,5,1,29,7694,7693,4,7693,694
10,8,2,8,18,337223,75199,106,38189,454
10,6,4,1,6,60033,12833,38,12833,551
12,7,5,1,10,468059,361,0,0,656
16,5,11,2,9,192913,719,111,1166,561
12,8,4,4,7,344926,18138,51,7292,512
10,4,6,1,9,154409,7510,0,0,539
15,6,9,4,8,405276,53187,58,1188,486
19,7,12,2,21,328862,61077,45,269,517
5,3,2,3,11,25813,25813,85,6661,527
13,6,7,1,10,49402,4979,3,4301,555
34,8,26,7,7,41558,32739,97,15120,477
10,2,8,1,11,39045,2242,0,0,580
12,2,10,0,14,92541,0,8,6268,515
7,1,6,1,14,6041,6041,37,6041,608
10,8,2,1,2,188933,822,3,822,546
16,6,10,1,11,398093,5699,97,5699,667
35,14,21,9,17,575905,109957,42,7225,387
16,12,4,0,12,124396,0,11,0,534
11,5,6,3,19,14733,11656,52,2035,490
13,6,7,0,15,591977,0,16,0,633
22,7,15,1,8,92322,1732,46,318,486
10,6,4,6,16,16794,63191,118,0,481
16,1,15,0,18,96026,0,24,1974,474
12,9,3,5,14,686372,25155,0,0,528
15,4,11,0,12,199517,0,8,0,453
22,12,10,0,14,267958,0,21,0,603
9,6,3,5,8,28566,37133,89,9260,539
16,8,8,2,26,618639,54119,0,0,480
30,6,24,0,12,90595,0,29,0,524
19,12,7,1,11,217740,2430,10,59,469
7,1,6,2,6,15351,10713,34,3103,491
19,8,11,8,12,71477,98523,353,18845,532
15,4,11,3,12,15165,15165,33,45600,472
132,16,116,2,16,179302,2377,25,371,514
42,10,32,5,11,61469,12206,126,3971,451
10,1,9,0,7,20618,0,21,2060,575
8,6,2,3,5,13606,6022,30,3120,529
64,9,55,1,11,355006,10177,35,6916,544
14,10,4,0,4,78784,0,5,0,564
6,4,2,2,12,17743,11218,34,11218,566
9,3,6,1,18,104302,29974,26,0,651
40,15,25,1,13,290694,449,0,0,567
20,6,14,8,9,67975,59385,102,3059,460
11,7,4,1,31,24549,7846,5,665,437
13,8,5,6,15,383286,48650,51,15340,434
11,6,5,6,18,48013,48013,139,14522980,467
14,5,9,3,9,37440,5900,52,0,491
21,10,11,5,11,31740,20388,56,5740,477
12,8,4,7,7,91948,56173,79,0,452
38,14,24,9,13,916625,20553,333,8400,424
21,7,14,8,12,53252,56208,267,12419,424
7,3,4,0,11,12522,0,25,2294,676
21,11,10,0,9,451661,0,0,0,565
6,4,2,4,5,8351,16091,82,0,544
142,8,134,6,8,76379,39101,158,7734,510
37,16,21,0,10,743815,0,28,412,595
8,4,4,1,8,54518,264,27,0,522
5,3,2,3,6,9213,9213,47,3114,480
21,7,14,8,9,135685,110016,150,63779,430
20,8,12,3,5,94436,4775,32,3055,472
42,10,32,10,15,1088472,367616,147,27068,451
20,17,3,0,15,163591,0,30,9696,507
11,5,6,2,10,259202,5537,28,1279,494
23,11,12,5,16,104267,43945,92,17438,427
10,3,7,2,7,69773,21337,10,0,488
29,5,24,2,10,850737,16043,0,0,470
23,8,15,4,18,27750,4972,7,2898,503
10,5,5,0,5,113687,0,1,0,613
13,3,10,1,8,32639,6374,14,358,525
13,5,8,0,9,263796,0,0,0,547
14,2,12,0,12,31698,0,0,11988,644
29,4,25,5,9,25657,27980,101,30000,481
3,1,2,1,7,8586,8586,10,8586,591
10,3,7,0,19,5209,0,0,0,725
24,10,14,10,15,188736,252483,199,115370,417
4,1,3,0,14,0,0,0,0,691
9,5,4,1,6,96120,5506,39,16524,463
21,4,17,5,4,24536,34447,118,9911,440
26,4,22,3,17,27459,9418,37,536,532
26,11,15,0,10,662974,0,1,0,618
24,13,11,15,12,92477,112994,226,23397,385
13,7,6,0,6,149328,0,0,0,610
35,14,21,9,8,48921,18434,285,13360,472
14,5,9,6,12,117237,98722,39,26951,434
13,5,8,1,4,50487,10355,25,10355,544
34,16,18,9,15,621006,140850,125,39808,429
3,1,2,2,3,3260,19969,15,16709,602
4,2,2,2,14,5729,6018,13,4389,642
10,8,2,0,8,77506,0,13,100,519
15,4,11,4,7,35220,49524,28,16407,489
15,12,3,7,12,311854,20320,76,8268,411
9,6,3,3,10,721637,1032211,47,15383,531
51,7,44,3,14,308173,35238,67,20612,466
57,10,47,3,19,684775,53522,34,2185,519
26,4,22,6,15,21463,38229,87,6155,607
121,6,115,0,7,47510,0,12,485,642
10,2,8,0,12,392,0,2,500,628
12,6,6,3,7,210898,18920,162,6045,431
11,9,2,2,8,156108,11876,41,0,473
24,5,19,1,8,71575,8320,30,8320,447
6,4,2,5,9,106375,106375,16,21323,534
5,0,5,0,6,0,0,1,1857,552
6,1,5,3,6,35362,44207,53,0,549
12,7,5,1,8,264724,2884,22,2247,448
12,2,10,0,12,10883,0,0,0,550
21,4,17,3,11,19652,11807,10,4172,463
140,28,112,5,13,498442,9780,15,2948,544
8,2,6,1,13,21522,21522,16,21522,537
6,3,3,0,5,159149,0,1,0,612
35,15,20,8,17,115055,114581,187,17353,435
3,1,2,1,7,54994,54994,25,0,493
17,2,15,1,18,262744,573,102,1819,456
5,1,4,1,17,20041,20041,25,743,543
13,8,5,3,12,192247,47471,188,40854,410
6,4,2,4,8,20826,11138,79,881,459
5,3,2,2,18,2147,2147,26,1868,561
9,1,8,2,8,12000,3636,23,3679,487
6,1,5,1,6,23317,1606,17,0,587
56,9,47,4,5,24715,13123,157,7086,427
8,6,2,4,6,15788,12115,128,8822,488
68,17,51,1,15,195418,1497,24,7030,587
20,6,14,8,10,1009621,1046808,266,3788,596
11,4,7,0,9,112492,0,1,0,603
11,7,4,2,20,188228,34814,42,19131,667
15,7,8,2,16,30610,9457,17,7570,433
29,16,13,5,18,1080097,119477,129,67825,464
9,6,3,5,10,450675,416894,49,197521,525
21,4,17,1,9,17355,22638,78,20621,497
15,6,9,2,12,390355,2392,29,442,526
8,3,5,1,14,342534,2248,14,732,571
9,7,2,6,7,15441,15441,78,2387,405
5,1,4,0,6,46113,0,29,0,537
7,4,3,1,15,14861,14861,22,14861,654
19,3,16,6,9,92084,88224,170,3342,610
18,6,12,3,8,11869,5317,47,1615,520
3,1,2,2,11,15667,21413,22,15667,455
6,2,4,0,18,11110,0,56,52396,508
35,8,27,1,13,11872,266,31,1770,554
13,7,6,5,10,55712,31424,107,12059,486
18,9,9,13,6,25893,55463,158,13223,598
68,11,57,1,9,32172,321,399,24795,411
18,6,12,0,20,970677,0,3,0,730
11,6,5,5,16,433170,39968,201,11765,473
38,17,21,2,7,161500,426,175,1329,500
9,4,5,2,8,106894,83337,52,0,522
14,8,6,4,12,415327,37391,80,7357,463
81,19,62,6,15,391389,37154,710,12750,414
7,4,3,0,4,10689,0,0,0,622
10,5,5,3,20,68878,47126,74,3273,488
20,4,16,3,17,243027,10773,70,13542,625
16,1,15,1,7,68329,10665,6,0,470
5,3,2,3,19,22380,22380,31,9286,473
8,2,6,2,6,8512,19505,36,444,523
5,2,3,0,14,780707,0,0,1223,640
19,9,10,6,9,139468,40233,111,2949,474
9,4,5,4,7,16908,16908,299,8730,496
19,8,11,0,14,1960,0,75,4874,516
63,15,48,1,15,108673,7911,5,9053,388
5,3,2,1,13,9222,4100,12,35021,548
13,5,8,0,3,51426,0,20,4270,557
13,6,7,3,10,268264,25106,31,5660,514
8,4,4,0,13,500,0,0,0,701
4,0,4,1,7,0,2591,10,0,648
20,7,13,3,13,23313,318,53,2898,551
24,6,18,4,10,13937,10800,103,50315,436
15,4,11,3,8,23820,23820,284,13200,524
2,0,2,0,8,0,0,45,621,545
21,7,14,2,12,263895,6183,37,4462,589
17,3,14,3,8,19354,19354,0,0,504
38,10,28,9,14,56067,83914,362,24589,402
10,4,6,6,7,30943,39459,64,6770,537
4,2,2,1,4,13561,355,30,750,603
19,7,12,4,14,112933,14398,165,32130,446
34,7,27,2,18,357656,10343,170,1405,465
4,1,3,1,6,26108,21649,17,21649,588
31,6,25,1,12,53268,722,21,0,602
4,0,4,0,7,0,0,1,0,675
7,5,2,5,13,59214,42290,73,2089,454
8,4,4,2,9,112548,85147,37,4056,478
10,2,8,3,10,6550,11074,85,4750,509
16,9,7,3,19,783099,264083,71,75031,495
6,3,3,6,6,1369203,2240158,111,984919,422
9,4,5,0,9,6570,0,158,1621,631
7,2,5,0,10,87958,0,2,0,636
28,8,20,0,5,289643,0,2,3899,600
16,1,15,0,7,2384,0,0,866,692
24,6,18,4,8,17569,8318,302,6108,452
11,8,3,5,8,17404,12254,30,4200,470
14,7,7,2,20,105349,442,5,530,575
8,6,2,6,7,62650,68428,68,46205,443
6,2,4,0,10,356983,0,0,0,555
9,6,3,1,22,56349,17057,4,22759,488
24,14,10,11,7,238061,193252,0,0,437
9,5,4,4,9,67481,26591,82,632,425
14,7,7,7,7,25901,23356,118,6440,545
13,7,6,6,7,21002,12207,109,6503,431
8,4,4,3,14,59780,46593,94,0,564
10,6,4,5,14,38033,25336,37,13245,423
73,6,67,3,19,23269,8824,223,19266,497
13,7,6,3,18,93259,43840,37,16718,512
17,10,7,4,23,502349,79863,39,0,418
53,10,43,2,9,154393,10370,35,10033,524
4,1,3,0,32,0,0,0,1546,667
13,4,9,1,16,144069,14271,25,14900,636
16,7,9,3,11,39639,14408,232,16566,460
7,5,2,1,8,452,452,53,452,569
31,4,27,2,15,17706,17706,143,5063,560
31,9,22,4,26,278553,57678,42,32569,475
4,2,2,1,16,5507,5507,15,0,539
34,14,20,7,8,107691,76464,524,2705,439
22,7,15,5,9,417580,115734,98,11318,402
9,2,7,1,13,16139,16139,29,16139,436
38,12,26,7,17,188282,43751,232,30799,387
16,10,6,10,22,641199,859362,149,218613,391
5,3,2,3,5,8060,8060,224,8967,487
16,7,9,0,10,293438,0,0,0,730
30,3,27,3,18,1146723,61091,142,34624,461
24,21,3,0,24,2032343,0,10,4929,454
22,7,15,7,17,471993,389023,76,5628,462
19,17,2,7,7,1375032,27786,15,0,463
6,4,2,3,6,37233,19277,39,10233,501
10,6,4,7,13,71961,125580,207,41745,449
9,5,4,2,13,13706,8231,54,7701,468
4,0,4,1,14,0,8290,5,13199,562
41,19,22,2,21,551647,937,11,3845,421
49,15,34,13,8,103958,108503,610,64768,475
22,12,10,9,13,141993,44486,158,5326,439
15,6,9,1,16,33609,344,34,0,567
12,5,7,0,8,57491,0,0,363,625
15,3,12,2,11,35862,8682,35,6255,490
14,4,10,5,13,307114,74685,46,18216,442
4,2,2,2,4,4037,4037,38,0,520
18,11,7,1,4,41475,1123,22,1879,570
20,13,7,8,12,105034,102107,128,1733,495
17,12,5,5,20,132329,2836,41,693,529
17,6,11,4,8,50543,19963,159,13598,467
7,5,2,4,7,31646,31646,10,4145,408
26,9,17,1,21,1624920,2995,0,0,664
7,4,3,5,4,297612,297612,98,0,449
8,6,2,2,11,453512,6574,50,7320,533
12,7,5,5,7,367274,30810,40,0,505
10,7,3,7,5,65167,38605,29,16321,465
9,3,6,1,11,46751,3762,38,7584,646
3,1,2,0,5,4593,0,7,7406,592
40,18,22,13,9,636361,331571,408,218767,453
14,5,9,4,18,220724,98826,47,17942,489
10,6,4,0,7,64835,0,1,0,640
10,8,2,0,5,201012,0,0,0,660
19,12,7,8,11,339149,67881,208,22719,435
6,3,3,3,9,9493,9493,66,4308,478
6,3,3,2,3,6138,5315,2,4666,532
8,0,8,0,8,0,0,0,0,612
9,5,4,8,7,50006,112740,156,24500,406
58,16,42,5,16,196006,41927,300,2586,474
7,5,2,1,5,7170,2418,75,2418,467
20,7,13,2,8,1206877,24200,144,20171,414
15,9,6,9,5,49517,54451,86,0,469
12,6,6,5,9,45362,7644,52,1454,613
6,4,2,4,5,12280,12280,48,2987,475
13,7,6,1,18,225821,8914,26,0,692
21,13,8,9,21,1310405,1179957,45,41581,531
9,7,2,2,11,111191,2953,17,0,467
14,6,8,1,17,273238,227,14,2900,538
13,7,6,1,18,120951,478,4,495,506
18,4,14,3,21,241087,25892,46,0,511
7,4,3,4,8,135091,135091,52,2857,503
49,4,45,3,18,53014,53014,52,7082,477
23,11,12,1,10,549880,390,15,106489,457
25,11,14,1,24,1138761,257,0,0,551
8,3,5,2,2,5847,4347,2,2240,553
13,7,6,0,12,77679,0,7,0,583
7,5,2,3,30,207807,12035,25,5405,464
28,4,24,4,11,9550,9549,195,7096,423
12,7,5,4,6,24404,24055,57,8744,420
26,11,15,10,16,371747,158741,235,39591,526
14,5,9,5,8,7975,9706,42,5801,474
10,5,5,0,10,43452,0,32,1132,538
13,7,6,4,11,150800,23165,53,1643,506
20,9,11,1,4,363372,22267,11,22267,606
18,6,12,3,8,29959,5319,63,0,540
5,1,4,1,13,1014,422,18,1737,520
2,0,2,1,3,0,4952,9,389,570
17,8,9,0,11,297380,0,0,0,563
7,2,5,0,15,198,0,0,0,701
21,8,13,2,14,59967,4900,10,7870,586
40,3,37,2,8,18151,17156,0,0,465
8,1,7,2,11,19008,14889,0,0,538
21,9,12,9,13,110822,100730,5,9150,501
11,7,4,3,5,439911,161428,26,0,437
35,9,26,6,13,514074,150717,199,104879,427
4,0,4,0,5,0,0,1,0,593
10,3,7,2,12,4032,5829,41,612,622
17,4,13,3,13,288239,50047,66,2052,518
26,10,16,7,17,48310,45396,111,11246,430
27,9,18,7,8,263734,119893,59,27481,463
37,2,35,2,10,78518,78518,30,78419,456
10,4,6,3,9,19831,19831,124,6686,573
25,11,14,1,26,4366458,1910,0,7187,615
17,7,10,4,9,166787,43136,72,15120,435
40,4,36,1,5,17720,597,15,597,549
41,4,37,1,14,48655,26534,130,26534,529
12,5,7,5,8,22971,20144,91,38872,479
5,1,4,2,12,6447,13334,29,6447,598
18,3,15,5,15,405464,123590,28,58834,478
12,5,7,4,12,32595,26115,104,4579,498
13,3,10,2,9,7160,7160,50,6648,572
15,9,6,6,18,182544,178682,106,135926,437
13,6,7,2,14,318386,34233,18,1609,506
28,11,17,11,17,660482,343974,185,87913,394
8,6,2,6,4,33911,41011,186,19172,449
10,3,7,2,3,8863,8863,20,4883,632
19,7,12,6,14,77807,32139,95,4719,458
19,4,15,2,8,1262,130608,85,3437,455
16,4,12,2,11,14682,4687,12,3025,541
34,16,18,1,27,441039,7046,66,39286,516
14,10,4,1,6,713560,1035,0,0,436
17,7,10,11,8,1006279,978818,51,230453,450
4,2,2,2,9,5817,5817,28,3443,467
32,12,20,3,17,437911,15213,42,1475,537
6,4,2,1,6,271909,18276,29,0,622
6,2,4,2,8,72424,72424,6,1056,568
36,7,29,5,12,13372,11849,76,198400,443
7,4,3,0,69,361126,0,2,3286,658
31,8,23,5,17,452422,187515,44,14436,480
6,3,3,3,23,12670,29133,61,0,673
20,13,7,0,20,553223,0,77,13228,516
25,7,18,3,24,37402,24264,70,6072,444
26,7,19,9,10,667373,91520,45,10643,450
10,6,4,1,9,30911,4529,10,4529,556
63,12,51,3,20,112941,10813,72,13883,464
11,8,3,4,3,50992,27214,36,0,409
10,3,7,3,6,9187,10880,20,15837,409
8,5,3,5,11,28665,94490,86,20501,428
13,4,9,3,14,21265,19089,193,13352,515
19,9,10,3,18,40434,42670,49,35599,527
6,3,3,0,18,8256,0,34,1131,545
18,6,12,1,13,198671,966,3,2898,473
10,7,3,0,7,40118,0,69,490,484
7,4,3,4,8,11102,9533,38,1442,440
20,5,15,4,8,30991,23015,191,17301,471
9,6,3,0,10,34741,0,0,0,675
29,8,21,6,14,68195,28175,499,15758,440
23,4,19,0,10,116223,0,15,6076,588
18,10,8,8,25,944085,21652,202,6801,465
22,6,16,5,18,34969,24948,96,12920,481
4,2,2,1,12,14543,14543,17,21368,626
14,8,6,9,10,250817,259138,158,2415159,446
19,7,12,8,14,34486,64420,174,17323,460
6,2,4,2,8,1385,1385,24,1181,456
11,8,3,6,4,89882,82135,115,22592,439
8,5,3,0,20,205412,0,3,0,621
21,13,8,1,15,124018,124018,34,0,551
12,5,7,1,5,1134,1134,37,1134,456
6,4,2,4,8,41359,36125,13,7081,474
12,5,7,4,23,979064,91875,61,34580,454
9,2,7,1,7,9173,9173,133,18045,538
10,8,2,0,14,363824,0,20,0,602
10,3,7,2,12,10827,4348,13,691,482
33,13,20,4,13,60897,23123,62,13394,411
27,4,23,3,17,380878,43244,49,27115,493
20,9,11,0,14,940471,0,2,0,490
16,9,7,4,15,888152,836261,74,524943,468
38,5,33,4,14,39522,34905,125,16840,615
12,4,8,4,11,64590,82611,54,50086,430
32,13,19,0,13,2407730,0,3,1249,669
78,4,74,1,13,14573,3547,61,16072,582
19,9,10,0,13,925449,0,2,0,648
6,3,3,2,7,22808,21842,40,21326,487
19,9,10,0,7,389408,0,9,0,606
16,4,12,3,4,45373,12978,208,1857,481
37,6,31,7,18,75308,133179,96,35679,562
22,11,11,6,29,181877,40120,68,15211,533
18,13,5,0,12,737143,0,7,378,537
27,11,16,9,21,826244,392302,185,14122,454
17,10,7,10,18,698050,226210,32,32816,453
8,4,4,1,16,7250,7250,16,7250,600
24,2,22,2,9,12601,12601,0,0,602
14,5,9,0,9,144435,0,3,2400,632
18,6,12,2,10,200973,8829,41,0,526
13,10,3,6,22,1745663,144169,128,20760,489
6,4,2,0,4,1040,0,0,0,651
7,4,3,4,13,29013,44600,27,20166,457
8,3,5,0,6,20987,0,48,5065,602
6,3,3,2,7,15550,11438,17,657,463
8,5,3,7,4,46992,95904,145,28544,445
18,11,7,7,12,196892,126361,12,2760,446
36,6,30,0,18,354173,0,18,4792,595
7,5,2,4,4,19045,17894,43,0,492
13,10,3,2,18,132295,21605,14,0,421
11,5,6,1,8,26721,971,17,971,564
23,13,10,5,11,601835,7963,49,524,460
12,3,9,5,12,29452,15725,83,1338,491
4,2,2,1,6,1981,1698,10,1698,613
26,9,17,0,11,496724,0,3,0,623
25,9,16,0,14,74789,0,5,648,684
20,5,15,4,24,48119,48119,56,35307,533
18,13,5,13,8,39607,35968,710,4906,447
7,2,5,2,19,17003,17003,31,16371,426
8,2,6,1,6,7550,550,9,4386,438
16,10,6,3,15,216059,20026,70,1332,497
4,2,2,2,3,11777,11008,40,0,424
17,12,5,0,8,327078,0,18,1150,592
9,7,2,4,7,26777,33878,57,3270,538
11,7,4,4,16,315053,116404,72,0,451
8,5,3,4,5,17990,18413,27,6786,474
24,14,10,0,9,1399373,0,0,0,439
28,6,22,1,14,51055,1237,17,1857,495
13,8,5,9,8,139159,229597,139,100554,385
35,21,14,0,25,1498170,0,14,2872,646
35,6,29,2,16,28490,2282,128,25320,435
13,4,9,1,15,10312,2564,10,2565,528
22,15,7,12,8,398085,265768,252,20109,446
12,10,2,1,17,387014,604,22,604,491
23,9,14,13,18,945958,1074721,133,242624,447
19,13,6,10,11,281509,265395,180,112848,417
6,4,2,3,8,208820,21692,46,14001,478
18,5,13,0,20,172928,0,20,1221,623
6,2,4,0,11,38005,0,1,860,507
10,8,2,1,20,27294,14698,32,14698,400
3,0,3,1,5,0,1594,14,0,583
28,9,19,0,36,126066,0,65,3650,561
15,7,8,1,16,356903,23686,20,204,575
13,9,4,9,12,31821,31821,38,7380,442
35,6,29,3,9,73114,10466,82,2547,493
11,4,7,3,18,363318,53787,33,22588,487
27,6,21,0,6,108073,0,13,4636,606
17,8,9,2,11,209348,22315,39,16882,513
12,6,6,9,30,758983,1117677,215,216465,435
88,9,79,5,16,94302,22050,57,21170,525
10,3,7,2,10,11637,3446,34,2211,484
28,19,9,5,9,635359,19273,29,8239,385
7,3,4,5,6,37580,30302,27,11754,472
13,6,7,6,27,80100,78751,44,12505,511
46,5,41,5,15,361474,144925,85,93675,529
18,9,9,6,11,309282,106353,25,25240,438
14,11,3,9,9,142255,164755,179,102780,448
10,7,3,0,8,611227,0,29,0,459
14,2,12,7,19,26779,67180,49,0,643
34,16,18,8,11,2180248,621292,0,0,466
31,13,18,11,15,625409,371375,0,0,509
15,9,6,0,9,748419,0,5,1270,616
19,5,14,2,10,322284,23354,42,18580,461
6,4,2,1,15,296722,27092,8,780,530
14,2,12,1,10,11939,11939,35,11939,506
10,6,4,3,18,92707,16304,18,29378,468
9,1,8,0,9,0,0,22,1642,651
32,16,16,3,20,661905,4143,57,1504,434
13,2,11,1,5,45945,2525,27,21178,589
6,3,3,0,11,8582,0,10,66,537
5,3,2,0,2,65683,0,123,1523,568
11,7,4,5,12,1133827,38572,100,0,459
17,11,6,7,12,246173,22413,247,7429,507
5,3,2,2,14,37514,37514,127,3826,548
13,5,8,1,9,475669,830,23,0,543
25,12,13,0,13,272013,0,0,0,600
15,13,2,1,6,788778,504,30,6249,537
57,10,47,7,35,80109,42536,343,19260,459
13,10,3,9,8,29169,29169,115,12244,495
20,13,7,0,7,154746,0,21,267,639
17,11,6,5,6,49584,32697,23,11370,478
21,6,15,7,9,31768,50660,88,18892,467
41,7,34,1,9,91005,446,73,1186,513
13,11,2,0,11,93822,0,0,0,621
21,11,10,1,11,173848,75,3,0,576
11,8,3,0,15,366133,0,1,3360,544
8,5,3,1,9,107087,918,3,368,591
11,7,4,5,9,46761,44137,325,25109,420
15,9,6,5,10,86079,74679,100,36476,428
7,3,4,2,8,48248,16666,39,0,522
10,7,3,3,4,54728,3448,30,0,488
4,1,3,0,9,0,0,11,597,723
14,6,8,0,12,479496,0,26,1090,579
39,25,14,25,12,522175,451557,397,61106,450
31,13,18,3,9,116494,10472,43,5406,485
14,8,6,2,9,700548,24754,16,2951,573
17,7,10,4,28,355045,121137,47,0,530
26,5,21,6,9,114912,21584,86,7385,455
45,18,27,7,9,240177,76581,147,35,517
4,2,2,0,12,4117,0,1,16682,676
11,5,6,2,10,471785,20832,0,0,528
22,4,18,3,19,26193,26193,78,4930,468
23,9,14,9,12,79574,59033,123,23613,478
23,13,10,0,12,956088,0,0,0,591
18,11,7,6,16,359221,100434,48,0,480
23,10,13,6,10,62678,26002,60,25984,451
6,4,2,4,8,22225,22225,13,5460,415
20,10,10,0,7,135517,0,0,0,625
45,17,28,9,11,1894656,1350133,9,131178,465
27,11,16,7,11,105706,67798,101,25253,431
11,5,6,0,7,36225,0,8,1466,500
32,11,21,1,15,835252,3230,22,3230,521
16,10,6,1,8,50211,37,2,297,595
33,3,30,4,12,1962,7279,26,1694,443
20,9,11,8,14,681360,200049,133,18067,486
10,5,5,3,12,35823,28486,178,8623,478
17,3,14,0,9,22592,0,33,3135,519
5,3,2,3,5,11501,24600,74,0,607
50,9,41,8,28,60271,62191,124,54268,434
31,12,19,9,11,335417,38752,64,14163,443
28,15,13,10,13,263746,57466,91,10383,388
19,5,14,2,17,24155,23937,19,19801,517
39,5,34,8,18,39179,82418,125,34690,474
14,4,10,5,13,303607,106295,22,42769,409
23,10,13,0,22,691315,0,21,221,660
4,2,2,2,18,162946,4906,0,0,628
33,1,32,0,8,7021,0,0,0,667
36,10,26,7,14,655354,33653,47,8681,451
25,11,14,1,16,286879,30770,41,4398,532
4,1,3,1,5,254240,6696,12,0,611
25,5,20,1,15,18736,972,194,6395,501
22,9,13,5,7,56510,19512,94,4730,460
24,4,20,1,19,21215,9260,0,0,562
16,7,9,0,18,139219,0,3,699,577
10,7,3,7,10,206244,293539,160,439,494
52,11,41,9,22,287496,100046,175,8555,417
12,8,4,0,6,240861,0,1,0,605
8,1,7,1,16,5766,5766,96,8216,499
21,7,14,4,20,126344,109109,83,41564,536
3,1,2,1,6,5412,1820,24,1820,510
11,4,7,2,24,802685,63829,20,51007,442
38,10,28,8,18,121699,111236,85,18311,465
9,3,6,3,11,146867,97776,43,86654,450
10,6,4,4,10,291486,136482,49,31213,387
8,5,3,3,12,19102,24336,34,14581,470
39,17,22,10,16,113913,113306,207,26806,418
24,7,17,7,7,63762,57131,54,16882,447
26,9,17,3,13,209851,58323,129,5400,509
14,10,4,1,9,713067,22709,8,0,502
15,8,7,4,7,32146,25901,75,9121,438
49,6,43,4,18,569480,33752,47,16348,395
18,8,10,2,9,155209,3328,41,1614,463
6,4,2,5,10,385279,20138,53,4239,515
58,8,50,2,9,40522,193,165,2161,531
35,10,25,11,11,80777,80776,224,17201,440
43,19,24,18,38,84985,62369,270,6960,420
34,7,27,4,24,172562,27359,486,24655,424
15,8,7,4,16,35139,16817,55,14361,568
13,7,6,0,12,195892,0,5,0,583
7,3,4,2,9,12418,4853,33,4507,517
26,7,19,2,13,120689,2783,40,2880,551
5,2,3,0,8,313433,0,12,0,582
13,2,11,1,17,3883,3883,25,6721,513
11,6,5,2,10,316353,8380,45,0,632
14,6,8,6,8,152066,125230,99,0,545
15,10,5,7,11,86511,79455,0,0,450
5,2,3,1,8,25000,8466,16,0,491
10,6,4,0,14,47416,0,21,0,610
15,4,11,5,8,25324,41859,73,12129,425
12,7,5,3,10,416500,171065,79,0,529
14,9,5,0,19,537753,0,11,2480,619
7,3,4,4,6,20518,20518,308,8664,496
79,14,65,14,19,175838,101556,234,32755,422
31,13,18,9,14,59072,33925,176,8907,455
42,16,26,14,7,187140,132086,155,2560,440
14,6,8,4,13,582980,44877,67,1251,521
14,9,5,3,19,60589,12762,44,841,533
10,2,8,3,11,98376,97559,48,608,462
41,8,33,6,18,350368,51649,86,40999,398
17,5,12,4,7,11586,3315,35,1931,464
27,12,15,12,8,56990,58814,221,13316,437
7,5,2,0,11,101298,0,13,0,524
15,5,10,5,6,141537,110897,90,1588,467
12,6,6,7,16,41572,61528,135,2072,497
16,7,9,4,14,138343,57952,89,25289,515
24,12,12,2,14,614619,11658,15,1535,571
5,2,3,1,8,10941,5613,37,0,507
6,3,3,4,7,51063,51063,9,35214,456
2,0,2,0,9,0,0,0,274,598
23,8,15,0,16,29141,0,11,4508,505
35,16,19,12,10,121188,111187,281,18469,410
44,24,20,24,21,494645,540669,226,98708,421
7,4,3,4,6,39689,43938,34,16271,545
8,3,5,3,8,15150,20129,62,232,572
14,4,10,5,9,689035,34641,72,23772,480
8,5,3,4,10,183431,57740,73,0,529
19,4,15,4,8,40052,57233,29,17047,463
4,2,2,1,6,9336,3057,0,0,518
21,8,13,0,19,32777,0,27,1100,604
7,5,2,4,9,48893,24709,184,10077,463
18,3,15,0,8,2915,0,214,27049,637
19,12,7,0,12,2082045,0,0,0,696
11,5,6,2,9,82926,6882,47,1435,462
25,8,17,1,8,279416,5813,31,0,576
19,9,10,6,8,37489,34228,91,761,493
9,5,4,4,4,350174,5203,129,2107,433
16,6,10,0,10,134719,0,17,710,537
15,9,6,9,9,22346,23819,64,4499,415
24,10,14,0,13,165887,0,2,1253,581
8,3,5,1,9,148344,1,2,0,587
7,2,5,4,7,3966,6002,46,0,535
37,11,26,10,9,173783,125480,188,16478,507
6,4,2,3,3,30402,30402,35,2861,449
12,8,4,9,11,258393,117129,89,11960,468
9,3,6,1,7,0,10262,40,0,551
15,8,7,3,18,117426,187607,27,546,615
3,1,2,2,19,518865,80447,0,0,573
12,3,9,0,9,201967,0,2,0,622
6,4,2,0,7,8619,0,0,0,692
18,9,9,0,20,1008326,0,0,1,606
21,9,12,2,26,697692,451610,47,112596,524
6,3,3,5,14,237038,275904,73,38866,519
12,7,5,4,9,32122,26105,80,14056,412
13,6,7,5,12,75254,23765,63,1714,474
14,7,7,5,6,22276,14156,91,6720,489
36,5,31,3,10,38032,4774,125,2645,460
35,12,23,5,22,1405057,61953,93,8255,518
12,9,3,4,16,1474208,28397,34,0,486
10,5,5,1,5,74924,27594,25,27594,557
15,7,8,9,12,45972,73534,65,15243,425
12,3,9,2,13,375583,59229,26,57595,475
8,6,2,3,17,428561,49575,68,1264,489
11,8,3,5,19,282953,125286,63,37456,436
39,13,26,7,22,187386,163824,125,12028,437
15,7,8,5,16,109036,42157,30,16275,519
9,4,5,0,6,17253,0,131,685,528
42,9,33,6,11,59814,59325,288,35512,434
7,5,2,3,14,72450,15677,22,0,457
14,11,3,4,11,615005,28172,53,1443,479
4,2,2,0,11,630,0,0,0,648
27,8,19,0,8,154616,0,22,5269,567
12,4,8,3,5,1975,5334,98,2878,487
24,10,14,6,11,103281,10341,198,6047,415
32,10,22,2,13,493592,1584,32,1971,404
16,2,14,2,12,7225,5348,19,4555,640
13,7,6,2,9,769346,1026,9,5637,464
3,1,2,0,14,970,0,0,2395,636
27,8,19,2,8,38117,573,49,1487,494
10,3,7,1,7,36548,31977,53,31977,556
8,4,4,0,5,8470,0,26,501,690
7,5,2,2,9,16143,7437,34,456,633
20,7,13,2,11,125868,4331,64,4646,501
11,4,7,1,9,27947,91188,0,0,516
10,6,4,1,5,61589,1431,8,1431,514
4,2,2,3,8,28502,28502,13,17852,462
17,10,7,7,12,301614,154578,0,35,458
13,5,8,1,12,482148,89083,3,1275,595
10,2,8,3,11,6223,20181,43,4023,630
15,5,10,2,8,30784,14917,76,8348,505
18,11,7,9,15,2421523,1751387,189,222745,419
22,5,17,2,7,41692,5198,59,2644,615
7,5,2,6,6,29631,37512,105,9452,427
13,7,6,3,10,136829,80973,45,6669,562
9,3,6,2,13,122997,122975,55,302,648
5,3,2,3,8,7121,7121,119,3280,625
9,7,2,1,19,314953,129983,26,129983,536
10,8,2,8,9,33140,26858,68,10042,404
33,9,24,1,20,2682734,67,26,1077,581
6,4,2,2,7,13309,26105,0,0,523
10,4,6,1,13,251377,2811,5,2811,576
13,6,7,1,11,226592,2668,0,0,462
15,12,3,9,10,473891,46644,106,17146,356
5,2,3,3,5,8608,8608,47,3020,509
38,7,31,6,9,28670,21071,49,9991,440
5,3,2,4,6,2021,8125,49,284,451
20,8,12,12,8,72191,97629,159,17954,406
23,17,6,13,17,456858,371232,76,327,434
20,12,8,0,15,5471644,0,3,0,628
25,10,15,1,7,26775,443,48,2000,439
21,3,18,4,10,37050,33484,95,12028,472
7,5,2,4,5,27394,15107,13,4322,450
30,9,21,5,7,51480,51429,100,8080,488
3,1,2,2,6,7908,12601,193,10818,617
7,3,4,4,14,20152,29036,48,7753,510
14,4,10,0,11,627395,0,5,2257,698
6,2,4,2,7,7966,185833,0,0,666
19,5,14,8,14,134408,187255,4,4548,458
8,4,4,4,18,25701,25701,76,10789,444
45,8,37,0,3,17710,0,4,1649,518
8,6,2,4,8,160184,134122,72,0,466
5,2,3,2,15,31829,7660,19,6298,500
7,3,4,2,8,6811,6811,37,238,462
15,12,3,11,10,83598,103188,337,33278,411
10,2,8,1,9,80534,11602,23,11602,585
10,6,4,3,10,22174,20645,286,17396,533
13,7,6,0,14,152656,0,1,2286,613
4,2,2,4,4,93512,145869,60,70210,480
15,10,5,1,13,2977431,83334,0,2671,470
8,2,6,2,9,33769,33769,41,31743,556
9,5,4,1,8,54563,7537,17,4479,522
9,7,2,9,4,92826,92826,83,5695,425
29,11,18,1,11,596681,6286,27,6286,531
4,2,2,2,10,331086,11254,41,0,545
15,6,9,0,26,102578,0,1,2976,686
12,3,9,3,9,6322,2298,4,1115,470
6,2,4,1,12,7528,7528,0,0,545
19,7,12,2,13,229366,7355,51,3431,521
8,3,5,2,14,16435,6685,5,2230,612
26,11,15,7,14,540921,23306,107,9121,426
25,4,21,0,14,139529,0,0,1493,632
9,2,7,4,13,39211,38938,81,18479,435
24,11,13,4,21,475363,23785,57,1699,480
47,10,37,8,9,780837,59581,226,10616,407
7,3,4,1,9,5996,4900,42,1386,540
15,6,9,3,12,18791,16122,0,0,434
12,10,2,5,10,40249,26389,58,11745,487
35,10,25,0,8,15132,0,59,1350,578
20,5,15,1,12,454450,5884,40,685,628
10,7,3,5,8,311648,90590,77,751,483
6,2,4,0,8,38865,0,0,0,602
11,9,2,5,8,20943,12029,327,14696,494
13,10,3,8,11,171351,151267,148,354,502
6,4,2,4,6,9007,9007,17,2404,413
23,6,17,4,7,70428,15212,127,9841,504
15,12,3,2,13,373771,28768,24,11358,522
20,10,10,3,7,63071,26301,37,9854,466
13,6,7,2,12,154239,2537,42,8375,497
12,5,7,2,8,351900,33429,39,14603,498
9,7,2,1,7,412913,562,11,63,481
12,5,7,2,14,263093,6577,7,0,498
11,3,8,3,9,14307,15394,51,14277,465
17,13,4,2,69,355955,35995,26,35615,566
5,3,2,0,9,2437,0,0,226,621
16,4,12,5,15,27219,27219,120,10049,513
19,8,11,0,6,37237,0,40,0,508
15,4,11,3,7,46872,24519,43,13011,459
42,4,38,0,19,80380,0,291,4422,688
9,5,4,3,10,31504,606,51,447,571
12,4,8,3,8,23675,8872,181,3228,530
8,4,4,0,9,106227,0,2,2115,620
16,7,9,3,11,270654,3067,59,1350,501
12,6,6,6,11,35598,31037,79,1856,471
11,7,4,0,5,73750,0,48,2201,550
7,2,5,3,9,6211,20599,19,6211,604
6,3,3,2,21,37388,33695,49,28922,569
16,3,13,1,10,18947,18947,0,0,595
13,4,9,0,8,326273,0,9,0,672
26,4,22,1,9,23460,1899,5,1899,577
59,7,52,7,13,242031,240722,49,43558,470
5,3,2,3,11,19101,19101,66,0,500
15,5,10,3,5,135350,5338,8,0,475
22,3,19,2,7,52679,18047,42,1297,543
8,5,3,4,13,94105,48185,87,0,520
9,7,2,4,20,85369,77937,51,44689,465
16,7,9,4,12,97824,50815,0,0,504
15,8,7,2,8,66083,27101,46,23946,465
7,3,4,3,7,34611,16467,34,0,544
22,11,11,7,8,74901,25666,241,18664,462
8,5,3,6,6,27150,22924,87,5140,449
18,7,11,5,15,287865,105929,81,66371,450
12,8,4,3,14,536426,98053,38,13952,472
28,6,22,1,17,71939,1316,19,3281,534
18,5,13,4,8,22185,19698,103,4530,427
7,4,3,0,10,46484,0,0,795,512
30,11,19,9,14,1489838,1759296,200,0,459
29,13,16,0,16,179659,0,36,3802,468
21,10,11,4,19,1425425,1361913,106,0,518
8,5,3,4,8,111597,110937,151,61923,502
9,3,6,1,11,11895,1272,5,0,508
9,4,5,3,6,26074,2928,94,1800,557
10,6,4,6,13,30840,42073,87,13049,438
3,1,2,2,7,10526,10526,41,1400,535
15,10,5,10,4,56210,63078,269,31488,431
2,0,2,1,9,0,18988,8,0,640
11,7,4,2,7,141595,5449,52,584,543
20,8,12,6,8,32130,22124,187,12250,480
9,6,3,6,9,48986,48985,57,25400,465
8,3,5,2,12,218362,24662,38,17278,557
39,7,32,0,7,102263,0,0,0,615
9,6,3,8,8,72034,93823,228,27398,489
11,6,5,8,13,585563,79031,77,6135,458
28,12,16,11,10,1776801,557658,179,3720,496
22,16,6,14,5,274357,165679,141,13476,343
35,7,28,3,13,42179,18382,108,0,481
12,8,4,3,8,335927,7402,0,0,518
20,14,6,1,11,1884591,784738,21,0,491
26,11,15,9,13,241261,200666,190,104412,409
14,7,7,7,18,28365,35393,58,5690,426
7,4,3,1,4,209140,292,6,0,559
5,2,3,2,18,134318,18232,18,1778,454
19,11,8,11,10,40287,39023,142,12525,495
9,5,4,0,10,269076,0,17,0,661
7,3,4,4,10,1942929,317863,65,0,512
45,13,32,14,9,92264,81785,176,19727,414
5,2,3,2,3,7262,1951,11,1053,499
11,7,4,4,8,23099,23099,71,5938,435
8,5,3,4,6,113270,9612,21,4819,436
11,6,5,2,3,66882,10317,10,0,457
10,6,4,0,7,183880,0,2,314,584
18,5,13,6,11,241698,10294,116,3681,566
12,6,6,2,15,34192,16419,27,9260,545
32,5,27,1,16,40378,9340,50,7627,623
17,5,12,7,12,55651,72163,114,1341,469
14,5,9,4,25,460857,22923,61,5846,477
11,3,8,1,10,9740,1019,3,0,532
13,6,7,4,15,88648,49393,99,2520,447
26,13,13,0,30,462666,0,2,0,684
24,9,15,9,20,59163,54205,290,27172,458
10,7,3,1,19,150298,1163,22,1316,496
80,15,65,12,10,73921,58924,332,20567,432
12,10,2,0,11,249219,0,3,450,521
18,12,6,0,9,1130167,0,1,0,625
26,8,18,3,10,123241,44575,42,0,490
24,2,22,1,10,383576,8882,1,5231,631
43,6,37,4,16,50832,5762,388,4274,449
9,6,3,5,15,33374,61362,126,0,473
6,4,2,2,11,27349,23655,16,11763,425
10,8,2,3,10,17859,8743,32,831,468
18,7,11,4,14,147881,139195,110,107343,544
13,5,8,7,7,82937,57722,358,7733,470
8,5,3,2,9,8518,7390,28,5087,534
3,1,2,1,17,477,477,3,7346,523
15,12,3,12,18,548588,261140,0,0,449
5,3,2,4,10,12199,18576,88,6838,446
166,13,153,6,22,407101,35524,211,24464,479
59,19,40,14,15,304289,243255,121,42909,496
30,22,8,0,8,1524084,0,24,2127,531
5,3,2,0,13,13642,0,0,0,644
12,7,5,3,17,227461,26818,0,2315,507
3,1,2,2,7,5348,13988,0,0,486
23,9,14,3,4,58972,628,1,29,551
17,12,5,4,14,71861,24265,63,851,474
21,6,15,3,8,16560,536,178,2129,539
8,3,5,1,8,106119,8551,32,6108,561
14,11,3,7,8,493410,228043,159,75727,413
17,7,10,6,18,38033,44836,241,29793,513
14,3,11,0,11,162247,0,6,0,584
8,4,4,1,8,38948,6247,27,4358,496
19,11,8,1,8,23505,3061,109,3061,496
19,11,8,4,9,34279,11003,92,4282,489
9,6,3,4,14,55112,24899,13,1698,427
11,5,6,4,8,25903,25903,115,11091,407
26,3,23,1,8,500593,49131,165,4000,421
13,5,8,5,6,46514,9573,81,4526,445
13,3,10,2,15,566589,2533,43,120,507
21,12,9,11,8,99717,80912,281,16877,419
13,4,9,4,20,479700,183787,81,421718,440
11,9,2,0,14,97915,0,1,0,620
7,4,3,1,12,229007,228267,7,0,536
17,7,10,5,15,192150,188250,132,18052,449
19,9,10,8,7,91571,32627,151,14972,465
22,7,15,0,8,44725,0,27,2273,602
10,8,2,5,14,417684,123181,112,1778,441
24,8,16,5,13,36499,30615,78,21751,417
9,7,2,8,21,251643,290756,119,133579,483
14,7,7,5,13,47232,13327,19,10000,467
25,11,14,1,8,422134,3388,9,3595,455
16,5,11,5,12,73362,77974,118,28952,502
42,12,30,6,11,248130,33439,319,16670,442
13,10,3,2,23,1248623,14287,11,1086,459
30,8,22,2,4,53005,5004,40,119,488
13,11,2,5,11,672759,52162,150,21372,433
22,20,2,0,14,261554,0,0,0,658
17,5,12,1,10,83155,5089,48,1039,518
26,13,13,13,15,402714,76912,388,19450,437
12,9,3,6,19,363934,58964,22,0,470
25,8,17,2,12,712157,10188,3,2898,482
16,4,12,0,10,43989,0,11,425,539
12,8,4,8,28,342967,342963,117,52854,396
9,2,7,2,10,46863,46863,56,0,513
12,7,5,1,5,75133,5301,3,5301,482
83,12,71,3,26,318992,26182,139,2618,472
206,20,186,10,12,114176,31744,152,5921,429
7,4,3,2,16,57802,10010,20,9621,505
16,10,6,0,9,126035,0,22,137,581
30,4,26,3,16,123621,40521,198,2600,517
8,2,6,4,15,380849,123824,30,0,595
17,2,15,1,8,5787,2570,15,2570,539
15,10,5,8,15,309729,137582,134,42334,435
11,2,9,0,7,0,0,218,1722,445
39,13,26,8,16,1274977,467622,185,41482,457
18,8,10,0,15,395325,0,0,0,632
27,15,12,14,10,770805,215236,163,10991,440
11,6,5,5,6,114023,84788,284,13859,523
31,7,24,0,19,908489,0,54,3148,688
10,3,7,5,14,34801,46398,40,17727,478
28,11,17,13,34,580116,416959,304,8556,437
19,7,12,0,12,839440,0,1,35,606
9,4,5,0,5,16518,0,10,2883,497
18,9,9,7,14,441945,37692,119,15369,465
6,2,4,1,14,27964,18510,8,2946,618
11,4,7,2,19,5121,2328,52,1905,502
18,6,12,2,14,59496,31788,123,39516,521
12,5,7,3,9,13009,7933,31,1164,462
18,10,8,1,7,65931,179,30,737,558
7,4,3,5,7,81698,70160,61,5488,522
14,8,6,0,8,156010,0,0,0,585
10,2,8,0,5,46458,0,0,0,622
16,8,8,7,9,122659,69989,132,1301,514
23,9,14,7,18,779833,130110,0,0,499
24,7,17,1,16,6977429,45,2,45,629
25,12,13,5,9,84630,10941,21,4094,463
10,2,8,2,17,3600,34538,29,3087,569
13,9,4,9,14,295961,295961,169,16309,447
19,8,11,4,14,545796,344489,82,992,394
28,8,20,3,20,488306,17020,39,9216,430
13,5,8,3,11,169613,48739,57,4453,482
10,4,6,4,8,66195,43496,6,4720,398
10,7,3,0,23,248573,0,0,0,614
27,10,17,8,20,91188,51856,163,9997,421
7,5,2,4,13,114240,34672,56,2375,450
7,5,2,3,7,101943,44268,51,20862,510
12,5,7,5,9,17618,25898,41,2189,477
16,6,10,3,14,336874,24975,84,47184,439
3,1,2,0,1,1500,0,0,0,622
4,2,2,1,9,29057,9292,94,9292,507
9,4,5,5,7,11049,17874,83,1446,499
15,9,6,2,6,283549,1958,3,0,418
13,5,8,0,10,70474,0,8,352,693
12,9,3,1,7,399835,2540,8,0,560
6,4,2,3,15,25901,24571,31,0,437
6,1,5,0,10,0,0,1,512,673
13,7,6,0,6,81569,0,2,277,594
5,2,3,1,7,7990,2591,0,0,569
10,4,6,5,13,37566,39817,64,12070,564
7,4,3,0,12,144307,0,0,0,664
30,8,22,5,7,282845,26567,287,70942,406
99,7,92,7,18,552970,299015,60,9413,401
8,5,3,3,6,192717,13610,47,0,459
20,10,10,9,20,344838,344838,0,0,454
26,9,17,0,15,563167,0,0,505,683
22,7,15,2,9,44226,24559,81,13577,496
18,2,16,1,9,25543,1356,44,1356,643
43,12,31,2,18,172558,7191,110,5850,492
11,7,4,3,10,53483,7000,38,4979,477
5,2,3,4,7,16190,41904,191,8099,510
5,3,2,0,10,129465,0,8,0,612
28,14,14,9,7,248943,205966,180,39500,396
18,9,9,5,12,518581,14910,0,0,470
10,5,5,4,12,43917,15799,0,0,459
31,6,25,6,15,54603,159934,86,110300,472
10,3,7,4,9,9838,9838,181,4762,629
15,9,6,5,19,363879,49784,0,0,453
20,8,12,0,6,68444,0,0,0,578
7,5,2,3,5,25924,19845,10,2642,448
10,5,5,2,13,31461,17271,60,0,549
17,5,12,3,18,311926,8443,137,6670,465
12,9,3,1,6,241802,2772,8,0,567
35,10,25,8,14,71292,38303,454,10599,417
6,4,2,3,7,27331,9662,5,2155,497
9,3,6,3,7,27921,20828,114,17818,506
10,6,4,0,9,19315,0,3,848,660
11,4,7,5,8,21369,31622,322,10850,517
18,14,4,0,7,447976,0,3,348,569
9,6,3,3,7,15925,15323,3,690,450
11,8,3,7,7,340370,329814,113,45091,486
29,10,19,11,7,94270,94269,215,29228,456
22,5,17,10,9,383074,558134,169,187607,378
6,0,6,0,17,0,0,0,651,699
14,6,8,1,5,113640,42698,127,1652,526
11,7,4,6,22,383065,25562,0,0,465
9,4,5,1,8,10673,77375,2,1443,495
41,7,34,2,26,21133,7088,41,6621,461
38,7,31,1,13,20542,4122,23,21906,469
16,8,8,4,10,795351,10300,97,1731,474
15,6,9,3,7,57133,29533,129,15510,452
23,13,10,6,9,482811,86279,27,10657,487
50,6,44,4,19,142219,9571,25,8937,491
7,3,4,0,7,2630,0,1,1896,614
15,10,5,5,8,56942,6356,65,4336,506
12,5,7,1,69,62949,80090,20,1039,558
16,4,12,3,13,35639,35639,143,31347,457
15,2,13,1,17,3138,3138,25,2369,565
6,3,3,0,7,350012,0,6,0,573
10,5,5,5,11,22941,22209,7,36155,477
17,10,7,0,6,354731,0,20,2992,515
35,13,22,1,23,168751,13076,8,9238,504
14,5,9,3,7,4814,8443,18,3109,491
14,8,6,0,9,50478,0,3,2581,495
21,10,11,1,14,38070,12533,12,71,600
13,5,8,3,14,23235,13114,47,6909,536
111,6,105,2,16,5207,3503,57,6247,425
6,4,2,2,3,17418,7324,74,6924,437
7,5,2,3,9,14203,9610,106,12484,488
26,10,16,10,28,779461,444780,1,1403,454
24,14,10,0,18,241538,0,22,0,637
25,10,15,0,21,446214,0,38,4000,514
16,4,12,2,13,497389,377250,54,206492,461
30,1,29,0,18,15933,0,6,702,738
13,6,7,7,8,43646,33757,130,4882,494
10,5,5,6,13,316357,246618,114,5274,486
6,4,2,0,10,255589,0,0,0,602
44,15,29,7,18,1449552,74218,27,1978,527
9,2,7,0,10,16076,0,0,0,652
6,3,3,4,8,156985,213034,120,77917,534
28,18,10,8,2,292393,13899,89,5756,453
5,3,2,2,9,3705,2243,6,1767,477
14,4,10,5,14,216723,232174,142,0,533
13,5,8,2,9,19255,18950,53,0,490
15,9,6,6,12,652222,154431,93,53748,423
38,19,19,29,18,1802478,2785592,464,107957,398
21,6,15,2,19,546044,3652,27,2501,503
23,18,5,0,6,81855,0,24,306,614
8,6,2,4,11,185811,10830,32,6713,518
8,3,5,0,29,10352,0,6,0,623
6,0,6,0,10,0,0,1,0,558
14,3,11,0,18,18971,0,0,751,629
11,6,5,3,8,50324,21244,47,1141,434
22,3,19,1,12,120876,7875,3,7875,641
13,9,4,0,15,620035,0,1,0,661
12,2,10,2,18,147772,147772,33,39537,480
20,8,12,1,15,483494,198,3,199,517
7,5,2,1,5,41927,516,4,197,444
8,2,6,1,9,12177,1621,0,0,625
8,4,4,3,6,383608,30363,54,0,501
6,3,3,0,9,282361,0,0,412,622
13,6,7,2,7,39642,19855,48,0,621
18,5,13,3,14,411711,88259,23,4620,531
12,6,6,2,11,60379,551,91,1242,501
10,3,7,1,14,274771,1139,25,14790,467
47,18,29,17,11,96673,112492,457,14512,416
20,12,8,12,6,71251,34841,88,7625,429
16,6,10,1,17,770106,1139,36,1139,512
7,4,3,1,9,30332,597,11,597,468
29,5,24,5,13,49868,22705,125,909900,427
66,15,51,8,23,474124,33067,16,13372,544
13,7,6,2,14,120417,16068,71,515,525
12,5,7,5,11,31325,38632,63,11861,404
9,7,2,0,5,405841,0,58,1238,535
27,0,27,0,14,0,0,14,2655,675
6,4,2,6,7,65620,91454,108,36464,467
9,3,6,2,8,109554,53777,38,1451,523
5,3,2,1,13,3316,1179,18,2293,624
12,9,3,0,19,257458,0,1,0,602
20,3,17,2,33,55783,147314,24,12589,534
7,3,4,2,12,154812,7246,24,2140,597
13,4,9,3,12,21744,14988,43,4461,427
11,8,3,6,5,38496,31789,75,19100,438
8,4,4,3,14,281527,6510,51,5229,509
10,8,2,8,13,288206,37989,48,8930,414
9,2,7,0,12,154210,0,0,0,614
5,2,3,2,2,15603,407,42,1079,491
15,5,10,10,8,202312,316346,130,79878,398
44,12,32,1,16,112840,4132,5,8282,504
50,13,37,8,14,408856,101274,108,79055,424
9,3,6,3,10,581640,105074,44,7422,500
19,13,6,7,4,359870,58439,47,26700,411
22,7,15,4,14,56810,32116,42,3981,495
31,10,21,4,13,77643,7819,42,4222,528
6,4,2,3,7,312322,43914,32,18918,534
28,17,11,11,32,482433,455765,298,20291,474
21,10,11,2,18,49685,24369,61,0,461
7,5,2,3,11,28102,20700,66,6005,434
17,3,14,1,7,30136,1252,242,1455,591
8,5,3,0,7,16854,0,0,0,709
72,7,65,6,22,119317,111780,342,57986,465
41,11,30,1,11,169563,4044,0,0,484
23,9,14,8,9,53573,36991,82,0,495
29,7,22,0,14,210185,0,104,12855,595
7,2,5,3,8,17558,24831,0,0,475
9,6,3,3,5,246172,4986,86,943,460
30,4,26,0,18,145805,0,34,37540,604
12,5,7,5,14,403261,128082,58,69978,499
9,2,7,1,8,3951,3951,24,4571,485
9,4,5,2,10,3916,3916,15,3072,423
32,7,25,6,12,93585,63434,170,7880,443
28,18,10,11,22,1421593,456543,349,78284,477
21,14,7,15,9,320424,346441,224,65569,465
13,8,5,0,7,209075,0,0,0,553
12,4,8,6,11,24823,26215,23,13844,541
33,17,16,1,22,1312412,2324,29,0,615
19,8,11,5,8,43511,33168,72,216,492
13,6,7,3,9,120915,83666,30,0,566
3,1,2,0,7,8398,0,0,0,629
9,3,6,3,14,34229,20388,49,12699,475
15,7,8,5,6,188370,19235,46,0,488
40,17,23,2,14,2156045,9208,30,3996,418
27,12,15,10,9,198894,52248,96,5271,431
7,4,3,3,8,18152,16789,27,11666,405
3,1,2,1,8,10186,9914,9,9914,597
18,7,11,0,6,252724,0,4,2390,503
33,8,25,6,18,126258,124998,95,16130,446
45,6,39,5,16,329848,17652,14,7236,459
13,10,3,9,9,72725,47750,104,0,481
86,14,72,6,25,243288,72495,126,43273,507
8,5,3,6,5,28762,41492,113,2621,441
13,3,10,4,12,1020,5473,23,611,491
20,10,10,6,8,127982,4304,30,380,549
41,12,29,1,10,166525,543,54,5051,500
9,6,3,3,7,57800,16408,269,7928,506
60,15,45,5,11,179662,34072,108,15372,388
9,7,2,0,20,333685,0,29,0,598
9,3,6,3,12,41974,35965,57,18967,510
12,6,6,4,19,1110283,19223,108,2290,447
4,2,2,0,3,13355,0,3,900,492
28,6,22,0,11,25292,0,69,3439,572
28,15,13,9,18,206741,70029,67,16846,424
18,5,13,4,11,101286,75441,108,1031,563
27,8,19,4,14,150002,130445,135,4403,447
12,9,3,9,8,75831,41106,154,9940,425
11,5,6,4,8,28708,21780,77,10845,463
7,3,4,1,17,16136,10712,17,10712,572
15,6,9,4,13,374132,29812,74,23855,508
24,1,23,2,18,5497,14280,39,3465,526
11,4,7,1,8,2023,2023,10,14725,545
133,11,122,8,8,125954,20933,201,11189,500
18,8,10,6,8,58537,43838,25,7271,447
19,5,14,3,12,302798,15818,330,19280,455
13,9,4,1,4,23768,577,20,577,482
5,2,3,1,8,2288,4031,19,0,577
20,10,10,5,17,157863,19298,45,15457,457
5,2,3,2,2,20055,20055,11,12518,452
6,1,5,0,16,1175,0,0,657,610
4,2,2,2,7,883577,883577,52,0,527
7,5,2,5,6,1010526,214832,0,0,502
20,1,19,1,9,0,11672,92,11672,537
3,1,2,1,10,1582,1582,20,1582,644
11,1,10,0,17,0,0,106,10871,577
17,11,6,5,10,274288,32852,71,10274,445
19,6,13,3,14,349055,18534,42,367,555
45,4,41,4,9,990248,308785,109,5487,451
12,9,3,5,6,378631,8557,49,4046,440
37,25,12,25,15,2174438,1038821,470,107011,415
5,3,2,0,12,1594,0,20,0,572
8,2,6,1,19,37130,37130,22,37130,667
20,14,6,0,7,55014,0,11,5568,452
23,15,8,0,18,443468,0,4,0,689
9,2,7,1,7,349,349,49,349,576
151,14,137,8,6,61546,11091,71,7723,480
12,8,4,3,8,3194,590,56,250,584
33,9,24,9,18,463832,102517,114,28844,399
9,2,7,0,7,161393,0,3,0,645
10,5,5,3,6,11684,9451,0,0,439
10,3,7,2,8,28220,3820,66,3808,565
8,2,6,0,8,7614,0,16,2467,540
15,5,10,3,4,23527,7573,22,3271,455
11,5,6,3,7,35993,19651,99,14198,440
6,1,5,2,8,0,20208,25,933,660
24,11,13,3,13,58611,15582,54,2866,454
13,5,8,4,17,59045,39670,58,9485,466
8,1,7,0,5,37583,0,0,0,681
25,7,18,5,9,88604,44710,58,19796,490
8,3,5,5,7,23100,40039,0,0,477
13,4,9,1,7,54251,1409,17,2403,567
10,8,2,6,12,35951,37839,17,26412,427
15,4,11,4,13,406561,72715,3,740,526
30,4,26,3,9,69213,152507,19,1027,478
18,9,9,7,9,30050,15018,76,1818,439
11,9,2,4,12,83266,31499,0,0,455
7,4,3,2,8,18760,8411,111,7585,637
34,7,27,3,27,59443,14891,25,4307,506
10,5,5,0,9,40432,0,3,1543,528
12,5,7,0,18,627746,0,0,0,550
11,8,3,2,8,371914,3011,12,2547,573
9,4,5,1,5,32660,3000,12,3000,629
16,14,2,1,6,560340,2030,1,0,570
15,9,6,9,8,74311,85180,118,18093,439
11,4,7,3,9,16204,13204,34,6975,542
8,3,5,2,16,25862,25862,25,3453,621
10,7,3,0,8,613005,0,0,0,692
22,8,14,0,12,90024,0,18,0,524
13,8,5,8,11,8047,3393,171,1035,427
5,3,2,4,11,13684,29594,78,6829,538
16,6,10,3,18,75222,8482,117,2890,500
12,9,3,1,5,66482,1125,11,1795,528
15,6,9,7,10,237410,237153,94,193852,423
8,5,3,5,7,26079,26079,73,18731,447
25,9,16,6,13,149658,187736,118,90833,439
10,6,4,5,8,50940,52769,81,6248,569
24,3,21,0,10,182144,0,27,0,636
10,4,6,0,8,882375,0,0,0,606
2,0,2,0,3,0,0,2,743,641
25,6,19,3,13,252448,22734,15,225,435
11,5,6,3,7,53241,4622,52,3501,474
21,15,6,2,7,1288611,16587,3,0,475
6,2,4,0,3,31095,0,0,0,606
14,4,10,0,13,396017,0,28,13953,452
16,12,4,0,9,6731,0,27,0,590
15,8,7,0,12,261310,0,3,0,469
19,9,10,7,15,435374,97725,147,20936,464
8,5,3,5,14,66927,122798,93,0,529
58,7,51,5,14,139006,108098,99,101217,470
6,3,3,3,13,50688,20340,11,13892,465
14,10,4,0,2,649491,0,1,0,577
15,6,9,1,12,284617,6093,0,2107,482
7,3,4,0,14,219,0,3,569,693
6,2,4,5,10,155577,69035,33,9208,460
22,1,21,1,12,4535,4535,13,4535,563
25,11,14,1,14,431713,3423,5,5522,496
30,19,11,1,15,1527818,50,31,3378,511
11,2,9,0,7,0,0,0,0,613
10,3,7,1,15,251180,251180,37,251180,619
17,7,10,2,11,246920,236292,26,648,668
27,8,19,7,13,57677,59565,52,11556,426
39,9,30,7,69,734033,65699,283,26335,443
8,5,3,5,15,24567,24567,75,11360,538
26,13,13,0,18,535443,0,4,0,658
26,13,13,14,16,73738,61988,211,10994,414
71,9,62,2,11,506479,4854,42,3889,590
3,1,2,0,6,0,0,18,0,672
3,1,2,1,7,4280,4280,21,4280,623
17,7,10,4,9,292743,36327,67,17337,471
47,1,46,1,5,7698,1000,16,1000,557
8,5,3,5,8,26572,25403,98,10339,491
7,4,3,3,10,29648,5367,75,0,620
7,4,3,3,17,513558,17671,48,4888,457
10,3,7,1,17,5140,6851,12,6851,631
14,8,6,7,5,137552,135178,56,5118,437
6,3,3,1,14,83335,2184,6,0,667
34,7,27,6,9,24981,27563,370,15709,467
31,9,22,3,17,645545,26389,89,13592,477
23,12,11,8,10,66653,65915,316,8994,417
24,7,17,5,11,208369,42574,62,608,494
7,3,4,1,11,609802,64346,3,64346,584
15,7,8,2,6,44775,10070,48,1776,437
221,6,215,2,6,19492,226,9,165,467
9,5,4,3,8,60880,5175,21,605,503
8,4,4,1,16,28885,1164,85,4655,566
53,17,36,9,69,320712,39553,105,9430,446
10,6,4,6,10,75289,75289,101,8061,451
17,5,12,1,14,23796,424,43,5332,574
7,2,5,3,14,34789,41565,26,22576,487
3,1,2,0,2,7654,0,1,0,459
14,8,6,8,12,769716,413994,54,18901,439
8,5,3,6,8,32855,48541,118,0,458
6,2,4,0,14,25486,0,0,1040,718
24,6,18,1,17,276403,3996,35,510,548
22,7,15,5,14,315256,80437,83,50124,443
12,5,7,4,31,286106,31673,46,7296,465
5,2,3,1,7,11060,600,5,0,518
6,3,3,2,15,219417,44103,40,0,430
11,5,6,5,12,86044,86044,160,37664,348
6,2,4,2,8,368379,4947,26,1386,571
8,5,3,3,10,642604,78025,52,4439,462
16,7,9,3,7,36179,3383,51,1477,481
17,11,6,8,13,157106,155772,117,126780,438
16,8,8,6,10,68798,45294,54,17544,387
32,10,22,5,18,169595,41002,166,32247,436
7,2,5,2,15,13628,8676,46,8395,512
19,6,13,2,9,29012,12167,83,8800,602
8,6,2,5,10,30021,30021,134,9589,516
3,1,2,1,5,1386,1386,11,0,510
14,9,5,4,8,133666,4903,52,1052,427
6,4,2,4,5,23519,23519,77,8910,511
4,1,3,2,5,11588,19480,25,0,484
11,6,5,3,8,24221,21817,99,4769,521
7,5,2,1,8,39577,3016,22,0,648
17,12,5,0,8,69010,0,0,0,678
8,5,3,1,19,74942,8514,22,279,492
20,15,5,13,11,181465,265994,265,24002,486
6,3,3,0,17,3314,0,8,19526,580
28,8,20,4,15,745758,93944,80,0,431
20,11,9,11,6,302548,173704,168,3414,494
34,12,22,5,14,398442,80933,29,0,474
12,8,4,3,9,67682,37128,0,0,523
28,6,22,4,19,206145,96079,59,6699,431
8,3,5,1,19,276352,5924,23,5924,644
22,6,16,4,18,43277,29230,95,18050,469
13,8,5,4,10,11607,4658,29,1934,504
8,5,3,2,24,71364,67850,41,65430,517
13,6,7,6,69,69924,72034,124,10378,529
28,9,19,5,9,397920,53755,59,3541,523
4,1,3,1,8,19657,19657,0,0,481
24,7,17,3,17,373902,13449,151,15290,484
6,4,2,0,14,579583,0,24,0,532
13,7,6,6,5,141380,8098,40,5335,459
20,8,12,0,7,8031106,0,9,0,691
13,10,3,4,3,39043,8501,48,4775,358
35,9,26,4,8,95648,27505,53,9757,432
13,6,7,3,9,294023,11721,88,3317,474
16,7,9,5,9,97869,49974,5,7018,505
11,5,6,8,7,67134,62719,69,11153,432
21,4,17,6,9,35457,36341,165,19761,475
13,3,10,1,13,5396,5396,59,5396,629
28,4,24,3,8,57483,56444,52,4202,501
18,5,13,0,18,218667,0,94,33129,401
12,7,5,7,10,30726,55563,299,14817,388
15,8,7,4,26,46624,30645,107,2388,611
10,3,7,1,7,20137,7575,0,0,607
7,2,5,0,9,545,0,5,0,637
22,10,12,9,9,278275,55591,551,16259,510
7,4,3,3,4,25856,24797,17,14076,440
17,6,11,3,27,22736,6889,19,5356,509
12,5,7,2,7,394875,5888,59,0,489
9,5,4,0,7,61181,0,0,0,546
95,10,85,6,8,90327,32524,64,14071,451
13,7,6,2,19,272309,11981,46,6633,444
32,4,28,0,13,78395,0,1,1922,637
19,9,10,7,18,638041,280995,109,17757,515
8,3,5,1,10,0,13797,0,0,606
15,10,5,11,13,167393,172025,74,23180,414
11,3,8,1,17,3860,1347,13,1347,566
26,8,18,4,13,86114,70299,31,19445,386
42,22,20,0,16,2446131,0,14,0,516
24,7,17,7,19,59483,26532,81,9880,438
6,4,2,1,11,216918,4630,22,4630,641
7,3,4,3,5,22058,23537,20,12239,475
16,3,13,2,13,217161,10812,66,3590,655
7,2,5,2,10,17920,17920,33,12970,504
10,7,3,7,13,34723,44465,86,19283,534
8,6,2,5,10,61158,48576,27,1284,473
33,7,26,6,10,50070,22439,92,4417,419
37,12,25,2,7,69861,88,379,892,597
10,3,7,2,14,39236,39236,60,1132,564
19,4,15,0,11,19170,0,261,22955,494
16,10,6,8,23,874271,282726,186,6520,458
13,2,11,2,8,26610,26610,57,13820,588
16,5,11,4,15,5305,2639,0,1974,528
3,1,2,0,14,0,0,0,0,784
5,3,2,4,12,74709,80391,55,57351,639
24,5,19,4,6,204415,20021,4,0,487
10,5,5,0,3,93833,0,11,0,485
17,11,6,0,13,847707,0,0,0,633
31,13,18,0,3,93551,0,2,598,598
6,1,5,0,10,0,0,0,0,590
20,7,13,8,9,66961,63984,141,57036,419
31,5,26,5,14,42621,52408,110,11130,562
6,4,2,3,8,71192,35511,68,0,496
20,10,10,7,19,301893,15851,43,6985,414
16,3,13,3,11,398436,48612,46,11350,556
18,9,9,3,14,28958,44738,86,10836,564
8,2,6,4,9,8460,22730,70,8460,520
45,9,36,2,14,153120,19550,41,13194,593
66,10,56,2,15,138343,9708,92,3411,520
12,9,3,1,9,306557,10715,40,0,511
12,5,7,0,15,176296,0,0,208,698
19,6,13,6,11,21421,21421,79,7629,444
27,12,15,10,5,54055,61371,158,18859,482
27,4,23,1,14,6452,837,19,2422,497
9,4,5,2,19,30714,5445,49,4826,486
8,3,5,0,6,38136,0,2,0,573
10,7,3,5,9,331279,14463,76,5712,460
76,20,56,8,18,825726,185059,217,80976,450
22,4,18,3,16,24137,27982,0,0,589
87,13,74,5,16,408860,17879,48,6443,474
11,4,7,4,9,53756,53756,42,28628,446
8,3,5,2,14,6151,900,17,345,690
10,2,8,1,6,5948,5948,8,5948,684
27,7,20,2,7,15180,945,132,2015,480
12,6,6,4,9,396220,10819,125,5218,378
6,4,2,5,7,20209,30980,112,693,513
30,11,19,1,10,882401,5796,33,2230,489
24,10,14,5,11,108073,43040,70,25123,480
11,7,4,0,11,573200,0,3,349,607
20,11,9,0,9,471969,0,13,0,580
11,8,3,0,10,482866,0,6,0,586
18,8,10,7,14,71582,77154,96,13780,438
14,12,2,7,8,279277,81705,95,18330,508
4,2,2,2,6,14282,12461,70,0,511
3,1,2,1,8,4381,4381,7,4381,599
28,5,23,5,13,41482,44998,43,3443,581
8,4,4,4,8,117617,117617,38,6402,439
8,4,4,3,8,38325,1986,63,1345,579
69,7,62,4,13,148414,203918,98,4484,524
11,6,5,0,11,101087,0,0,404,596
11,5,6,8,11,242454,388355,39,1250,466
8,4,4,1,7,172708,461,27,2455,543
10,3,7,1,8,1866,802,7,802,539
37,17,20,3,9,510396,4657,61,7462,582
15,10,5,10,12,880407,236230,182,1961,523
22,4,18,3,8,490109,8938,50,4779,494
12,4,8,4,7,14071,5486,18,620,453
8,6,2,5,13,47379,49272,80,8520,519
17,7,10,5,14,19023,11891,28,3974,493
15,11,4,13,6,26601,45092,318,14171,491
7,5,2,0,4,185371,0,10,0,603
8,5,3,0,4,171391,0,7,587,536
8,1,7,0,10,29008,0,23,3465,605
24,11,13,1,8,455537,895,4,955,543
9,6,3,0,9,67394,0,0,0,682
16,7,9,7,9,227647,222188,159,82457,511
54,9,45,6,6,71145,27243,166,16501,439
6,0,6,0,11,0,0,0,0,625
5,2,3,0,20,234302,0,23,1207,591
8,2,6,3,13,9189,67078,55,8637,547
6,4,2,0,5,26965,0,24,0,556
15,5,10,3,8,48892,46119,42,1591,466
5,2,3,0,10,25927,0,8,581,571
6,4,2,4,18,286695,29992,49,7737,465
13,9,4,13,18,663296,190472,177,14425,518
14,7,7,1,14,303703,8612,70,49547,474
48,15,33,16,9,223608,137653,262,38932,407
29,14,15,16,13,626324,548513,86,24090,414
30,8,22,6,8,29395,24890,185,591500,454
15,10,5,1,9,157569,577,16,577,515
9,5,4,1,9,58608,4876,59,2082,490
5,3,2,1,16,58638,58638,21,58638,652
21,5,16,3,14,273975,12687,40,7320,431
25,15,10,7,8,978813,129615,29,0,531
10,5,5,3,2,109091,9307,12,10110,503
31,7,24,3,20,21617,4187,54,4061,535
24,11,13,3,19,207243,25403,49,18454,573
41,16,25,11,19,315170,132196,222,38523,498
21,4,17,1,16,165558,12571,51,2945,506
7,3,4,0,5,131,0,0,0,685
7,3,4,2,7,10819,10819,32,10567,487
45,10,35,4,16,47613,3900,75,6528,547
10,5,5,6,7,7918,16642,107,407,437
11,9,2,4,8,19763,5821,20,3132,539
9,5,4,7,6,65378,121513,80,29471,461
39,9,30,6,15,73085,43920,238,5968,443
25,8,17,4,19,326829,169611,86,13944,457
13,6,7,5,6,517094,168027,119,2437,493
33,11,22,3,11,952804,15880,218,20892,459
28,15,13,0,4,2221853,0,2,11798,609
15,5,10,3,11,473044,51540,74,5333,464
6,4,2,1,3,5992,3622,8,3622,476
33,19,14,22,11,653575,883325,395,111754,425
10,6,4,0,8,8990,0,0,0,708
21,9,12,0,7,195066,0,6,0,597
14,4,10,0,5,17185,0,62,1970,542
10,7,3,8,14,83058,122233,59,45781,454
16,5,11,0,21,21902,0,7,0,581
7,4,3,1,9,4924,1752,24,5840,618
8,2,6,0,14,87124,0,10,68995,616
38,6,32,2,8,84047,13850,102,6960,493
12,6,6,1,9,45024,415,14,1496,588
6,3,3,2,8,12778,12778,26,10672,474
75,5,70,8,9,131823,156613,162,6868,457
13,7,6,10,7,86138,119380,348,49704,419
11,8,3,0,9,85384,0,46,0,519
10,4,6,2,5,569477,2343,48,1659,531
3,1,2,1,6,0,4585,33,0,646
33,5,28,3,19,52872,36663,148,836,536
8,4,4,5,7,28296,38519,72,17029,449
33,4,29,2,7,31226,24686,50,9305,501
4,2,2,2,6,7883,7883,36,0,577
8,4,4,0,8,13580,0,0,0,658
11,4,7,4,6,2763,6436,10,935,487
23,12,11,15,31,1455205,1225776,0,323,453
16,6,10,0,11,240330,0,0,1,619
32,18,14,0,9,787061,0,0,0,691
47,15,32,1,14,258810,126574,112,126574,486
36,6,30,6,17,268868,262170,137,3887,509
21,9,12,9,8,129380,102521,159,6194,423
10,4,6,6,9,44794,59618,43,1250,451
13,8,5,0,16,225854,0,0,198,655
8,4,4,0,2,402693,0,0,1670,647
18,10,8,0,12,487758,0,34,494,675
10,5,5,4,8,26494,8433,5,2284,439
6,3,3,3,20,9666,9666,46,6936,551
45,9,36,6,13,546412,38925,317,21374,459
65,32,33,13,8,1510979,193606,181,9631,364
16,4,12,2,10,22464,2156,20,6875,468
5,3,2,4,7,16402,35013,52,18611,492
76,5,71,1,11,33364,1462,55,2596,633
33,15,18,13,10,73439,73438,312,10086,414
26,6,20,2,12,333982,8484,37,7990,517
18,6,12,7,32,948412,802505,117,0,465
7,3,4,2,8,1409,29229,22,3397,582
19,9,10,10,24,546778,537116,74,215769,480
4,2,2,1,10,6468,6468,1,6468,608
7,5,2,3,12,85983,43263,0,0,537
10,7,3,2,6,261251,234,33,870,454
23,5,18,2,7,72940,33400,55,20707,544
5,3,2,3,9,20571,20571,49,0,487
9,1,8,0,16,0,0,21,1849,649
8,3,5,3,5,41720,4502,24,13011,524
4,1,3,2,12,5700,10974,48,5719,542
7,4,3,3,19,165643,165292,50,27764,519
8,3,5,1,14,181984,3446,24,3446,649
10,5,5,5,9,146005,136084,125,0,472
9,4,5,3,7,34952,15422,44,6193,440
11,2,9,2,18,551190,18244,30,6395,554
4,2,2,1,8,593,6880,0,0,635
9,3,6,1,8,45542,3528,53,1754,510
7,2,5,1,7,6716,2842,1,2842,627
15,7,8,6,10,80604,77004,227,14716,442
19,5,14,7,10,37879,40813,136,6433,620
4,1,3,2,12,2425,49842,8,2425,509
25,10,15,3,12,163279,736,12,1463,494
46,10,36,10,13,113262,237908,154,36007,469
30,8,22,4,4,86681,1204,20,929,505
3,0,3,0,18,0,0,8,3098,505
5,3,2,0,3,18740,0,1,449,622
6,4,2,2,8,66359,3162,2,466,447
32,8,24,7,6,28527,20705,255,10002,451
38,11,27,5,27,560608,93644,222,11389,498
9,5,4,2,5,4528,4321,23,4314,442
11,8,3,1,12,357755,5435,16,0,519
23,10,13,2,11,152443,3106,21,2739,607
4,1,3,0,7,140552,0,1,64,662
9,2,7,1,17,163543,147631,1,147631,612
8,2,6,2,5,27007,27007,20,512,431
66,16,50,6,13,221469,33510,369,12433,443
45,5,40,1,9,185399,7942,124,7942,596
17,9,8,2,22,154736,1961,4,1926,578
9,4,5,4,17,13342,10800,51,7778,492
23,11,12,5,19,388571,15810,56,9572,434
13,5,8,2,16,54760,2684,53,6900,579
6,4,2,3,12,21838,19339,48,0,552
5,3,2,1,15,5317,14492,17,735,535
27,13,14,19,14,886997,1540842,274,290830,417
14,9,5,1,11,22228,437,29,3098,495
14,10,4,9,19,74702,92046,146,37674,448
38,5,33,4,14,158562,76977,103,18537,466
7,5,2,3,5,229492,32811,0,0,467
7,4,3,4,8,2247,2858,71,1195,525
29,9,20,3,10,489488,17271,225,12587,426
11,9,2,6,15,1959407,1958851,0,0,515
13,8,5,6,7,254828,242234,153,15648,413
15,12,3,9,10,40486,39658,137,7273,461
23,11,12,7,17,27725,47930,89,6955,472
12,6,6,1,17,480143,941,3,1127,647
17,7,10,5,9,8119,13459,64,3355,460
15,7,8,4,13,100931,27986,30,15366,458
7,4,3,0,8,1610079,0,0,0,700
21,12,9,10,13,57978,69368,178,4462,457
13,7,6,8,9,62549,83825,243,13107,354
20,10,10,3,14,1494611,13985,0,1250,491
14,10,4,7,19,163243,56093,100,15453,457
13,6,7,0,11,38387,0,24,2250,610
9,2,7,0,15,329279,0,2,0,566
8,5,3,3,9,33044,12382,40,8074,466
13,2,11,2,6,2964,2964,34,2266,534
13,7,6,5,6,32653,32143,75,3074,427
6,2,4,0,12,10051,0,12,1489,562
15,7,8,0,69,424609,0,5,33752,712
8,5,3,3,21,74656,7102,9,4637,497
8,5,3,0,21,44614,0,9,2365,561
2,0,2,2,5,71080,71080,50,0,589
10,6,4,0,4,12947,0,14,0,582
15,10,5,0,8,438006,0,19,0,617
20,9,11,4,19,165494,62177,41,52563,452
20,9,11,2,12,391879,10707,57,9250,470
24,8,16,6,11,99765,75636,91,17808,461
10,2,8,3,19,39023,22608,46,3815,461
10,7,3,6,13,62142,57694,66,30640,480
32,14,18,0,19,368826,0,8,664,558
11,4,7,3,13,2913,2913,17,1138,522
18,12,6,0,6,113608,0,2,246,647
19,11,8,9,7,94721,59294,509,12992,431
8,6,2,0,15,81763,0,0,0,571
53,9,44,3,10,604459,64140,113,55376,532
22,8,14,7,12,23976,47446,61,4138,477
14,10,4,4,8,116340,88167,58,11284,436
11,6,5,3,11,273550,45878,28,6470,402
10,6,4,5,8,28625,28625,457,18172,447
13,6,7,9,13,503632,196809,226,14002,447
32,10,22,4,28,263708,198215,59,95527,471
15,8,7,0,11,85994,0,1,576,655
4,1,3,2,10,11604,17865,33,11604,576
12,9,3,0,7,113643,0,6,1303,658
5,2,3,3,6,5808,13502,21,5378,542
40,7,33,6,7,12349,11999,135,4350,446
10,5,5,7,7,71103,43288,63,9674,454
28,9,19,1,12,257041,15595,97,18140,455
13,4,9,3,4,65738,49600,24,9638,455
13,8,5,10,9,29100,39333,157,8633,442
5,2,3,0,9,2165,0,24,6005,453
16,10,6,10,18,1253811,795441,32,5928,476
58,18,40,9,13,804048,265436,411,36890,469
13,8,5,1,22,206221,2154,8,2628,523
8,3,5,4,14,310505,307707,33,0,512
120,12,108,10,13,143115,159489,11,16645,453
9,3,6,1,10,12535,7005,28,1180,488
10,7,3,4,12,590057,328339,0,0,418
10,7,3,7,4,79244,83334,146,0,578
11,1,10,0,6,0,0,2,3088,564
18,4,14,2,11,14161,5146,28,2794,580
5,3,2,1,11,334837,10381,25,0,530
18,5,13,0,6,207896,0,0,0,619
13,10,3,0,9,151770,0,1,0,467
9,1,8,0,6,2492,0,11,0,532
29,23,6,5,15,369271,10787,51,2480,545
12,8,4,4,19,760895,371233,94,238393,453
8,5,3,2,15,98505,85567,16,55567,578
10,3,7,0,6,21906,0,0,0,628
14,5,9,3,16,680671,64938,33,6480,478
10,4,6,2,8,5384,13310,33,0,594
7,3,4,4,3,17639,15166,24,5211,395
13,7,6,6,10,23288,25004,89,3254,422
26,4,22,1,9,18275,9061,31,9061,519
32,16,16,6,17,875365,285637,156,667,440
11,0,11,2,8,0,21018,0,0,613
6,4,2,2,11,268520,7898,21,7837,587
13,11,2,0,2,247875,0,1,0,545
23,7,16,4,21,108552,27511,54,17269,474
6,3,3,1,12,38877,35656,4,35656,466
12,8,4,4,6,59264,7710,58,1378,466
17,8,9,1,11,936181,104520,23,104520,538
10,4,6,0,6,35076,0,9,0,522
4,1,3,2,6,60264,50505,0,0,576
31,9,22,5,13,192908,112751,99,4630,474
6,1,5,2,2,2333,10286,8,2333,456
97,10,87,1,16,316894,111476,101,111476,455
16,3,13,2,13,20439,20439,207,19499,533
22,10,12,3,12,284008,5126,61,1748,412
36,13,23,11,12,86696,64854,40,11448,424
20,7,13,4,5,235192,14501,87,1478,486
4,2,2,0,6,58032,0,23,5400,595
15,10,5,0,8,2514184,0,0,8109,583
6,2,4,1,8,507052,3057,0,0,552
4,1,3,1,7,6265,6265,27,6265,644
8,5,3,1,8,37892,5814,3,11429,449
3,1,2,0,12,0,0,0,0,663
148,24,124,11,20,840716,323879,180,151498,453
16,8,8,2,11,111821,1287,0,0,490
9,3,6,1,4,20219,14697,11,14697,624
12,9,3,1,8,119563,2922,19,871,565
15,7,8,4,8,350047,22307,67,6030,468
223,2,221,0,7,14387,0,0,0,636
23,9,14,6,12,121471,82808,178,56497,456
11,3,8,4,14,33101,23315,71,1200,494
19,2,17,1,11,4573,4573,37,4573,660
12,3,9,1,11,114722,2581,30,2581,612
20,10,10,15,7,51224,80926,328,16005,462
9,5,4,1,11,272388,9990,40,596,454
8,6,2,4,69,109989,78320,92,41659,460
10,8,2,3,12,664526,26527,60,14367,421
10,7,3,1,6,504174,17350,17,1971,564
31,11,20,13,8,165421,127947,518,1920217,423
10,8,2,0,8,399234,0,0,204,613
15,8,7,8,8,46707,57793,59,15085,406
14,4,10,2,6,20727,3239,113,11579,454
13,3,10,1,15,355061,266276,53,266276,528
44,21,23,2,25,1663302,4895,43,923,492
15,2,13,2,10,9610,9610,234,9180,493
6,4,2,2,8,11426,9094,23,7155,495
36,30,6,13,16,635891,138820,14,17446,441
4,2,2,1,9,15547,8399,22,8399,539
42,21,21,1,22,261389,150,49,2676,587
6,2,4,2,5,107927,2763,34,1241,644
9,3,6,3,4,11521,6544,22,2948,480
13,10,3,0,4,269263,0,1,0,563
5,2,3,0,7,37149,0,1,683,646
4,1,3,0,12,0,0,5,1975,653
30,8,22,3,9,589749,4859,61,0,586
14,3,11,0,10,15952,0,21,1689,522
14,5,9,0,25,50054,0,0,0,677
47,12,35,3,17,577271,2688,7,29966,484
4,2,2,2,6,2380,2380,8,1528,491
7,3,4,1,13,10776,7637,24,983,634
27,4,23,4,8,54038,52534,89,32760,433
15,9,6,8,6,83730,29779,160,6633,404
5,2,3,1,14,299213,5518,14,0,527
14,7,7,5,9,450466,16633,12,9624,453
16,6,10,4,11,488639,56131,83,2608,455
9,7,2,1,8,20618,139,7,5050,524
14,4,10,1,14,183056,8748,28,47445,628
4,2,2,2,11,5320,4540,28,1145,506
29,7,22,5,13,70529,33020,177,19236,384
21,13,8,3,30,336957,1404,116,4779,523
13,8,5,7,10,40267,35493,73,27946,427
11,5,6,4,14,216408,17670,50,14000,644
19,11,8,10,9,98994,176113,156,19216,475
10,5,5,0,12,17459,0,8,0,604
7,4,3,3,11,45661,19919,86,23330,499
9,5,4,0,14,94559,0,19,6241,665
8,6,2,1,4,87081,19392,18,0,512
8,6,2,2,16,444345,46668,47,34664,535
19,8,11,0,27,303966,0,0,0,733
13,6,7,5,11,169426,174478,39,45983,456
6,2,4,0,6,12972,0,4,0,650
6,2,4,2,2,16612,378,39,1137,578
33,7,26,2,14,40422,40422,98,7719,462
16,4,12,0,13,277008,0,4,2704,518
11,9,2,7,21,41405,21939,135,9796,336
10,4,6,0,3,24705,0,0,0,624
33,5,28,0,18,71341,0,0,1535,591
4,2,2,0,14,0,0,0,0,698
14,5,9,5,14,90767,93163,73,4403,522
34,12,22,7,13,778004,75734,128,18770,434
20,8,12,0,9,96393,0,13,1416,469
7,3,4,2,8,2472,11863,0,0,598
39,18,21,0,22,945534,0,43,34262,661
157,8,149,9,19,531245,227110,0,0,434
12,10,2,4,11,858340,38290,46,16438,449
2,0,2,1,12,0,3828,0,0,544
5,3,2,4,7,41914,47235,24,20479,438
9,5,4,5,9,40829,27522,104,3105,506
30,13,17,1,10,928999,2230,29,2230,489
55,6,49,2,25,210804,6212,22,6386,522
8,4,4,2,7,118053,2496,0,0,484
12,8,4,0,12,82573,0,3,48571,486
35,15,20,0,10,753648,0,34,412,519
7,3,4,2,5,199030,15607,31,367,517
6,4,2,3,10,188354,28746,221,4434,635
11,2,9,2,8,30992,30992,103,18560,535
6,3,3,2,11,17406,17405,2,13411,452
9,6,3,6,12,14589,26257,118,1095,478
14,7,7,0,16,788581,0,1,0,585
21,9,12,7,8,48705,30761,122,9906,418
3,1,2,3,11,28550,55337,57,0,613
5,2,3,2,6,6607,9087,21,5357,642
5,2,3,3,8,9484,19397,0,0,484
3,0,3,0,7,0,0,2,0,678
24,9,15,1,16,209198,13129,18,323,543
10,1,9,2,14,5640,6875,39,18800,480
11,5,6,3,14,36085,20753,65,1171,536
14,8,6,2,15,4561,9637,16,7808,508
10,6,4,3,17,194168,4510,4,800,515
10,7,3,2,8,547368,7908,30,0,463
12,3,9,2,9,12880,4258,27,2924,438
8,4,4,4,8,16096,19014,8,1554,518
8,6,2,6,9,149654,58339,138,1796,444
20,4,16,1,13,26225,20046,67,20046,483
18,14,4,7,18,261707,19798,324,12372,490
19,3,16,3,9,17149,23536,37,20480,549
22,10,12,6,14,802334,35986,99,19808,474
14,4,10,5,9,67357,75511,65,22456,434
6,1,5,0,8,30974,0,12,180,570
10,7,3,4,11,18350,18350,63,14355,451
40,8,32,4,12,32151,10687,105,7537,463
12,7,5,0,14,87921,0,116,794,536
25,12,13,4,10,95433,8515,161,1668,466
16,9,7,0,12,2466809,0,106,9196,504
74,8,66,5,12,73153,33690,304,14649,459
9,7,2,0,12,242481,0,19,0,546
7,5,2,3,5,16480,5946,4,644,430
16,8,8,2,11,45402,429,5,2810,510
6,4,2,2,12,310462,207159,12,191196,529
71,18,53,7,16,1076719,82815,33,15502,421
12,2,10,1,14,0,3700,48,0,659
12,2,10,3,12,14485,21791,32,13903,444
10,7,3,8,12,321204,449086,107,155391,524
20,13,7,13,14,360975,271170,199,97386,455
18,11,7,3,15,85527,10908,19,9251,446
7,3,4,3,8,60596,61574,71,43753,453
71,12,59,0,18,258617,0,45,9430,489
5,2,3,0,8,3080,0,11,0,574
36,8,28,3,9,20172,14808,57,7104,471
6,4,2,1,14,243698,4614,10,4375,467
3,1,2,0,3,23680,0,0,0,646
6,4,2,2,12,315920,10670,58,0,458
25,9,16,3,26,609779,21393,46,10369,477
30,9,21,2,16,546305,143713,63,2563,418
5,2,3,0,20,489,0,21,1475,669
6,4,2,2,11,37772,71655,47,0,546
7,5,2,3,13,4880,7121,30,4339,464
22,6,16,6,13,303346,48487,78,13874,477
24,2,22,1,15,8445,8445,1,51386,568
67,19,48,17,15,547338,264194,286,52106,414
4,1,3,0,17,1100,0,0,1300,663
10,3,7,2,7,15386,22581,20,14386,512
5,3,2,2,6,14007,14007,191,12474,609
50,9,41,6,16,137606,105927,155,1951,523
5,1,4,1,6,20328,5831,11,5831,483
38,25,13,2,13,1192827,2081,25,1841,511
8,0,8,0,20,0,0,20,0,632
16,9,7,5,10,443268,21865,94,3045,535
14,4,10,0,7,22053,0,6,130,571
10,4,6,1,22,75785,29905,26,29905,617
25,20,5,15,69,1342491,674543,355,15398,450
13,4,9,7,15,287563,553647,123,192560,455
13,6,7,6,13,43621,37028,51,18942,509
12,6,6,4,10,30078,11659,50,7864,439
16,8,8,3,11,439200,106387,0,0,494
13,7,6,8,8,282933,97483,145,33322,458
9,7,2,2,16,358913,4384,14,550,581
3,1,2,2,11,11317,20907,0,0,642
44,8,36,8,15,85680,33390,56,5221,431
17,8,9,1,10,366056,449,0,1498,454
16,3,13,1,8,282243,12560,0,0,480
5,3,2,0,13,38164,0,3,0,645
27,15,12,1,7,1736697,555,3,1,660
10,7,3,6,17,322887,60878,0,0,479
6,2,4,3,7,21700,34556,83,0,519
13,1,12,0,20,0,0,20,0,660
17,9,8,9,16,448543,568896,179,263271,510
10,8,2,4,23,320313,27821,61,10423,582
15,8,7,6,19,60762,51330,52,15388,466
5,1,4,1,13,13986,13986,1,13986,628
10,4,6,7,24,53256,100144,97,0,498
11,9,2,5,5,452581,8494,45,2274,465
18,4,14,1,6,51467,329,15,0,552
23,3,20,3,14,51984,28035,195,27730,520
13,3,10,5,9,44920,39775,20,12712,481
8,2,6,1,10,2523,2523,58,2460,553
13,4,9,0,3,137949,0,3,119,584
8,6,2,0,3,62329,0,0,0,645
6,4,2,2,8,15559,10908,34,0,526
19,4,15,5,7,606712,17686,63,3778,462
13,7,6,2,9,4628,2178,24,3242,427
37,16,21,20,10,1364544,852773,49,19814,442
47,9,38,5,14,236714,58998,152,41693,511
9,3,6,1,13,297124,1862,31,0,542
14,9,5,3,13,21057,13557,0,0,434
12,7,5,1,12,84312,5966,4,0,592
4,1,3,2,12,40868,60452,27,40868,447
7,4,3,2,5,9450,6845,45,15532,460
20,11,9,2,11,202143,200226,35,193633,529
6,4,2,0,11,418489,0,15,0,459
14,4,10,5,17,67131,42547,32,17227,534
14,3,11,3,10,32166,35804,102,8103,502
38,9,29,7,7,123281,83777,0,0,439
26,4,22,2,11,7312,1168,417,3485,457
17,2,15,7,11,74036,92793,1,1250,541
23,7,16,5,13,119201,66873,116,82729,460
20,5,15,6,11,46416,48593,153,9455,543
18,11,7,0,18,2541211,0,39,8271,563
31,13,18,8,21,715498,28758,234,11520,474
15,12,3,8,10,139730,33520,105,9900,495
7,5,2,2,14,13789,9730,14,9290,480
7,4,3,1,12,25194,490,28,1272,598
24,8,16,3,8,151807,21575,60,14995,498
11,5,6,2,9,29544,6143,27,5224,442
21,10,11,10,6,18101,17923,76,3064,450
26,3,23,2,14,24908,12868,121,6962,500
79,9,70,3,18,145233,85331,5,22256,534
15,12,3,6,16,14031,1110023,30,15489,403
13,10,3,5,19,383093,92326,106,0,415
42,9,33,9,10,69908,57346,51,6130,407
42,12,30,12,11,67328,67327,132,17279,431
2,0,2,0,10,0,0,0,0,587
12,10,2,9,14,85757,54307,311,24719,415
23,9,14,3,6,51459,7754,48,3864,583
15,7,8,7,21,27708,26477,135,8184,457
20,3,17,4,15,21943,47147,95,14805,659
10,6,4,4,10,27920,27920,246,20000,491
16,3,13,2,19,7325,7325,63,8408,482
27,9,18,8,7,87302,53040,84,16611,376
7,4,3,1,12,21313,11634,18,148,621
6,4,2,6,39,41730,53619,0,0,489
10,4,6,1,69,503344,6570,31,6570,529
7,3,4,0,3,26026,0,0,0,606
32,11,21,2,16,194049,1828,12,7312,546
20,4,16,2,15,325192,13111,31,11154,463
16,3,13,2,7,226660,211450,3,3527,500
27,19,8,16,69,709847,669078,163,327,476
11,5,6,1,10,37875,34400,17,3342,554
17,8,9,3,5,94106,819,69,6252,437
18,7,11,0,12,161073,0,4,0,653
64,24,40,0,20,951403,0,31,7522,534
7,5,2,2,12,15425,13655,22,12717,568
7,2,5,2,6,277516,52472,0,0,618
6,3,3,1,6,391239,9610,7,0,579
25,5,20,1,30,1093018,286034,37,0,527
15,7,8,1,16,566317,220,0,0,572
9,4,5,1,10,299812,8510,97,14381,468
7,2,5,1,17,29422,23319,0,0,553
11,7,4,3,14,35920,35920,42,24229,401
23,8,15,4,5,347605,9178,56,6897,409
35,14,21,0,9,3933858,0,21,0,656
26,4,22,0,7,367776,0,0,0,675
8,3,5,1,10,100880,22449,17,22449,566
16,6,10,1,30,135570,1009,0,0,536
27,9,18,7,8,144888,75289,108,6300,462
18,12,6,4,9,707123,125067,2,2558,477
11,3,8,0,9,13028,0,15,304,674
9,3,6,5,12,25656,42236,23,696,524
6,3,3,0,12,577376,0,20,348,654
9,3,6,1,9,328570,20599,2,20599,413
10,5,5,3,11,46201,15588,47,0,475
35,3,32,4,8,51565,51564,49,38704,459
33,11,22,8,12,645691,167748,141,39933,461
29,16,13,0,18,1682888,0,63,0,571
20,6,14,5,4,28664,20235,17,5524,456
23,15,8,0,8,165801,0,21,1260,541
20,9,11,10,19,80586,80586,293,17976,449
9,4,5,4,11,22600,18568,132,7200,491
4,2,2,0,14,122730,0,0,0,547
28,5,23,7,24,53951,53877,90,11698,461
4,2,2,0,8,5318,0,0,0,619
13,8,5,7,17,45039,48423,131,12767,429
9,5,4,3,7,27345,10231,0,0,527
5,2,3,2,17,48943,41786,28,21111,543
10,3,7,4,8,69552,82536,56,17973,423
5,1,4,2,9,2903,7242,59,16888,533
8,5,3,1,6,73343,923,0,0,529
48,3,45,5,14,15730,16255,90,11060,467
22,7,15,7,11,36184,28527,105,1855,478
21,10,11,7,12,295640,21357,123,9260,375
14,11,3,2,8,185614,700,11,5314,623
5,2,3,0,12,0,0,50,0,526
14,9,5,6,7,102567,75234,83,684,440
6,3,3,4,6,11425,16938,57,8207,505
47,8,39,0,10,169290,0,0,0,595
15,6,9,0,8,82927,0,365,23600,462
20,13,7,8,69,16849,25698,67,15437,443
18,5,13,5,7,26288,25500,55,8265,411
9,6,3,4,9,13641,8817,56,3494,524
8,6,2,5,6,25180,15655,44,1187,380
7,4,3,1,13,6380,6380,29,0,555
10,2,8,1,17,346735,4068,50,4068,649
21,6,15,0,13,40352,0,9,525,658
23,7,16,4,12,177959,79724,37,0,446
6,3,3,1,10,24230,2507,6,0,630
8,1,7,1,17,398,398,10,4396,550
24,18,6,0,9,341445,0,11,0,530
14,7,7,6,15,52068,44244,50,18278,439
4,1,3,1,8,28076,28076,25,0,510
3,1,2,0,3,26782,0,4,2917,473
9,3,6,4,4,26143,26143,40,18150,457
7,3,4,0,2,18279,0,0,0,635
15,7,8,6,13,243880,25886,77,13605,471
9,5,4,2,10,16367,1426,65,1239,492
22,13,9,6,10,546493,16444,80,6460,425
14,9,5,1,11,225210,3025,60,158,502
5,3,2,3,11,20577,32985,12,18981,487
12,6,6,1,14,322333,3744,99,7991,647
22,7,15,9,7,61619,56773,339,14577,439
45,11,34,9,18,213555,64667,503,12250,466
6,4,2,3,6,16372,280,10,359,619
10,7,3,0,15,243830,0,0,510,628
9,2,7,2,4,7339,5759,66,0,498
18,10,8,0,7,316146,0,0,0,610
9,5,4,3,10,71762,30282,227,23170,491
27,0,27,2,14,0,11480,38,479,491
24,7,17,2,11,66668,9499,21,9314,583
19,9,10,3,5,185806,16131,34,21302,431
7,5,2,1,8,3324,298,30,0,621
67,6,61,3,9,81326,19182,72,10811,475
5,3,2,3,7,22256,17614,56,3830,568
17,6,11,0,7,79984,0,9,0,539
12,4,8,2,8,190344,1041,5,875,516
11,4,7,3,9,383131,17560,30,14366,404
8,5,3,0,16,195694,0,40,1457,674
19,5,14,3,18,322481,36009,22,2780,476
13,7,6,0,13,315225,0,0,1481,637
22,10,12,7,13,125643,26407,9,4980,458
9,5,4,3,28,104916,97175,32,65638,493
14,8,6,7,8,33881,33766,45,14007,411
20,8,12,1,19,166642,35,25,3782,530
12,3,9,3,15,179066,34358,0,0,607
3,1,2,1,12,17242,17242,23,17242,632
18,9,9,1,12,280518,6620,18,0,557
7,5,2,3,26,9637,9637,45,6183,491
12,6,6,7,18,413648,411555,37,1970,465
11,8,3,7,9,376598,210502,57,101376,389
24,11,13,3,5,113722,16257,1,677,443
42,14,28,7,15,87644,27944,102,9973,466
13,8,5,0,9,61338,0,0,0,697
6,4,2,0,5,26962,0,1,0,589
7,5,2,3,5,61551,53354,156,27239,464
13,7,6,10,9,95928,135289,109,55625,461
27,7,20,7,10,34188,31188,116,9620,460
5,2,3,1,11,6459,5969,25,0,525
9,5,4,3,20,544289,198700,29,6820,436
34,12,22,0,13,3754627,0,2,0,578
18,6,12,0,13,527379,0,1,0,661
15,8,7,0,8,197942,0,1,0,488
17,11,6,0,14,3259858,0,1,0,609
7,3,4,1,8,22331,324,19,745,526
31,7,24,0,9,171199,0,0,0,626
11,4,7,2,17,16820,16820,48,8410,525
7,4,3,0,8,58014,0,0,0,712
19,9,10,9,13,92857,104644,130,14761,596
22,11,11,7,11,351885,26622,187,8600,425
11,9,2,9,8,414878,55552,36,10260,417
21,3,18,2,18,293281,37873,3,743,534
7,4,3,0,11,277392,0,7,416,491
19,1,18,0,5,15690,0,51,694,565
8,5,3,4,7,254473,30457,39,6457,489
28,7,21,3,10,172838,4478,226,5983,405
6,2,4,1,15,2248,2248,12,2248,635
6,2,4,1,8,286556,12448,16,12448,470
17,13,4,0,26,0,0,48,18022,554
22,10,12,14,21,492131,105252,72,9736,420
70,7,63,0,17,403455,0,3,7170,555
15,9,6,6,12,394686,72214,132,9824,486
5,3,2,2,7,16486,15348,0,0,481
3,1,2,1,5,12732,12732,11,0,629
14,9,5,6,7,888989,257357,109,7222,425
6,2,4,3,7,24269,59136,57,34867,603
4,2,2,1,3,30638,4650,8,4650,620
14,8,6,4,11,592123,10969,55,3354,413
11,8,3,0,20,124992,0,0,0,528
15,10,5,8,20,277168,91855,66,6102,507
7,5,2,2,3,25979,10015,29,4303,473
10,8,2,8,6,28981,28981,41,12034,466
9,4,5,2,12,240900,12653,58,5257,498
17,7,10,4,9,64445,9123,8,3477,435
8,3,5,2,6,8555,13252,63,10950,494
5,2,3,2,12,56778,51430,31,0,590
36,14,22,8,9,338596,21228,70,5380,436
39,6,33,0,17,193492,0,11,14331,641
22,9,13,0,7,415065,0,207,9066,443
42,15,27,17,14,362387,273965,152,87744,380
27,12,15,3,7,298875,30594,134,17746,605
13,3,10,3,9,96407,86739,51,429,443
11,6,5,3,14,29475,27228,1,2165,531
7,2,5,0,4,243084,0,0,0,598
34,8,26,1,13,574329,30350,39,30350,593
9,7,2,1,10,77812,658,4,0,615
15,7,8,4,69,432788,6463,55,10928,490
40,17,23,8,10,300514,32339,75,7608,454
4,2,2,1,11,12900,7305,5,7305,553
7,5,2,4,6,55990,3346,13,1464,462
25,18,7,2,6,257292,1694,20,1324,485
17,13,4,0,18,1540929,0,5,8192,546
37,14,23,10,9,484130,52579,963,10086,567
14,8,6,6,8,51430,45327,78,10198,480
8,4,4,0,6,588415,0,0,0,649
7,2,5,5,9,299959,121697,129,3399,585
4,2,2,1,11,105842,6689,23,0,567
10,8,2,5,14,139377,30984,57,16490,540
10,6,4,5,14,85230,145705,108,0,446
18,10,8,6,8,78385,26693,89,6499,432
10,4,6,5,13,578771,23831,52,0,482
12,5,7,0,24,381360,0,8,12804,527
2,0,2,1,6,0,1484,10,0,630
4,2,2,2,4,935,1193,22,1074,664
38,14,24,4,18,176312,14411,89,5855,443
10,3,7,2,8,35403,14722,48,0,443
83,8,75,4,18,212672,209564,60,0,527
11,7,4,6,10,37187,34956,360,11194,424
7,4,3,3,21,398270,13495,123,6103,549
11,9,2,0,10,154744,0,0,0,678
7,3,4,2,15,77351,29706,0,1045,452
22,7,15,6,6,33166,33166,128,0,460
43,10,33,5,5,90176,42199,11,13630,443
9,7,2,1,11,638893,1,5,0,580
47,5,42,3,7,476722,16364,47,11832,427
16,7,9,5,17,40848,37746,41,7138,513
8,6,2,6,6,14215,30882,92,4711,373
116,14,102,2,27,977531,14786,17,14500,541
55,17,38,17,21,495545,447296,227,20619,406
9,6,3,0,5,122460,0,0,0,583
17,5,12,0,9,95412,0,3,0,564
23,11,12,7,14,68417,35729,121,8890,400
8,4,4,4,9,10096,9956,21,5522,432
9,6,3,4,18,469362,42409,68,30399,446
5,2,3,2,5,1887,15549,12,1887,514
14,7,7,6,6,191706,189813,114,69273,409
15,4,11,0,12,334974,0,2,0,665
15,5,10,2,17,333723,108832,2,4336,647
9,4,5,3,10,51599,30344,38,4632,522
20,7,13,1,7,68696,15619,42,15619,513
15,6,9,0,8,447128,0,4,0,672
3,1,2,1,7,3105,3105,25,3105,556
27,11,16,8,21,320615,286483,125,22698,384
16,6,10,2,15,168254,13230,42,22037,466
10,6,4,4,9,60047,35682,0,4957,439
27,13,14,8,9,432327,24518,110,34277,417
24,14,10,7,14,56491,7257,63,3984,439
11,4,7,4,8,498469,348903,37,34633,443
20,6,14,4,8,48867,36853,27,20936,473
16,10,6,1,6,66921,3917,5,925,480
10,6,4,6,13,44651,44651,76,24231,443
20,10,10,0,20,398582,0,0,0,595
271,13,258,0,17,65317,0,20,740,674
14,7,7,5,15,229464,57286,75,18629,409
9,1,8,0,3,8082,0,3,3325,546
30,11,19,2,10,114533,24499,67,23325,440
30,15,15,15,9,131274,137686,232,53449,406
15,6,9,4,15,236284,68525,73,0,464
22,12,10,8,13,189231,74447,82,11162,463
7,5,2,1,12,65129,2131,18,0,676
10,6,4,5,7,24793,23895,47,10382,497
6,3,3,0,13,27626,0,1,3000,640
14,8,6,3,7,44732,32448,150,2537,451
20,4,16,4,6,10465,10465,69,4980,451
32,19,13,9,11,735421,651714,128,106347,450
7,1,6,1,3,6579,6579,16,6579,569
16,11,5,2,7,225471,4347,47,0,439
8,5,3,5,7,97078,85327,0,0,542
22,7,15,8,7,73820,64000,155,14021,559
7,3,4,2,13,1086,622,29,558242,597
21,7,14,0,12,351518,0,15,0,625
16,8,8,7,11,69434,41802,17,10556,454
14,2,12,1,19,3708,2256,1,6525,513
8,6,2,6,13,63713,58831,102,18446,481
42,12,30,5,13,1041801,22900,73,4994,450
22,10,12,5,16,123559,65381,58,2068,465
10,3,7,1,12,16479,4625,2,4625,633
27,11,16,7,13,72393,24912,281,5993,447
15,5,10,5,10,181841,192624,59,69643,427
3,1,2,2,3,4505,4505,13,2988,504
7,2,5,2,13,3952,1043,19,565,560
2,0,2,0,9,0,0,16,0,636
19,4,15,0,10,43548,0,12,1702,638
20,8,12,8,9,93445,90984,199,40787,454
23,6,17,6,18,68122,58707,37,26353,474
20,6,14,4,19,4737,4737,29,2898,500
17,7,10,0,16,62907,0,6,0,612
14,7,7,4,8,107759,12022,51,3055,407
11,6,5,3,24,345121,35902,78,7304,459
7,4,3,4,7,37987,18284,67,8254,543
10,6,4,6,8,155572,219031,112,69442,435
43,39,4,2,69,1033479,2859,10,1130,490
7,4,3,4,7,17491,22771,45,2710,441
11,6,5,1,10,1114209,9698,7,30279,598
32,10,22,6,18,253066,24659,352,13481,481
6,4,2,5,14,27333,13070,19,6880,471
25,6,19,6,7,257609,30876,80,0,473
16,12,4,6,14,61641,27278,35,16120,442
2,0,2,0,8,0,0,0,0,608
22,8,14,8,13,967481,767085,158,355503,480
7,4,3,3,6,29013,25954,0,0,443
12,6,6,3,7,60366,51314,65,3340,446
5,3,2,2,22,11658,17390,25,11658,466
3,1,2,0,3,3892,0,1,301,612
12,9,3,8,10,132695,120943,179,6623,420
6,0,6,0,11,0,0,0,9541,610
30,5,25,0,17,55348,0,0,3256,604
14,6,8,4,10,44774,44330,93,3273,428
27,13,14,1,18,170751,8280,53,11280,552
19,6,13,4,14,464881,30783,46,15127,460
42,11,31,1,16,2353698,1085,6,1267,541
21,6,15,1,15,241302,70490,12,1442,474
4,1,3,4,9,5250,41342,54,0,506
9,5,4,0,11,32381,0,0,0,649
3,1,2,0,4,4672,0,15,0,599
22,4,18,2,8,9484,13487,152,11672,543
2,0,2,1,4,0,4334,20,0,618
7,3,4,1,9,143267,6783,9,6783,583
8,3,5,4,7,45616,45616,65,25991,511
14,7,7,3,10,853925,9461,29,4152,605
7,5,2,4,10,22981,22981,41,9858,428
13,5,8,3,22,49311,48838,77,25676,511
21,9,12,0,11,2374923,0,14,1487,464
29,9,20,8,6,280015,15194,41,6154,449
4,1,3,3,11,77881,77881,51,53749,494
13,6,7,6,8,38464,37290,224,14703,427
18,6,12,6,12,162913,172951,97,24123,455
58,5,53,1,19,188644,30382,31,5700,610
15,5,10,2,11,146727,109126,30,0,553
4,2,2,2,9,14639,14639,0,0,483
24,5,19,2,22,33701,3848,61,2815,531
12,3,9,2,13,14510,3335,327,5428,489
4,2,2,0,3,90125,0,0,0,613
17,13,4,9,17,233024,1269345,206,216908,468
24,13,11,0,20,90467,0,24,0,689
9,3,6,1,11,41406,20190,2,20190,616
25,6,19,5,10,49972,47172,379,20515,369
21,6,15,5,4,140712,11228,21,6198,444
13,4,9,1,10,80331,8638,28,12652,563
3,1,2,2,4,828,14475,38,828,531
19,9,10,0,11,77114,0,73,16048,625
11,6,5,2,4,31552,1325,13,955,488
18,8,10,2,6,236749,11612,39,0,425
6,2,4,1,8,3472,2308,8,2308,612
7,5,2,5,8,78655,102308,9,31069,468
18,5,13,2,12,27350,9153,24,5862,442
14,5,9,1,9,378532,22389,17,0,635
5,1,4,1,14,255552,23422,30,0,525
7,5,2,1,6,50798,1349,24,1349,524
3,1,2,1,4,7118,7118,0,0,533
9,6,3,6,9,265917,244086,96,27330,456
27,5,22,4,8,54038,52534,86,32760,433
13,5,8,5,11,15313,6295,42,3985,519
9,2,7,3,13,3007,28081,39,3007,592
15,10,5,0,17,115803,0,1,496,538
31,5,26,1,9,18988,12295,185,12295,650
7,5,2,4,3,72328,37842,111,18422,486
55,14,41,16,14,350528,382476,198,41269,421
11,8,3,6,15,111825,87531,63,19932,430
5,2,3,2,21,361764,17291,0,0,496
5,2,3,4,5,12322,21448,38,9625,480
7,3,4,3,22,26668,44220,43,3720,483
19,9,10,3,19,42683,4545,40,3991,488
26,17,9,11,25,912761,269381,144,22566,480
22,6,16,2,14,27587,10570,27,371,534
5,0,5,1,5,0,8033,31,8033,629
8,4,4,4,3,76494,35407,24,900,460
5,3,2,0,5,59963,0,3,0,571
7,4,3,0,8,51315,0,0,0,652
5,2,3,2,10,19239,19239,0,0,559
25,10,15,11,19,273125,333008,199,74145,454
14,8,6,3,16,441225,26624,66,18463,495
44,13,31,7,19,218581,186195,64,53975,511
7,4,3,0,14,330179,0,5,0,518
25,10,15,6,14,178527,27259,88,16869,382
4,1,3,2,6,23886,23886,27,4059,633
7,3,4,4,14,236563,236563,78,51540,548
41,13,28,4,22,503335,108381,4,7194,550
7,3,4,3,15,10922,7402,63,995,542
3,1,2,0,6,15005,0,5,0,694
7,4,3,2,12,47931,46714,44,27904,529
8,3,5,3,7,15528,8125,12,4972,430
22,7,15,1,12,194443,900,52,3316,484
4,0,4,1,8,0,3241,0,0,607
7,5,2,6,8,54035,58823,77,7411,447
24,14,10,2,10,200256,14148,53,3004,424
14,11,3,2,7,98017,2125,32,1765,562
10,4,6,0,3,249637,0,6,985,601
139,13,126,7,14,244296,108448,82,9081,494
10,5,5,1,26,47697,145,3,0,666
18,9,9,5,18,455714,74451,45,9222,453
7,5,2,4,5,20340,19416,284,8960,458
22,7,15,1,16,23413,49636,32,513,537
21,7,14,4,11,216252,25507,0,5161,457
19,6,13,4,8,132146,35485,276,2310,540
9,6,3,3,11,534622,5809,28,10124,397
16,10,6,1,6,368711,1492,0,0,525
30,14,16,1,22,548347,1,66,9430,656
7,3,4,1,8,304263,1467,18,1467,477
16,11,5,12,6,36251,50036,396,9121,403
19,8,11,5,19,76952,28000,57,8382,491
18,11,7,6,11,502208,11839,34,1015,532
14,4,10,5,9,27917,23061,20,7765,506
31,5,26,1,9,182111,24491,41,0,528
13,8,5,4,16,453711,205662,74,3680,505
7,3,4,1,14,900,900,12,2205,655
28,11,17,2,9,425463,7155,26,5843,543
25,7,18,0,6,72813,0,34,4137,479
37,13,24,7,14,255087,164177,92,1017,570
8,5,3,0,8,24240,0,0,0,578
9,4,5,5,6,78164,91262,79,31348,425
3,0,3,1,4,0,25747,12,0,549
15,4,11,6,7,19539,37694,115,10330,451
12,5,7,3,9,111777,15351,141,6438,487
9,3,6,2,4,10368,9861,132,6217,572
5,1,4,0,5,26471,0,8,405,605
6,1,5,2,7,7020,14040,33,0,657
16,3,13,3,4,47089,17205,0,0,464
28,9,19,6,15,73439,24725,153,9385,422
10,8,2,5,5,23182,7336,23,2747,391
12,9,3,2,13,372868,16184,17,6392,486
11,8,3,8,7,118277,132784,164,40569,478
7,0,7,0,7,0,0,0,1278,679
62,24,38,6,15,163690,141724,139,24000,432
6,1,5,1,9,4018,1108,45,2546,597
15,2,13,3,13,20297,44624,64,20297,478
16,6,10,3,9,229554,88112,136,3609,485
12,9,3,4,10,555191,29905,0,0,541
12,6,6,5,4,30485,8992,22,6585,433
17,8,9,2,21,97957,850,44,0,560
6,4,2,4,3,30678,11718,75,2582,366
14,5,9,6,6,9457,18075,110,2511,570
44,10,34,1,13,49903,550,22,550,567
23,18,5,0,9,157805,0,0,0,696
4,1,3,1,3,2119,1839,35,1839,639
7,4,3,2,11,419587,25730,10,2217,537
6,4,2,2,6,4556,4556,82,1866,558
5,1,4,1,13,0,1162,28,0,631
5,3,2,0,10,1114983,0,0,0,615
8,4,4,1,11,287114,3795,11,0,550
5,2,3,1,7,3771,2321,42,0,552
6,3,3,1,8,9494,624,0,0,548
17,1,16,0,6,0,0,0,0,744
46,8,38,4,10,30746,3925,332,3351,481
37,10,27,6,33,627417,189252,115,2972,488
16,5,11,4,11,463202,14310,47,8405,488
7,2,5,4,4,88535,88534,54,13180,523
6,3,3,1,10,27907,13109,24,13109,644
27,7,20,4,8,54870,126230,72,84,466
7,5,2,4,12,242941,69483,102,50472,477
11,9,2,8,14,43128,43128,122,10556,371
9,5,4,0,6,46348,0,0,0,621
96,4,92,0,8,19801,0,0,294,598
9,4,5,6,8,39162,45646,43,6066,493
10,8,2,7,6,108855,15405,54,3239,508
10,5,5,0,11,1145370,0,0,0,660
13,8,5,5,15,203909,22454,91,2973,489
12,6,6,0,7,55368,0,0,0,533
90,12,78,2,12,215395,4052,31,831,548
14,8,6,2,12,48489,228,19,760,485
19,15,4,4,16,967987,108082,52,51012,419
11,7,4,1,17,545766,1650,26,1650,559
8,6,2,2,9,88985,67837,58,1231,524
13,5,8,4,13,368804,15372,40,3157,426
13,4,9,3,14,28568,8231,7,5638,437
15,8,7,0,7,32262,0,110,1131,670
24,6,18,1,29,70883,5077,22,950,424
3,1,2,2,15,5754,11508,35,0,675
4,2,2,0,8,11427,0,0,1617,589
4,1,3,2,6,10524,10524,24,7424,540
5,3,2,3,8,18291,25594,76,6610,556
9,4,5,0,3,152333,0,2,0,507
8,3,5,2,7,10860,8860,87,5448,544
26,5,21,3,20,358675,344822,88,247062,515
22,7,15,2,14,67328,18664,59,9853,539
39,5,34,4,8,178516,108364,33,16008,477
19,11,8,7,13,542126,49705,102,8943,481
3,1,2,1,11,43393,26876,16,0,477
23,12,11,13,14,92866,128102,0,0,421
14,7,7,1,8,96981,15563,32,0,507
11,5,6,6,14,697125,743659,82,47082,435
53,10,43,13,17,295410,227039,54,10212,464
8,5,3,3,2,9073,5477,15,203,412
38,16,22,9,16,2369087,607610,46,3890,513
17,6,11,4,12,32474,31174,323,18100,511
15,13,2,3,12,977912,23173,25,0,545
31,6,25,5,12,134828,24819,80,741,460
26,2,24,2,10,3409,2878,54,3444,575
31,23,8,2,26,293324,11385,19,8472,480
36,10,26,10,16,42923,50107,159,8955,439
16,12,4,0,13,262855,0,0,400,497
39,20,19,0,14,2203918,0,4,48236,547
13,6,7,3,16,185075,64753,31,11198,544
7,1,6,2,9,8042,12935,0,0,544
12,3,9,4,14,29799,28971,324,21624,489
27,16,11,0,13,346170,0,7,320,521
59,8,51,4,18,108561,20904,167,21684,444
72,7,65,2,13,56424,3007,100,4747,483
19,7,12,0,14,59904,0,0,761,688
18,6,12,1,5,439192,987,15,0,508
10,5,5,5,10,74397,16430,66,0,519
11,3,8,2,6,3962,3962,23,2768,464
4,2,2,0,11,63392,0,13,139,646
15,4,11,2,20,123186,74236,51,64977,497
19,7,12,3,15,95575,66263,115,21840,529
5,3,2,0,14,399349,0,2,3211,523
15,9,6,0,12,509046,0,16,0,668
23,17,6,1,6,327690,200,4,357,495
12,4,8,0,17,353206,0,2,0,595
12,7,5,6,10,30408,14671,120,7027,531
24,13,11,0,14,302627,0,3,2640,655
4,2,2,3,13,37889,44753,47,27178,493
13,7,6,10,18,465334,224041,143,16578,469
61,12,49,14,14,116375,149192,718,32109,447
8,2,6,0,7,34377,0,1,702,572
61,13,48,10,10,276725,203302,193,11120,457
36,6,30,0,10,395932,0,231,1969,697
169,19,150,0,19,370707,0,4,943,619
15,7,8,7,4,173727,56996,119,8537,375
8,3,5,1,7,19740,640,11,2073,575
18,6,12,7,8,157986,80538,124,877,471
8,5,3,3,10,266132,32371,27,7767,478
17,3,14,4,18,2758,48610,40,1328,486
19,5,14,5,24,31182,56554,131,23602,519
28,7,21,5,18,68416,32164,31,23750,435
17,12,5,10,13,27675,28759,115,5995,459
5,2,3,0,3,7205,0,3,595,546
38,4,34,2,8,13668,10180,115,9668,529
49,14,35,7,21,208284,27328,129,8840,507
18,8,10,2,16,1635457,3072,58,1347,410
43,11,32,5,10,61968,37032,68,15824,443
4,2,2,1,13,432423,4658,8,42402,575
17,12,5,0,13,550233,0,17,0,652
11,8,3,1,10,150874,594,4,0,514
6,4,2,3,8,408148,18066,24,2616,502
17,8,9,5,13,36522,17401,25,8968,473
20,9,11,5,9,56133,19604,50,8642,434
21,9,12,2,18,239349,10900,10,11978,418
32,14,18,13,16,139655,118156,410,26150,376
18,9,9,7,14,428331,41150,120,24062,496
38,1,37,1,11,6773,6773,18,0,645
5,3,2,1,4,48730,30789,6,370,523
23,4,19,1,8,164418,105623,21,105623,492
29,5,24,0,3,9087,0,0,2315,524
7,4,3,1,5,384247,7259,7,0,585
24,8,16,0,6,474492,0,3,0,611
7,5,2,0,10,51594,0,1,0,607
6,4,2,0,7,19588,0,3,289,569
9,5,4,0,10,56975,0,0,0,608
57,6,51,0,6,246957,0,2,0,640
21,10,11,0,6,168418,0,0,0,672
20,3,17,3,12,22058,25022,117,2655,513
8,4,4,0,18,241337,0,0,444,647
11,6,5,2,7,225569,28169,18,1721,498
9,4,5,6,6,459596,41417,93,9742,502
12,6,6,2,21,211114,201534,60,196983,484
9,3,6,4,16,184059,224210,104,0,469
30,13,17,0,8,85450,0,1,192,578
18,11,7,0,19,191511,0,1,0,670
36,13,23,8,19,397302,95927,304,23400,466
9,6,3,1,5,160526,1045,3,1045,526
33,9,24,0,13,973988,0,9,0,675
116,12,104,6,19,591448,451413,115,75380,464
11,4,7,1,10,27379,1236,32,1986,492
17,4,13,4,13,61134,65301,0,0,500
41,12,29,2,21,230807,13543,113,10645,430
20,4,16,3,24,365096,59124,30,60738,429
45,16,29,6,13,143840,19672,30,8351,399
8,3,5,2,6,11917,5274,162,2988,471
14,3,11,2,19,1012053,18223,41,14669,651
12,6,6,2,10,25000,12607,123,16896,414
82,7,75,1,11,41055,914,40,914,517
11,6,5,4,11,280984,25719,32,11737,426
9,5,4,2,6,9557,6494,34,3806,502
8,1,7,0,15,0,0,0,2789,777
16,7,9,8,7,60287,41919,0,0,463
5,1,4,1,3,1103,5050,10,5050,595
28,8,20,6,10,576454,95228,83,10393,483
5,3,2,1,6,326451,10487,0,0,640
37,4,33,2,7,22448,3548,40,0,481
9,6,3,4,7,13656,33733,65,7647,477
10,6,4,2,14,114139,82566,18,45332,523
60,5,55,4,14,44393,29653,83,10910,549
46,8,38,9,19,351805,83015,335,23600,453
27,5,22,0,12,13727,0,20,3461,576
11,3,8,0,20,24468,0,1,0,699
64,11,53,10,9,81888,79876,131,22582,407
4,1,3,1,5,5698,5698,25,0,629
14,7,7,2,17,729695,20860,98,11020,446
5,3,2,1,12,34176,29413,41,29413,533
12,6,6,7,11,422194,126222,107,49316,468
17,7,10,3,10,120441,9631,82,9255,491
23,10,13,9,13,36479,36479,25,6688,465
16,8,8,5,5,30352,16051,181,6978,408
30,6,24,4,14,535146,72558,110,19138,614
16,5,11,5,8,66527,62199,93,8115,451
30,13,17,2,13,263042,6595,16,4193,515
5,1,4,2,9,850,2976,0,1092,551
7,2,5,3,14,54273,68952,46,28286,538
24,10,14,5,20,359005,21179,263,20022,498
21,15,6,10,10,287768,273210,261,149967,433
30,12,18,4,9,86423,15450,34,12286,471
43,16,27,15,13,336301,241092,439,43579,456
49,7,42,3,13,14064,14064,51,7081,479
41,9,32,7,13,125966,46969,103,11952,486
14,8,6,10,8,96018,101252,103,18881,420
21,10,11,8,14,404130,65475,144,31323,382
9,5,4,3,19,284705,229154,77,148599,471
8,3,5,4,8,38309,38309,49,19231,387
15,8,7,0,12,1018210,0,20,0,614
20,12,8,3,20,246794,187622,1,2590,491
10,7,3,0,13,312121,0,5,0,628
8,6,2,0,12,113725,0,2,0,638
13,11,2,0,2,79335,0,0,0,589
10,6,4,5,8,33696,42396,329,15251,490
24,11,13,4,15,371996,340634,133,0,531
13,8,5,0,11,372576,0,24,0,612
31,3,28,3,12,55842,47699,68,29573,529
22,6,16,1,14,19729,2710,24,965,500
9,5,4,3,18,300440,36326,78,0,480
6,0,6,1,17,1854,1496,13,1496,550
18,9,9,9,15,304960,111459,19,9254,443
4,1,3,0,5,0,0,37,0,638
4,2,2,0,7,20720,0,0,0,614
15,8,7,2,14,109586,2888,14,1709,521
7,1,6,1,15,8234,8234,24,0,653
9,7,2,3,6,119657,786,16,1756,569
56,6,50,0,19,129376,0,5,4600,587
14,4,10,1,15,2191,1085,2,1085,520
3,1,2,2,24,8057,10070,15,0,507
18,11,7,9,10,982356,275219,81,143593,474
8,3,5,4,26,412496,412496,16,203360,459
16,11,5,11,7,116446,116446,65,11134,469
15,7,8,6,13,45614,42579,65,2772,568
23,7,16,6,10,123837,40283,139,6008,526
6,2,4,3,6,13620,10181,51,8225,547
9,5,4,3,4,10553,11422,0,0,455
19,15,4,0,10,336328,0,3,0,637
18,4,14,0,12,208014,0,7,814,509
33,9,24,4,12,763124,27151,102,15135,531
24,13,11,9,22,93142,20614,222,1853,486
13,10,3,0,8,375470,0,0,0,587
12,1,11,0,9,5386,0,67,908,615
17,8,9,0,14,783617,0,0,0,524
25,11,14,8,8,769211,91646,197,10695,439
40,5,35,4,15,225229,214751,58,204729,478
29,9,20,0,15,100625,0,0,7949,654
9,2,7,3,45,362057,261130,110,17099,638
27,10,17,9,10,521196,618890,119,283679,451
27,2,25,3,7,4511,7197,29,2686,504
3,1,2,2,8,20043,28281,40,0,477
13,5,8,7,7,248983,245993,0,0,487
18,9,9,4,15,106384,32266,19,4772,441
12,5,7,3,6,6385,10223,49,2030,478
16,4,12,1,18,191376,275,7,3886,554
13,8,5,0,5,223488,0,0,0,622
25,5,20,1,6,5673,2605,53,3708,498
17,7,10,3,13,585564,54703,92,40790,533
12,5,7,5,25,77416,92913,90,40750,477
35,12,23,9,11,637707,590010,224,26737,442
11,7,4,0,11,1076710,0,0,3357,608
46,7,39,1,9,117796,41470,1,1877,592
6,4,2,2,14,25181,733,21,6118,458
11,9,2,0,16,509381,0,3,2726,653
23,17,6,1,17,9153830,105,0,0,617
4,2,2,4,11,12982,18514,52,7000,490
20,6,14,0,18,520405,0,11,335,652
30,8,22,3,9,294725,15275,139,6783,482
3,1,2,1,8,15260,15260,26,327,494
186,10,176,6,13,213380,57019,170,26132,415
29,11,18,4,19,213025,48444,48,22941,519
10,1,9,1,10,9300,9300,15,9300,494
22,14,8,1,6,578124,495,2,0,603
10,6,4,1,4,353096,20255,3,0,428
10,6,4,6,7,69651,63421,86,23226,493
8,6,2,1,18,51827,27279,25,0,594
6,3,3,0,7,29817,0,5,0,638
11,4,7,3,69,77418,57974,34,55094,491
2,0,2,0,13,0,0,0,1842,677
8,4,4,4,15,20129,27591,77,8443,610
13,4,9,2,9,57209,46934,62,2341,451
13,7,6,3,24,89533,89291,84,2553,484
21,8,13,3,16,163122,44002,65,25019,436
50,12,38,13,8,102375,101837,453,52221,420
24,6,18,4,18,685521,230584,92,51181,512
14,8,6,4,17,33216,31226,91,11776,516
27,8,19,1,15,112688,5167,28,5167,641
17,11,6,1,3,52225,3981,19,175,593
26,10,16,5,10,46714,16650,293,10579,415
12,5,7,4,13,56956,58562,62,6822,489
7,5,2,1,69,11651,2318,22,0,448
54,11,43,7,9,530062,73373,20,0,435
5,3,2,2,7,1564,10079,36,0,514
31,9,22,4,11,35590,26580,100,9024,497
11,4,7,3,10,39313,154013,22,3872,490
15,5,10,0,14,12581,0,0,2399,626
21,7,14,5,14,475122,115955,124,0,501
11,3,8,5,18,30975,39339,316,18584,520
23,3,20,0,17,6491,0,28,424,639
9,3,6,0,6,7122,0,1,15,636
14,7,7,3,8,15214,14427,65,2080,428
8,5,3,3,10,20866,17570,13,2211,503
33,7,26,1,17,90360,9441,122,9441,617
9,5,4,3,6,4296,9121,38,1500,508
28,11,17,4,12,129053,86665,51,13184,424
11,3,8,6,9,125764,158701,91,4183,473
39,9,30,7,11,236551,14690,149,10013,476
9,3,6,1,15,128465,15890,13,15890,508
11,8,3,3,5,536684,15466,22,781,543
10,8,2,5,16,26705,19541,64,4839,468
8,5,3,2,10,308964,6346,45,3173,611
11,1,10,0,3,7935,0,5,3937,518
5,3,2,0,4,115905,0,4,0,541
15,1,14,0,16,0,0,11,1170,671
110,11,99,2,69,85201,16631,73,10090,465
34,12,22,2,14,441471,1458,34,2626,482
13,8,5,9,21,81448,80882,47,11039,466
11,8,3,4,16,379663,46569,92,6014,459
17,8,9,0,7,169086,0,15,5149,544
8,6,2,0,16,1281841,0,7,0,632
4,2,2,3,7,3360,5375,0,0,510
17,6,11,1,14,505363,27527,55,0,489
7,4,3,0,10,2759,0,0,0,583
18,5,13,4,20,24543,3298,77,843,483
38,6,32,3,13,472980,110865,23,32573,401
29,6,23,3,6,55820,3331,342,2811,523
12,8,4,5,19,17704,14588,119,5663,417
52,17,35,9,14,280979,139153,115,85676,445
10,4,6,7,16,219679,249989,144,0,547
19,11,8,9,17,928761,738003,196,0,507
6,4,2,1,15,15250,10453,25,1755,644
14,7,7,7,6,40803,22972,21,7523,451
8,5,3,0,9,14451,0,33,2717,610
25,8,17,2,24,242672,99115,55,0,636
20,12,8,6,14,321205,167502,75,1979,497
7,5,2,1,10,175928,333,0,0,631
8,3,5,0,8,21703,0,22,0,658
15,9,6,2,12,182536,71947,29,47312,527
11,8,3,3,7,332733,10633,290,11874,506
5,2,3,1,6,465400,22584,25,22584,531
8,6,2,5,17,138171,26639,24,17614,438
15,6,9,5,9,553289,63265,92,0,455
11,2,9,1,8,430,430,43,430,578
29,15,14,12,6,364241,56808,83,9301,407
35,7,28,3,10,217746,28819,190,15754,474
16,5,11,3,23,639731,18924,58,12324,639
24,11,13,9,7,285730,52402,159,17558,512
13,8,5,5,9,63249,14004,98,9272,497
24,5,19,2,19,29672,6086,24,8630,440
18,5,13,0,17,2071,0,0,10491,543
3,1,2,1,6,1972,1972,11,2380,524
21,11,10,8,8,667332,47166,160,23054,389
11,3,8,0,12,33754,0,5,4245,697
9,6,3,3,7,76765,20920,75,0,558
12,5,7,3,8,5070,4986,215,5130,432
13,8,5,6,5,25363,23420,141,12282,485
126,15,111,7,21,211110,51416,548,41364,455
45,7,38,3,9,75492,25057,108,42519,427
12,5,7,9,13,420362,449002,0,0,472
6,3,3,2,5,4200,1290,9,789,691
14,6,8,3,13,77399,19812,45,11323,625
48,9,39,1,11,243244,2500,105,7025,531
15,7,8,4,4,44041,6811,142,3880,442
59,2,57,2,18,19894,13121,209,44308,401
8,2,6,3,5,2152,21097,34,803,448
13,5,8,4,7,17252,14536,83,9197,433
21,6,15,0,14,116562,0,0,245,701
25,8,17,3,14,286548,12171,91,9610,427
36,6,30,0,5,67284,0,39,3096,464
22,8,14,4,10,109999,17043,46,8282,459
12,6,6,1,15,125009,686,32,0,528
16,3,13,1,8,116406,27943,31,806,447
8,3,5,0,2,15154,0,1,0,491
23,11,12,12,8,115961,127631,318,29814,442
13,11,2,12,4,216612,65574,104,10883,440
5,2,3,2,10,115320,130057,33,115320,663
29,15,14,15,9,401307,217920,16,30165,407
8,2,6,2,12,24622,24622,42,23766,446
24,11,13,13,30,661924,88281,177,29999,417
25,6,19,6,9,377052,66733,81,28623,466
34,5,29,2,13,54612,9898,3,7137,574
15,11,4,0,10,861267,0,5,0,542
4,2,2,1,3,2416,2390,0,0,600
51,16,35,10,15,115667,32163,285,4831,448
7,4,3,2,7,19248,19248,139,17998,578
20,5,15,6,8,70348,64865,69,0,481
6,2,4,1,8,2336,2336,20,0,482
12,8,4,6,9,52832,35624,75,7968,450
5,3,2,0,3,24840,0,6,312,631
5,3,2,3,13,1578,15845,28,7935,651
8,5,3,5,11,253704,56291,89,0,527
9,7,2,5,24,35447,41921,0,0,564
11,3,8,2,5,21680,10588,0,0,459
9,4,5,3,9,2610,2610,18,1551,504
15,8,7,3,11,23877,9380,80,5737,451
19,11,8,12,15,289375,333081,252,1577,476
16,7,9,0,14,434098,0,2,10912,511
12,5,7,6,8,73562,86053,98,9223,425
21,2,19,0,9,11482,0,16,1481,545
13,5,8,2,18,201685,4329,62,4374,491
15,10,5,9,7,28922,34613,160,3298,440
33,7,26,0,9,33146,0,97,4655,572
23,4,19,1,7,483190,5129,0,0,468
4,2,2,1,8,4223,2620,25,0,564
38,17,21,0,15,553394,0,18,713,560
16,4,12,2,8,4743,2063,14,1440,411
12,3,9,0,21,177069,0,8,4382,671
12,9,3,6,7,381121,129066,87,0,466
7,4,3,1,4,9509,1281,94,2570,471
62,9,53,2,15,124584,6958,61,3411,546
12,6,6,3,17,107655,4301,14,1810,557
9,3,6,1,14,31110,8385,11,13029,547
26,13,13,0,23,243093,0,4,0,679
8,4,4,2,8,16068,14123,17,4181,471
30,6,24,6,18,35318,31556,380,12229,511
14,5,9,2,18,188792,21175,122,13422,517
21,14,7,15,7,130727,127867,297,17267,484
4,2,2,1,4,45212,3681,0,0,479
20,12,8,7,14,266686,262535,146,24314,493
7,4,3,2,22,156261,5676,11,994,460
30,20,10,12,13,918768,769217,283,0,508
30,10,20,5,8,20991,15070,41,2917,590
20,11,9,13,15,425997,344939,271,0,491
13,9,4,6,9,485043,234411,43,1240,481
17,9,8,1,9,579026,28415,19,28415,469
32,11,21,1,18,711771,11801,5,11801,444
32,10,22,5,14,110802,72696,80,0,516
27,8,19,3,10,110924,14723,86,3813,440
7,3,4,2,7,13925,13925,16,1077,667
21,11,10,3,14,232157,7210,49,5569,458
19,15,4,14,10,413872,113724,125,10701,424
53,15,38,12,8,644660,483005,45,4422,481
23,9,14,0,16,2433039,0,2,47787,689
11,5,6,3,14,23686,3207,14,1998,481
5,2,3,2,7,12130,11135,48,8125,490
24,9,15,1,24,417850,1338,18,8148,434
18,9,9,3,13,560917,95781,33,38967,526
5,2,3,3,6,1612,1612,17,764,580
16,9,7,3,28,382570,3417,8,1139,431
38,12,26,15,19,565033,585877,260,7258,421
36,5,31,1,14,133845,117711,13,117711,452
14,9,5,1,13,259921,6371,105,8006,523
12,5,7,4,18,217076,298650,97,182109,457
21,6,15,4,13,251618,15001,75,18114,431
23,12,11,4,12,128575,11777,115,2220,528
20,7,13,0,16,206554,0,0,0,709
28,5,23,3,12,114452,114084,87,0,461
37,11,26,1,9,158812,43855,2,0,479
55,19,36,5,9,612918,18883,70,9051,441
9,4,5,0,3,202963,0,1,2500,562
12,9,3,1,6,61752,683,13,2442,524
52,15,37,3,29,424372,22827,73,11702,460
12,5,7,2,7,40027,4059,56,25396,425
9,4,5,0,7,82272,0,0,0,580
11,5,6,2,10,227635,29044,21,28266,516
31,4,27,3,11,21267,595,522,6505,591
49,6,43,2,5,51554,17007,37,8341,494
29,12,17,9,10,59841,52996,379,12983,418
10,4,6,2,11,286677,5320,36,0,679
10,7,3,2,6,38584,9455,10,983,464
13,6,7,4,11,1512757,477700,86,15200,486
15,8,7,7,12,49227,49227,25,6284,419
52,8,44,3,17,328061,180734,54,88477,472
18,6,12,2,17,73825,37499,145,24306,448
30,11,19,9,8,138094,102464,264,47336,453
56,12,44,6,10,222304,39251,85,5822,494
26,7,19,0,6,237415,0,12,800,594
14,9,5,1,23,174186,5297,11,125,522
10,7,3,4,7,140392,58605,96,0,609
5,3,2,1,20,117963,24663,11,0,489
10,5,5,4,7,9707,3349,32,1406,478
9,3,6,6,7,29798,57246,105,6730,482
5,2,3,1,12,100170,6411,0,0,632
14,3,11,4,7,54012,18231,51,9911,502
12,8,4,3,14,186399,5603,47,4583,470
12,4,8,4,9,119831,140669,71,0,528
15,11,4,11,10,734434,874052,0,1647,493
8,6,2,4,7,32258,26202,74,687,501
8,5,3,0,8,649300,0,0,0,597
39,15,24,5,9,213531,44935,55,29557,506
12,2,10,1,7,5165,3759,51,3759,447
31,6,25,3,17,751847,245310,89,0,497
5,0,5,4,8,17212,24731,32,0,607
8,2,6,2,14,8469,2479,44,3287,494
22,9,13,0,13,275898,0,3,0,534
23,16,7,1,19,788545,1270,17,810,622
19,5,14,4,14,110198,54028,92,3745,556
13,6,7,5,9,53543,30806,29,4921,476
9,6,3,1,10,424458,6991,12,6991,512
19,10,9,2,8,173170,7304,193,6918,528
11,8,3,2,4,101358,823,73,962,499
14,4,10,2,13,13065,11445,67,0,593
17,9,8,3,13,28395,22152,9,17448,440
14,10,4,1,5,318805,504,6,1876,454
37,10,27,3,28,298833,2873,30,0,492
16,5,11,2,9,35987,7433,26,1568,491
8,4,4,0,10,21409,0,12,18880,429
78,23,55,11,11,110166,53526,291,4300,413
5,3,2,1,12,4863,1363,1,1363,482
7,4,3,1,12,22038,552,41,552,664
7,5,2,0,15,401897,0,2,0,715
22,6,16,3,15,51329,18710,108,3493,453
8,6,2,0,6,132035,0,1,100,616
12,2,10,2,17,288757,24223,0,1557,528
44,15,29,8,13,364902,17080,440,6007,484
28,12,16,2,10,54785,4490,4,6822,402
4,2,2,2,14,43822,43822,24,42103,505
10,7,3,4,27,167798,166925,74,1710964,476
25,6,19,3,13,162540,43674,17,0,525
9,5,4,6,10,61549,69434,52,0,515
23,8,15,8,25,42988,42988,400,40882,433
7,4,3,4,8,25096,24546,8,2211,491
11,8,3,0,10,165286,0,0,0,570
31,14,17,1,12,2227901,985,8,1960,466
11,4,7,1,16,65527,277,6,860,577
5,2,3,0,18,382969,0,0,0,592
4,1,3,1,6,876,876,7,876,556
17,5,12,3,16,676078,676078,45,2189,456
39,10,29,6,11,393146,37023,68,17122,435
11,9,2,7,13,23185,23185,135,6403,408
5,2,3,1,6,60961,15703,14,0,557
66,4,62,0,6,33779,0,26,2840,437
24,12,12,2,25,639691,546403,41,1598,572
24,5,19,3,13,21969,63965,134,13011,564
60,10,50,7,16,14958,73619,215,21107,464
8,2,6,3,14,25114,26702,28,24018,501
50,7,43,2,11,61341,3095,41,1519,509
19,4,15,3,28,112955,56574,48,0,503
17,7,10,2,10,49623,2295,31,3322,432
8,4,4,4,12,32144,27116,39,10885,462
7,5,2,6,12,63753,77532,95,30030,552
45,24,21,14,23,1793141,2796382,248,0,469
29,13,16,16,10,107699,184005,285,22665,417
10,2,8,1,14,4605,4605,0,0,579
56,15,41,0,11,410531,0,34,1166,489
15,9,6,0,9,365220,0,0,0,553
11,5,6,2,2,13593,1549,28,3211,507
16,7,9,4,11,9838,9838,31,18928,456
21,4,17,0,8,69116,0,28,0,463
53,15,38,10,12,198340,164987,354,41904,420
33,7,26,0,26,182162,0,126,2540,683
20,5,15,7,9,104214,101213,186,9872,486
32,15,17,1,15,421918,2819,30,5636,440
26,9,17,6,12,53651,25580,297,7541,508
13,4,9,0,9,29233,0,12,152,711
23,4,19,3,14,11172,11172,406,164838,418
5,3,2,0,6,65394,0,12,200,469
6,2,4,1,9,1063,1063,20,1063,627
19,10,9,5,10,493410,57312,113,30332,483
33,10,23,3,13,227136,17778,31,31447,396
9,6,3,5,6,75503,68064,88,1979,563
14,11,3,4,3,169745,18441,62,12509,386
10,6,4,5,11,296080,102421,87,2550,541
5,3,2,1,5,18841,1095,0,0,475
14,5,9,0,11,372667,0,7,3302,427
8,6,2,1,22,218137,1469,17,1469,549
17,9,8,6,11,86380,38698,413,5505,475
31,5,26,4,15,497222,8332,81,0,478
15,7,8,1,14,53501,449,7,0,608
13,7,6,0,16,238447,0,0,0,605
14,7,7,4,8,47290,47290,99,21690,476
20,10,10,1,6,168790,572,8,850,553
23,7,16,6,7,41517,32894,46,20496,480
10,4,6,6,5,39668,39475,84,2338,543
13,8,5,5,15,720132,22895,55,47417,446
24,9,15,0,14,170175,0,19,854,581
26,9,17,9,11,42779,78174,165,6652,446
38,18,20,5,6,823025,5821,88,313,487
6,4,2,3,8,13835,13835,301,16611,498
14,4,10,3,5,6030,6030,24,2350,472
29,7,22,7,21,85965,195190,226,61368,439
40,17,23,7,15,119674,32886,63,11210,494
15,8,7,1,7,184994,5540,19,0,470
3,1,2,0,14,309201,0,0,0,655
17,6,11,9,9,225115,536946,183,172759,436
8,1,7,1,14,45570,29591,15,29591,540
43,6,37,5,19,28114,11698,254,6958,564
11,3,8,2,14,12073,12073,12,11763,515
31,6,25,4,11,29869,11151,53,1436,460
14,6,8,5,4,89334,19957,100,7193,437
11,5,6,2,8,167,14176,27,3739,554
11,4,7,2,17,275021,169051,43,866,562
19,6,13,2,4,63560,2898,90,2603,489
22,9,13,5,15,425389,13220,155,2670,481
12,8,4,7,9,57700,53237,124,15825,378
11,3,8,2,19,109554,6065,16,0,607
14,7,7,8,16,35843,38655,239,5928,470
6,4,2,2,20,56769,31561,18,12088,491
3,1,2,0,10,94,0,0,2000,691
31,4,27,3,9,28234,44334,98,12059,484
24,10,14,2,12,571204,53822,79,33510,449
9,3,6,3,13,26575,26575,23,9223,471
16,6,10,4,13,260398,19699,62,10167,454
25,7,18,0,21,602767,0,127,7014,463
9,6,3,3,11,66181,65681,62,23462,559
14,8,6,5,14,329201,116879,103,30956,450
13,6,7,5,11,51323,41832,243,22479,455
5,3,2,0,4,17874,0,1,489,582
20,9,11,2,14,59429,21544,240,1796,459
12,5,7,2,7,18711,103162,23,0,640
9,7,2,4,5,42360,8935,72,5574,438
12,7,5,5,21,181736,132386,15,3409,465
13,7,6,3,4,36339,16579,15,198,464
28,5,23,4,13,63418,26800,35,3472,622
8,5,3,3,18,121063,121063,72,88810,449
5,3,2,2,7,285136,3279,30,122,557
17,3,14,0,13,184040,0,0,19,578
54,9,45,8,11,245839,241967,286,148098,418
46,9,37,7,9,33238,29249,66,8815,488
9,6,3,1,25,94679,58021,24,0,460
41,14,27,13,11,899488,686403,187,4701,397
8,3,5,3,19,259687,12034,33,6500,567
15,10,5,7,12,44446,20341,70,6721,437
23,8,15,10,10,74865,108876,471,23324,427
43,2,41,1,7,21107,2511,35,569,535
6,3,3,2,13,399102,18646,26,15006,511
31,20,11,1,11,782879,976,1,976,473
3,1,2,1,5,14136,1398,26,1398,540
19,12,7,1,6,103310,2262,129,5670,561
7,4,3,0,12,402873,0,0,0,538
13,5,8,4,10,305346,207146,87,18351,428
24,14,10,1,11,328967,1476,33,423,643
40,3,37,5,8,270330,269079,61,224648,501
20,5,15,5,9,250880,250880,132,1739,488
50,6,44,8,17,46460,71828,179,34402,408
9,3,6,2,11,127543,186929,67,0,549
19,8,11,6,9,514022,137313,219,23406,484
26,9,17,8,16,185864,153860,128,25482,373
7,2,5,1,13,1444,1444,12,1565,645
8,6,2,4,12,133493,97975,30,0,510
9,6,3,0,3,174576,0,0,0,633
12,6,6,5,9,20235,20235,345,12036,455
8,1,7,0,6,3455,0,0,0,613
14,10,4,5,7,49748,18345,232,10800,432
12,3,9,7,12,181935,319559,98,137624,528
18,10,8,2,19,255374,9571,42,3098,543
5,2,3,2,11,66900,68101,0,0,545
6,4,2,3,12,402162,42055,28,26076,486
21,7,14,0,8,53406,0,3,0,538
34,6,28,1,7,116752,10998,60,0,486
11,2,9,2,9,7808,6508,33,4458,577
5,2,3,2,7,10952,10952,16,7826,599
4,1,3,0,2,20971,0,0,0,652
15,8,7,3,9,219197,68670,1,780,466
3,0,3,0,7,0,0,33,498,538
8,4,4,0,23,305772,0,0,0,681
34,6,28,1,13,97720,8825,16,10272,529
7,5,2,2,14,10110,5342,11,3702,452
59,19,40,3,13,283194,42520,74,7876,440
19,6,13,3,14,22516,8328,25,22926,558
23,13,10,16,23,315394,358172,90,172926,421
20,6,14,1,10,40190,7633,25,486,592
22,11,11,0,7,858135,0,0,0,683
6,3,3,1,7,166366,166129,37,0,528
8,3,5,2,17,24674,24674,0,0,535
12,6,6,8,25,144651,349515,0,0,535
9,6,3,4,2,73632,9536,30,3395,464
13,6,7,4,8,316417,22147,11,10456,465
17,12,5,2,20,411564,4152,14,1849,460
9,3,6,1,5,13692,943,8,943,523
6,3,3,0,9,32230,0,0,0,627
8,3,5,2,9,19399,19399,98,18237,605
26,3,23,4,11,11513,9635,27,3504,452
14,8,6,4,12,280896,42424,100,2415,483
28,7,21,3,10,77730,12943,35,19799,516
13,5,8,3,11,59832,24025,148,10770,539
27,7,20,5,9,539518,61704,0,0,509
15,9,6,1,8,162590,1331,0,0,548
11,6,5,5,7,19977,15958,111,323700,394
22,7,15,3,8,107352,15346,1,4221,494
36,7,29,4,10,120629,78809,60,107,466
9,5,4,0,9,721327,0,0,8926,624
10,8,2,8,5,55699,55165,299,15156,446
8,3,5,4,8,21856,34096,106,10214,491
8,5,3,7,9,194138,211779,156,0,549
14,7,7,3,12,229230,22154,88,980,472
18,8,10,6,15,103126,119703,113,2480,505
11,8,3,0,8,65799,0,0,0,580
16,8,8,6,9,94437,37566,65,2328,501
21,3,18,3,9,75114,75114,60,55674,505
12,8,4,6,9,436055,72121,0,0,457
7,4,3,0,4,31310,0,0,0,642
10,6,4,5,12,283442,110573,51,75746,486
25,10,15,9,8,93860,74577,91,7098,424
20,1,19,1,9,3036,3036,20,0,543
9,5,4,0,28,322847,0,14,3002,591
23,10,13,4,18,717239,24107,31,3547,474
17,7,10,0,7,231084,0,3,2688,619
16,6,10,5,9,21371,19568,111,7210,459
20,9,11,7,16,305310,86372,170,8772,534
19,7,12,1,19,488110,24569,26,427,483
6,4,2,5,11,66644,54265,0,0,460
5,3,2,2,6,36034,5446,23,4966,468
7,1,6,2,5,3641,3641,26,2765,513
16,5,11,2,13,237724,17919,73,4149,498
51,6,45,1,8,19146,172,89,1854,558
13,5,8,3,13,17850,14915,25,10510,453
11,8,3,6,17,487155,65159,83,24603,425
12,5,7,0,15,1483235,0,13,0,548
17,5,12,3,21,467583,250115,89,0,557
24,10,14,12,18,608501,137821,220,31445,429
6,2,4,0,6,130264,0,0,0,663
13,5,8,4,6,10153,8629,187,5692,415
6,4,2,4,6,466553,81091,65,0,521
41,5,36,3,14,20864,10780,22,5263,513
15,8,7,1,12,407944,9019,25,700,545
18,14,4,11,6,1642435,338793,158,484,437
12,5,7,3,4,15876,7924,7,7093,561
25,8,17,5,7,333552,171702,81,398,487
29,4,25,3,12,58212,1430,191,1833,528
11,6,5,5,12,303166,24641,10,4980,433
9,6,3,5,12,349953,83972,18,0,456
15,8,7,6,9,13535,35395,41,2984,443
3,0,3,0,12,0,0,8,0,639
6,4,2,3,9,6725,11824,53,545,493
10,8,2,1,19,750180,171938,22,0,587
10,6,4,5,12,24689,26690,154,17020,486
9,6,3,0,5,72775,0,0,0,633
20,6,14,10,9,327599,223177,6,33286,442
8,1,7,0,14,0,0,216,2108,540
23,4,19,5,9,67039,69487,73,48344,428
13,3,10,1,11,19541,172,6,351,608
9,6,3,5,7,27100,10025,64,1428,481
21,6,15,5,9,409546,18346,77,4275,451
18,8,10,7,5,37684,54145,56,1776,449
18,8,10,3,12,199328,152621,23,137864,459
48,7,41,6,19,52529,52529,619,23766,487
4,0,4,0,14,0,0,10,9405,600
11,5,6,4,15,231919,22512,44,3980,490
21,5,16,3,18,6775,6309,313,6725,516
11,6,5,1,9,234426,571,28,0,512
3,1,2,0,27,0,0,17,20875,493
10,2,8,2,14,4184,4184,10,3309,433
12,3,9,1,12,18530,14625,20,433,516
18,6,12,5,18,121182,121182,98,75900,398
63,13,50,17,14,909681,1280879,362,0,477
38,13,25,3,13,240582,39896,182,13870,519
6,4,2,0,7,92523,0,1,0,577
6,4,2,3,5,22373,420,23,744,572
14,5,9,1,8,136796,800,28,0,501
29,2,27,1,19,18743,7290,34,8219,519
10,5,5,6,8,85640,70354,0,0,451
20,5,15,0,13,42113,0,22,1085,666
6,2,4,2,9,12736,11021,40,9617,682
34,7,27,0,12,42320,0,43,4788,647
7,3,4,2,8,14982,9629,27,22236,492
9,4,5,4,7,19348,5744,30,522,529
11,7,4,3,8,8121,3942,82,1810,467
21,6,15,2,5,35734,6515,112,4275,449
22,5,17,2,24,878676,1104,54,5458,468
4,2,2,1,5,12888,6980,24,876,664
47,14,33,6,14,142434,980,21,327,521
12,4,8,2,10,871399,5260,80,14900,454
10,6,4,6,15,511189,55860,93,9842,539
10,8,2,1,12,85192,19663,39,19663,488
3,0,3,3,5,33291,33291,75,0,553
12,3,9,4,5,9561,12810,62,6678,487
11,5,6,0,12,506453,0,1,0,607
15,13,2,13,14,103385,102086,180,8898,412
9,4,5,5,8,358474,358474,162,119553,474
7,3,4,4,13,28176,35241,14,15187,553
30,7,23,3,10,258539,7722,128,4794,496
39,6,33,6,15,704645,18286,14,3706,494
83,20,63,1,13,295637,2595,35,7526,502
7,4,3,3,11,12112,32383,24,10922,505
4,2,2,0,1,16375,0,0,0,624
30,14,16,9,14,852517,168934,289,11703,427
56,16,40,6,8,397695,31554,36,2352,527
7,5,2,2,13,452976,112169,38,116,459
11,3,8,1,11,101384,1715,48,1327,518
26,14,12,12,13,121514,111937,205,42728,455
18,12,6,2,6,236784,3082,117,624,447
56,14,42,7,8,63067,26978,148,13659,451
3,1,2,0,12,0,0,1,2516,632
19,6,13,4,14,120370,120349,92,51957,482
21,13,8,5,8,74343,14339,88,7504,515
34,3,31,1,12,23895,4696,30,4696,469
9,5,4,3,10,20032,12300,74,2450,452
26,10,16,2,14,368520,6292,20,2882,493
14,7,7,5,13,33099,20375,43,6299,452
8,5,3,0,10,0,0,23,2874,647
17,9,8,1,11,226930,3720,0,0,466
12,8,4,0,9,577723,0,6,1142,622
57,15,42,2,11,510186,7380,112,8436,498
12,4,8,2,14,399638,23870,14,0,608
8,4,4,3,19,24770,37191,16,4204,552
12,4,8,1,6,20540,1,35,2482,486
19,6,13,6,7,45330,45330,92,16450,514
141,13,128,11,48,244265,162031,374,14971,488
191,12,179,2,7,192074,12337,187,2862,491
16,11,5,8,7,82415,43962,99,10573,484
6,2,4,3,6,92307,119778,49,90348,425
73,7,66,2,19,222295,10686,133,10413,486
15,7,8,1,13,46975,856,1,1184,562
19,8,11,8,18,438814,36848,201,5603,460
17,9,8,9,18,323202,58275,125,11520,465
8,6,2,2,7,62624,4598,24,3430,594
37,16,21,0,14,144857,0,55,9530,646
12,7,5,5,9,226684,33077,73,25719,470
7,3,4,4,14,281079,38449,37,11351,521
6,3,3,4,9,8868,19090,135,5311,535
7,3,4,3,7,15728,15728,119,8017,466
5,2,3,0,6,176400,0,4,1918,681
37,12,25,14,13,2023901,1751976,364,519387,420
21,9,12,8,8,36122,36122,184,8678,558
10,7,3,5,8,40352,54556,92,10880,478
5,3,2,0,4,33116,0,0,0,591
12,3,9,2,8,237404,17479,63,2682,509
12,4,8,4,19,53703,41958,44,1679,527
17,12,5,0,2,135745,0,3,189,611
28,13,15,8,15,82198,36847,1,13666,501
8,6,2,0,10,33143,0,3,0,566
47,8,39,3,14,37361,15395,44,8384,487
18,8,10,7,17,28172,15701,116,6285,423
3,0,3,0,4,0,0,18,0,629
66,11,55,0,14,230560,0,4,9164,542
11,7,4,1,9,10048,3766,0,0,524
9,4,5,6,11,10086,15097,91,5408,493
3,1,2,1,7,25843,25843,117,25843,632
7,4,3,3,14,215017,215236,72,165233,503
5,3,2,1,8,365672,1623,14,1623,556
8,5,3,3,18,10447,90269,67,3730,539
14,3,11,2,5,15089,14346,107,13086,562
7,4,3,5,12,71627,98233,93,36425,502
44,6,38,4,14,329534,30130,121,11128,464
12,9,3,1,5,257576,601,1,601,543
10,5,5,5,8,60142,12929,99,4112,466
19,6,13,3,19,280881,11266,74,9718,429
36,7,29,3,9,130747,73201,39,67103,436
13,5,8,4,13,35558,37557,49,18187,593
62,16,46,1,22,482483,620,118,1410,519
16,6,10,4,11,378795,71565,56,8152,471
9,3,6,2,14,218124,985,30,2132,544
35,10,25,3,14,191357,1101,150,1710,512
9,4,5,3,8,96580,35975,18,0,432
43,6,37,5,16,114712,93414,176,12325,457
6,4,2,2,13,40713,2536,26,2217,546
51,11,40,0,14,570028,0,13,638,666
12,3,9,0,13,9293,0,0,3511,683
9,4,5,0,7,95847,0,0,0,631
17,4,13,2,7,40477,31352,42,2793,544
36,13,23,10,9,807455,213212,147,6766,492
16,9,7,8,10,74379,29158,143,21367,477
14,9,5,4,14,123427,76593,51,44566,462
16,5,11,3,10,29336,14770,101,11085,521
31,11,20,1,13,215544,2399,47,2399,578
33,7,26,1,14,9326,202,112,3968,483
22,9,13,10,11,53293,64861,327,39386,424
19,2,17,1,11,12729,12729,37,884,485
6,4,2,0,3,174937,0,0,0,643
5,3,2,1,14,114278,7921,23,7921,654
14,3,11,1,7,53577,16018,16,16018,654
15,9,6,9,19,591005,176453,172,31706,391
9,5,4,1,12,41542,16254,26,11433,502
8,5,3,4,6,19801,9631,48,4569,446
16,4,12,4,9,16693,17337,80,12872,609
11,4,7,1,12,145879,29199,20,1367,615
8,1,7,1,17,4172,4172,10,4172,505
20,4,16,5,14,546537,148538,93,18900,498
13,2,11,1,13,101631,92876,12,92876,515
25,13,12,11,19,1501525,2430585,278,438145,485
5,3,2,1,5,22019,4689,5,4689,509
10,4,6,3,16,784282,189132,40,0,481
27,10,17,3,10,581791,128718,65,3391,479
8,6,2,3,8,154427,6862,9,0,525
31,4,27,1,15,30170,8084,27,8084,672
6,2,4,1,9,0,7201,38,1378,648
7,2,5,0,13,835,0,14,1724,600
4,2,2,0,6,12360,0,0,0,703
46,9,37,4,17,303746,62114,363,30903,511
31,11,20,10,7,428053,47521,136,10231,407
12,8,4,0,6,33397,0,3,980,607
13,9,4,3,9,236385,2366,101,3314,481
7,3,4,4,8,90610,93598,16,57310,485
35,11,24,10,9,72289,51059,76,778500,452
8,3,5,0,8,4386,0,3,0,635
18,12,6,1,9,157327,15033,34,3350,494
21,11,10,0,20,352131,0,0,0,583
14,11,3,2,3,24745,3387,6,779,463
36,3,33,3,8,17171,17171,50,10241,597
6,2,4,3,8,24304,9027,0,0,456
11,7,4,6,18,61097,63854,100,26844,421
23,7,16,5,6,81374,51771,112,19273,507
3,1,2,1,3,143551,143551,7,143551,427
25,10,15,8,6,50840,57416,238,26586,406
5,2,3,2,8,29561,29561,67,0,486
15,6,9,4,17,45118,45118,76,21624,569
33,11,22,4,7,206214,31000,229,4580,458
34,11,23,3,10,266583,15131,0,0,439
5,2,3,0,7,83246,0,25,0,541
4,2,2,1,7,177027,35423,21,0,526
30,9,21,2,11,142785,11930,57,12385,472
10,7,3,6,8,361274,249353,6,6532,439
22,6,16,5,11,55819,59945,63,8327,488
15,9,6,0,5,408156,0,0,0,619
29,13,16,16,18,1900610,2056180,283,3583,485
5,0,5,1,6,0,17772,16,0,580
24,11,13,12,16,204415,167176,289,47512,421
16,3,13,4,8,17136,23011,80,13480,549
12,7,5,0,16,312945,0,0,115,626
6,2,4,2,2,4259,4259,19,3111,407
26,11,15,1,15,164212,7582,59,1639,587
17,14,3,10,7,204841,13098,70,3058,437
12,3,9,0,8,318152,0,18,0,585
23,12,11,0,10,769200,0,19,0,548
19,6,13,3,6,46716,5077,11,4329,446
13,5,8,5,13,126720,97605,12,3288,412
7,3,4,2,10,116277,88374,0,0,501
27,1,26,1,8,10839,10839,17,10839,610
17,7,10,1,7,590851,1269,13,0,476
28,6,22,4,14,240591,1733,408,11760,533
23,2,21,1,5,3633,6068,15,6068,661
28,16,12,0,25,156775,0,31,5837,689
9,3,6,7,18,30907,153168,145,22388,532
25,10,15,8,15,489963,476296,5,10825,388
38,11,27,0,27,1335942,0,7,0,558
20,7,13,5,17,246024,181277,22,135862,501
13,9,4,7,19,701853,131765,89,7161,426
9,6,3,5,6,41268,39204,138,13595,420
5,1,4,1,6,711,711,9,711,577
10,3,7,0,7,10289,0,3,298,672
4,0,4,3,6,17150,50760,66,0,608
10,8,2,8,7,54974,54255,145,12317,477
24,2,22,1,14,3201,3201,25,4095,500
8,3,5,0,5,152445,0,10,7784,639
13,8,5,4,17,619158,23829,2,1273,528
4,2,2,1,4,33443,1663,32,0,532
7,3,4,3,11,88847,88847,46,31877,552
23,9,14,6,10,23740,11326,58,3718,375
13,8,5,0,9,102663,0,0,0,700
11,5,6,3,6,11929,21292,162,6916,523
18,6,12,1,13,336725,42383,60,2293,479
41,10,31,4,17,91220,52702,91,32383,466
7,3,4,2,8,41738,10201,30,8473,497
33,9,24,5,7,49522,9069,38,1814,497
52,10,42,4,17,422441,35519,32,9413,422
14,9,5,0,5,591512,0,0,0,692
14,4,10,5,11,43430,43430,64,6010,536
8,4,4,4,6,21726,21726,54,19618,464
7,4,3,3,15,20384,17671,24,2898,495
11,8,3,5,8,110326,117214,17,1868,418
15,11,4,1,14,224055,288,25,0,529
33,8,25,4,10,159107,9855,64,5039,440
12,7,5,1,11,322228,8158,34,737,492
16,7,9,3,18,81251,13126,83,2907,455
7,0,7,0,12,0,0,0,0,625
7,5,2,6,10,121164,162324,124,0,446
32,9,23,5,10,66668,55108,266,27933,449
31,13,18,10,23,85934550,30467248,111,8557,502
16,7,9,0,23,680666,0,2,0,646
23,9,14,6,10,468037,58191,130,2554,451
15,2,13,2,7,54194,9622,47,2840,459
20,12,8,8,21,449270,88964,97,23524,482
12,5,7,6,11,202865,174517,117,156716,467
7,5,2,0,15,72233,0,1,9,684
17,3,14,1,8,448,448,43,965,509
23,13,10,7,6,474044,159677,173,998,437
5,2,3,3,7,52,8972,19,12274,522
11,6,5,6,14,34343,38598,102,23997,442
17,6,11,1,12,314116,1819,24,3524,533
11,8,3,6,19,47167,41419,72,2159,440
5,2,3,1,18,219266,4889,0,0,492
24,4,20,4,7,329642,24201,68,2853,529
57,12,45,14,6,496144,602985,281,134382,451
22,7,15,1,15,250423,65425,28,0,529
13,2,11,2,13,132094,113757,23,34416,609
47,6,41,4,10,308705,20143,77,11757,497
30,5,25,3,15,49458,18534,0,0,523
36,7,29,0,69,324296,0,2,342,709
12,9,3,3,8,342665,11105,45,1419,466
10,3,7,1,10,51534,7155,5,0,486
41,13,28,8,18,570405,182763,285,13636,446
4,1,3,2,8,6338,17001,41,6338,502
7,3,4,0,3,133126,0,1,1,649
20,8,12,0,26,517259,0,25,0,675
12,5,7,4,5,182199,31353,40,5726,458
12,7,5,3,18,168668,80440,41,76500,435
28,8,20,4,29,146180,48940,103,8497,525
22,11,11,4,17,84777,4361,20,1700,474
8,4,4,4,13,15855,19411,49,8392,406
7,4,3,1,13,350827,3529,0,0,508
19,8,11,4,9,261744,79896,92,3509,517
25,9,16,0,27,126577,0,1,495,691
219,11,208,1,16,1131369,3914,37,19876,649
5,2,3,0,8,494480,0,1,448,706
7,4,3,4,13,87832,87832,82,18012,502
33,7,26,5,17,674617,20995,36,7233,491
17,5,12,1,7,24542,11120,37,489,489
47,10,37,4,6,147178,10352,121,5356,552
3,0,3,0,13,0,0,0,0,627
11,5,6,3,18,460737,14577,47,7941,477
7,3,4,3,11,79819,78916,6,76705,545
23,11,12,4,17,1146157,53004,241,26891,453
7,4,3,0,4,50870,0,0,0,593
41,12,29,1,14,180854,4534,167,4534,555
11,8,3,3,3,305220,1131,22,612,508
22,10,12,3,11,336524,8193,49,3680,505
32,21,11,0,19,878745,0,12,1960,683
8,3,5,5,9,22907,43780,48,800,517
7,4,3,2,8,5704,5704,52,1730,619
49,18,31,19,13,587001,343325,384,7573,448
10,4,6,1,9,32737,11287,104,11287,640
18,8,10,5,12,287683,31417,84,20248,479
42,10,32,10,13,243512,284730,431,83355,484
5,2,3,2,3,3105,3105,12,2830,443
12,9,3,3,23,1296972,22632,24,1012,420
27,9,18,3,9,344933,9944,34,5329,605
15,6,9,5,18,159511,68518,227,21376,496
15,4,11,3,7,152393,35732,28,0,454
21,5,16,1,13,171341,616,12,775,539
27,11,16,11,13,424820,103613,60,22520,353
7,2,5,1,4,9852,4524,7,4524,488
25,13,12,3,12,347698,29914,0,0,496
20,7,13,4,18,533651,403396,61,0,518
9,3,6,2,9,101595,57865,47,0,517
9,4,5,3,5,53844,21658,49,8290,533
3,1,2,2,1,0,19106,12,15292,392
11,5,6,0,7,453660,0,7,0,591
5,2,3,2,7,9457,7264,36,0,543
5,3,2,2,7,48589,21949,122,18649,620
14,4,10,3,8,261562,38702,186,13696,570
9,3,6,1,7,8879,7651,101,9501,530
7,4,3,4,8,1743,10178,53,1016,500
4,1,3,1,6,13675,13675,27,13675,528
9,7,2,6,13,55050,55050,163,20902,506
30,13,17,4,14,88828,18141,32,4709,446
12,2,10,0,5,201250,0,0,0,642
9,3,6,0,14,227873,0,0,480,755
5,2,3,4,4,3811,17579,0,0,441
19,2,17,2,2,19791,287,52,1415,494
38,8,30,6,8,534117,19335,173,13227,392
7,4,3,2,7,28724,24815,78,24303,453
11,4,7,1,11,297125,10468,14,825,506
8,2,6,1,9,52100,4417,0,0,566
38,14,24,10,10,492805,373128,295,116093,439
14,9,5,4,4,524699,40384,25,18252,456
22,11,11,1,18,671493,164,2,164,578
8,4,4,3,19,13322,13322,9,4889,512
80,9,71,8,15,56875,40122,439,9532,415
10,4,6,5,8,37468,40544,238,8792,458
15,6,9,6,11,1405086,344783,0,0,469
6,1,5,1,13,403166,6572,23,3474,621
17,8,9,3,7,45055,10782,21,6623,503
20,6,14,4,13,28851,29871,72,3014,535
9,3,6,2,13,1114,1114,7,6340,526
39,8,31,4,12,9620,14464,120,16154,411
7,4,3,0,6,29627,0,5,0,618
10,6,4,4,8,3582,632,16,458,607
13,8,5,7,26,37139,37139,271,21750,462
41,7,34,3,14,298902,20643,132,6742,494
10,5,5,5,14,34062,30581,63,23086,412
8,4,4,3,6,8874,5138,35,2007,439
7,5,2,0,7,289481,0,3,0,610
10,0,10,0,8,0,0,12,368,638
26,8,18,1,16,774391,26701,25,531,555
10,6,4,1,6,45993,1838,2,1838,455
6,3,3,2,12,396956,18791,39,7457,506
9,5,4,4,7,20232,12614,145,7873,506
22,14,8,0,24,295324,0,10,1814,517
11,6,5,3,18,53597,49443,46,10939,397
6,2,4,1,6,10925,3706,12,3706,557
51,17,34,9,9,260621,26881,180,8503,422
10,1,9,0,8,16451,0,0,0,647
33,17,16,15,12,591502,100287,416,38740,416
16,2,14,1,19,9861,7219,21,6089,632
11,6,5,1,14,506245,512,18,512,480
24,14,10,0,14,947461,0,18,339,486
18,4,14,2,13,308142,60219,126,36011,624
42,9,33,1,15,454037,37498,20,230052,589
31,12,19,5,14,309539,155946,127,7828,448
10,4,6,3,14,36978,22704,53,2636,505
60,16,44,11,13,62738,35620,224,3705,443
7,5,2,4,14,130210,121228,71,55125,562
48,9,39,8,13,40539,40539,316,15561,431
15,7,8,1,12,51664,624,1,2974,522
12,6,6,3,47,6055,7257,1,1102,484
14,8,6,3,31,71915,73318,51,252,554
8,5,3,1,15,161334,581,34,0,537
18,4,14,4,19,22170,19405,32,6444,468
22,8,14,8,10,33045,40775,144,10093,454
30,7,23,1,17,379078,2344,11,2344,600
49,17,32,12,13,738371,393439,205,10298,429
21,6,15,3,12,33593,8001,25,802,466
11,5,6,1,14,172233,447,1,57208,604
8,3,5,4,12,12077,12077,113,5703,518
11,7,4,0,14,23329,0,0,950,664
33,9,24,0,9,37343,0,28,295,497
6,4,2,0,12,0,0,5,0,710
17,9,8,6,8,72509,67529,120,9565,460
17,10,7,0,17,391723,0,21,8916,667
13,6,7,0,16,489387,0,5,17136,606
79,9,70,2,8,199286,3313,38,13790,421
29,9,20,5,7,289924,20281,235,4768,493
14,6,8,5,13,38581,29458,99,13659,479
23,4,19,1,6,171020,808,33,808,449
24,3,21,1,7,179397,4679,6,0,528
29,7,22,4,14,204424,10886,105,3109,435
14,8,6,4,13,696134,87628,65,62348,446
27,12,15,1,18,307669,1844,16,0,557
4,2,2,2,7,16385,6904,49,5470,452
12,8,4,2,18,156556,155809,65,8145,521
16,6,10,2,16,51390,29291,42,0,528
6,2,4,0,16,103972,0,0,1589,650
9,7,2,5,6,20881,13223,63,2899,479
15,5,10,4,7,19256,19256,263,2092,527
27,6,21,4,10,74635,22581,74,11269,427
7,3,4,1,8,11603,3002,29,3002,555
69,25,44,17,13,520621,109035,370,33681,371
6,1,5,0,9,14884,0,0,0,670
50,8,42,1,5,288391,3381,2,0,526
6,3,3,3,4,15833,19395,28,16179,540
4,1,3,0,14,0,0,0,328,741
37,6,31,1,14,180357,28846,114,28846,455
27,3,24,4,13,20417,16616,21,8993,408
12,5,7,2,9,31570,13867,109,7709,553
53,6,47,8,13,661745,333023,138,18511,414
30,14,16,1,13,573873,11200,29,0,528
17,6,11,5,9,55010,52288,117,0,477
16,11,5,1,6,423863,96398,23,96398,661
11,5,6,5,11,376748,122682,26,101843,416
10,7,3,2,15,289534,86550,19,56550,421
15,3,12,0,13,14029,0,70,1388,677
14,4,10,3,9,834594,21979,55,121831,598
10,4,6,2,9,65110,64623,19,61283,462
20,5,15,3,14,139897,34558,64,0,529
22,8,14,6,11,45710,29363,143,24787,463
12,10,2,10,6,160724,137248,182,37373,493
21,18,3,0,5,163507,0,0,0,632
10,5,5,8,13,1846678,2774278,155,106053,566
13,9,4,4,20,12701,9766,50,3720,539
17,11,6,0,12,2071015,0,6,0,551
227,2,225,5,8,40622,40160,138,15921,461
85,14,71,12,13,108213,72493,242,10466,406
16,6,10,1,14,388564,12656,35,0,497
36,11,25,8,8,148942,83467,80,33673,528
17,5,12,1,3,16390,3038,15,3038,608
10,7,3,0,4,184075,0,15,3946,554
7,4,3,0,14,266362,0,0,2336,588
39,16,23,2,17,1548251,16000,61,1185,559
7,4,3,1,6,35453,13906,20,0,510
7,3,4,0,16,69597,0,0,0,712
31,4,27,1,7,14648,1640,62,3334,604
43,22,21,19,17,615083,258843,97,18063,482
28,7,21,7,40,74256,73570,72,53028,457
12,5,7,8,6,40632,61463,132,11189,423
23,13,10,9,6,258231,189746,8,1572,459
13,10,3,5,11,929852,11744,68,2025,450
20,8,12,5,12,101046,7787,118,4024,407
19,5,14,4,17,454878,58409,219,23335,577
17,12,5,9,8,357597,196676,146,1736,428
11,6,5,6,7,452873,34535,47,0,469
34,6,28,3,12,93422,4094,49,2950,526
6,3,3,3,9,33947,18683,146,17422,470
14,10,4,7,8,65536,21153,178,6157,446
52,7,45,6,14,30227,27744,136,7112,433
9,3,6,2,8,33167,22705,64,3888,529
25,9,16,0,13,236903,0,24,1522,551
14,8,6,4,17,62547,24456,88,13265,469
12,10,2,3,8,509395,48806,71,5084,477
64,11,53,7,17,352345,74230,242,43951,486
46,9,37,6,19,96720,46468,193,14949,446
8,3,5,1,4,5480,101,64,558,570
21,3,18,2,9,29623,28510,24,18490,635
14,12,2,2,8,727268,29323,27,950,547
20,12,8,5,16,290643,28069,50,3210,546
9,3,6,2,10,12873,7421,50,6348,498
20,13,7,10,19,134646,149590,189,15783,481
10,3,7,3,9,1392,18881,226,17958,594
11,4,7,5,6,27572,27572,138,12547,485
14,6,8,4,14,12827,10583,32,8701,460
11,7,4,7,6,18073,18073,393,8409,429
65,7,58,2,16,12574,6899,68,4799,460
13,4,9,1,15,13503,2914,4,17212,471
4,2,2,0,8,0,0,9,1311,660
15,1,14,0,6,0,0,82,6138,553
62,14,48,13,8,80076,50388,223,7597,421
4,2,2,1,9,9959,1628,23,1628,644
38,4,34,4,9,98123,68154,48,437,490
157,12,145,5,18,191542,131904,132,30684,456
14,5,9,4,8,42642,20411,94,19353,532
24,9,15,1,9,601147,156,20,1060,465
13,8,5,1,10,600733,520,51,520,405
13,3,10,3,16,5487,5487,38,2677,590
17,6,11,4,12,304601,40266,10,4874,431
20,8,12,3,11,774977,17379,98,3116,504
19,3,16,0,16,0,0,2,4973,588
15,10,5,2,9,972507,3743,0,0,480
13,2,11,1,5,20072,1145,20,2165,575
7,2,5,2,9,207598,5321,37,2778,599
66,10,56,6,16,44075,35801,117,18838,368
26,4,22,1,8,20876,1799,6,1799,592
8,6,2,2,13,439746,18293,39,14483,470
12,1,11,1,9,7786,7786,24,7786,571
33,15,18,6,10,1088875,85300,217,220316,429
32,5,27,4,9,70354,66784,125,27066,426
7,0,7,1,7,10733,10733,11,10733,624
15,7,8,0,8,446359,0,0,0,602
13,6,7,2,8,837705,9962,21,4122,474
20,5,15,7,12,52570,63247,136,23573,399
22,2,20,2,19,23785,23785,63,6381,484
14,10,4,8,11,67436,50153,333,13847,427
14,7,7,1,6,302551,3859,13,919,624
17,14,3,0,16,678463,0,3,180,551
16,4,12,1,6,4856,237,24,2184,408
18,4,14,1,69,5374,5374,23,6245,590
28,5,23,3,16,18465,3368,248,4172,594
21,8,13,9,16,65407,67171,72,15079,441
6,4,2,0,14,306593,0,11,765,609
12,8,4,0,7,123682,0,0,769,599
10,8,2,2,7,55556,20716,11,7746,418
4,2,2,2,4,4969,4969,11,4061,500
3,1,2,0,11,0,0,0,0,696
13,6,7,3,6,396598,8293,17,725,425
13,6,7,2,12,364579,31918,60,0,494
4,1,3,1,8,7328,7328,25,935,514
11,8,3,5,7,316744,54101,66,12831,479
17,7,10,0,8,41718,0,57,546,568
6,4,2,4,7,28014,26889,59,6435,520
20,4,16,3,8,642055,14549,137,9050,423
5,3,2,1,8,27900,27900,39,0,539
12,9,3,1,12,374711,10665,1,26207,650
19,7,12,6,15,19440,19440,85,5919,480
22,10,12,0,11,278235,0,0,0,679
35,8,27,5,11,47261,18635,153,7579,444
10,5,5,0,16,57402,0,15,0,689
9,7,2,1,4,138268,50,3,0,636
38,11,27,4,12,183353,37413,78,460,515
25,11,14,0,13,1222748,0,29,0,598
28,12,16,1,9,692824,4266,17,429,647
15,7,8,5,10,342367,44738,0,0,457
20,8,12,0,13,846975,0,1,0,650
9,7,2,1,3,50111,916,17,446,470
11,4,7,3,9,13689,16035,54,8326,486
10,4,6,4,11,9255,27367,73,0,520
6,4,2,6,8,22238,39459,297,12833,454
17,6,11,5,14,45212,46903,141,6620,483
13,5,8,1,13,187092,11752,70,11752,535
18,5,13,4,4,15181,10517,64,6933,353
12,6,6,1,11,350876,335,8,3219,517
7,2,5,3,10,9633,37443,68,2014,546
30,3,27,0,10,49864,0,24,2609,640
7,4,3,2,7,370748,8379,52,3532,494
72,26,46,16,13,564042,37140,119,510,443
21,12,9,10,9,179666,153718,183,6930,482
24,12,12,7,8,136722,126639,177,15989,491
13,4,9,2,16,121958,47800,13,15934,578
11,3,8,1,9,120765,1402,4,1402,645
9,4,5,0,13,553828,0,10,1156,537
10,2,8,0,30,0,0,5,1086,622
26,20,6,0,13,124677,0,49,4400,587
34,17,17,17,7,388323,387435,394,80942,411
59,6,53,4,8,201362,51739,55,19710,460
16,6,10,8,9,186933,200423,0,0,547
7,5,2,2,9,4469,84547,16,1002,595
16,10,6,12,12,547107,965826,222,163984,503
5,3,2,0,8,5076,0,0,0,567
5,3,2,1,3,32566,9766,12,0,428
10,5,5,3,12,376567,40090,26,21395,473
5,1,4,1,4,12207,12207,13,12207,508
15,10,5,11,13,62869,83685,118,14610,392
17,7,10,6,10,393733,39441,43,2409,427
14,11,3,7,7,257010,21708,366,11215,375
48,6,42,5,8,39782,25742,152,17913,449
5,2,3,2,4,14438,14438,0,0,453
15,4,11,0,2,42040,0,0,0,613
3,1,2,2,8,11990,24040,0,0,493
4,2,2,2,6,9940,16365,35,9940,529
34,15,19,8,48,152357,25373,275,3279,461
4,2,2,0,5,35767,0,2,0,638
18,5,13,8,11,749800,1182063,187,0,483
6,4,2,4,9,158600,133482,66,0,514
13,6,7,4,15,44643,56269,80,22318,592
18,9,9,10,6,63138,76028,83,12932,417
9,7,2,3,4,319148,10888,86,7932,451
5,2,3,2,13,4283,4187,0,0,555
26,14,12,4,9,303692,104738,118,23334,446
11,7,4,5,18,152550,74780,105,0,561
27,5,22,4,8,372103,38777,90,2733,494
20,11,9,1,15,252639,1932,13,2898,383
17,5,12,4,9,45341,41236,79,8124,453
12,9,3,5,12,119155,84146,65,29988,493
7,4,3,0,7,44477,0,23,0,502
10,5,5,0,18,62737,0,4,1101,683
10,7,3,5,9,17274,17273,53,9425,482
23,12,11,0,15,623751,0,5,918,648
52,16,36,4,28,1065769,213794,119,153739,468
7,2,5,2,6,11175,3156,44,8529,481
33,15,18,0,7,180622,0,15,237,644
27,12,15,0,7,1030339,0,2,0,607
8,4,4,2,14,26752,19279,37,638,525
4,1,3,0,4,0,0,11,0,608
10,7,3,0,13,259834,0,23,22076,567
9,5,4,3,13,96228,392561,87,13902,532
33,12,21,4,8,83837,45727,216,17498,411
26,4,22,2,18,79989,10809,56,17053,591
17,5,12,5,11,24815,24815,125,6250,424
14,1,13,1,8,7014,7014,30,7014,615
9,7,2,2,12,83036,16930,3,0,585
8,5,3,4,7,280363,215509,3,102182,439
66,14,52,2,14,335181,10817,298,9658,407
10,5,5,1,9,502053,1229,24,1911,597
22,13,9,8,12,107805,67381,76,35589,421
4,2,2,1,15,3884,360,0,0,588
22,7,15,3,9,116877,74364,119,32708,498
19,8,11,5,10,448107,36761,111,5447,454
9,4,5,4,10,33574,33024,54,0,483
7,3,4,1,13,13680,13580,32,14430,648
30,2,28,1,12,1902,2166,8,0,632
24,7,17,3,19,297676,15828,15,5695,439
27,17,10,1,29,421984,91,1,12,593
11,7,4,0,14,101767,0,1,4374,570
6,1,5,3,9,6333,26621,20,12487,482
5,3,2,1,6,18532,4171,14,0,690
29,5,24,3,7,23226,7551,80,0,551
23,15,8,2,9,772548,1469,24,0,468
9,3,6,2,8,63814,63814,21,31907,564
32,7,25,8,15,53520,76542,29,6050,415
8,3,5,3,9,14015,3599,34,2199,425
117,10,107,1,12,630592,88849,102,4170,479
21,13,8,12,11,301001,382874,158,108067,346
8,6,2,1,12,96875,711,27,0,547
11,4,7,5,14,11166,12946,71,3429,435
9,1,8,1,12,0,149013,0,0,621
25,7,18,4,25,189888,97127,0,0,580
16,11,5,2,11,319649,6648,16,1101,500
48,12,36,11,13,621803,1154091,463,6795,429
18,4,14,1,15,25538,3280,30,1202,460
6,3,3,0,2,41794,0,2,28101,594
8,1,7,0,5,0,0,1,0,715
4,2,2,0,18,6506,0,0,0,712
7,5,2,3,17,340966,70936,48,44459,502
11,5,6,0,11,1056,0,0,11370,600
13,10,3,7,7,456535,186658,79,0,502
7,3,4,3,5,31893,26251,45,1365,471
8,5,3,5,6,16269,11332,66,4864,431
14,7,7,7,8,29546,29344,56,7429,484
14,12,2,7,2,97548,17183,23,2118,328
10,1,9,1,5,5424,5424,9,5424,621
26,5,21,7,12,14094,27518,383,11324,498
9,5,4,3,6,53435,34886,172,885,489
7,4,3,0,13,279891,0,0,924,652
4,2,2,1,12,245865,41183,0,0,613
12,6,6,4,4,9141,7911,54,1118,439
12,4,8,6,10,94107,176072,25,15410,455
30,7,23,6,13,278309,69188,264,21370,429
33,6,27,6,8,52209,47565,228,5681,487
40,11,29,7,12,118283,30189,182,21506,427
9,7,2,3,6,381029,17198,27,10189,483
20,12,8,5,9,87459,4974,33,1288,478
28,10,18,3,10,318040,347,14,469,538
18,13,5,15,13,76508,75797,134,19866,437
13,3,10,2,5,9368,9368,47,0,676
10,4,6,0,10,74864,0,64,0,679
22,12,10,6,18,91573,23483,131,389,539
46,24,22,0,10,1564633,0,4,0,674
175,11,164,7,18,172162,192239,159,1580,501
13,6,7,0,11,78018,0,39,1249,579
12,5,7,4,23,619146,11889,71,47,476
21,12,9,0,6,47182,0,95,2256,545
243,9,234,8,15,433162,70903,353,19204,427
10,7,3,2,7,181754,1344,51,1233,418
8,6,2,4,6,31824,25861,158,4898,443
6,4,2,3,6,129200,19140,0,0,487
12,1,11,0,4,5396,0,5,2387,528
6,2,4,2,11,17551,17535,101,10255,420
6,4,2,0,14,240171,0,0,0,558
7,3,4,2,14,33127,1991,27,1850,654
7,5,2,4,8,60633,22460,31,6942,512
5,3,2,0,4,264392,0,7,0,574
41,6,35,2,11,33871,30831,30,19667,462
32,13,19,0,12,1467225,0,0,0,657
32,14,18,6,31,530904,59717,76,1757,503
14,5,9,7,11,46291,34194,87,9291,469
5,3,2,1,38,4592,4631,0,0,569
28,7,21,5,21,38994,26744,220,10275,447
16,10,6,2,15,68972,20686,0,0,486
28,10,18,3,20,269537,51792,138,47911,469
31,8,23,7,14,35725,35718,152,7623,453
17,6,11,4,13,51031,68247,101,2544,519
19,13,6,2,19,162314,1141,21,3800,503
8,6,2,4,14,27212,4865,77,22944,456
6,4,2,2,7,13446,12949,135,18558,418
5,2,3,1,8,26927,467,14,512,406
11,9,2,5,9,53691,31387,27,10818,515
29,10,19,8,17,157428,152445,147,35360,491
6,4,2,2,8,39517,787,0,0,591
4,2,2,0,1,33074,0,0,0,621
10,5,5,5,8,437620,23052,36,11256,569
14,11,3,9,6,64873,61628,121,6992,443
12,7,5,1,11,113164,572,21,0,648
7,5,2,3,13,35371,29215,37,4879,550
8,6,2,0,6,18221,0,1,0,640
5,2,3,1,11,2840,2840,16,4206,507
21,6,15,2,17,341984,685,20,3103,493
32,7,25,3,14,24300,10973,54,12706,557
83,17,66,6,14,345322,63256,371,18584,431
3,1,2,0,12,6162,0,2,0,640
10,7,3,7,18,241052,269734,111,0,462
26,10,16,2,13,898849,3111,50,369,545
5,3,2,3,14,183974,21255,0,0,533
5,3,2,2,9,88398,87586,18,59591,508
16,10,6,4,13,245929,20499,76,8722,476
5,3,2,4,8,23674,31161,119,9792,566
84,19,65,7,19,351590,75433,109,7615,480
8,1,7,2,9,30103,30103,22,6972,570
10,6,4,2,17,1038343,95279,12,2049,518
9,7,2,8,6,100520,96042,140,0,467
10,6,4,5,6,313412,20988,65,10652,449
35,4,31,2,13,42444,26312,35,21750,495
10,4,6,4,12,88444,4182,31,4216,447
5,2,3,0,9,445087,0,10,13570,632
8,5,3,2,8,14439,14153,168,11793,395
22,13,9,0,7,341307,0,15,0,581
5,1,4,2,6,74455,20535,32,0,526
16,5,11,6,12,46961,30506,36,9724,436
10,7,3,2,6,176939,6391,22,1119,490
12,5,7,2,8,121947,1817,5,0,516
12,7,5,0,17,231119,0,8,500,633
6,3,3,3,9,6536,4797,12,1396,478
24,14,10,5,12,240077,112685,69,309,453
17,14,3,6,10,380635,20824,101,6009,515
9,4,5,0,5,346648,0,126,6810,436
8,2,6,1,8,0,5902,20,5902,561
12,6,6,2,6,384518,71790,39,5350,465
18,4,14,1,12,45266,4046,7,1132,481
18,9,9,9,9,127932,67790,33,9446,442
6,4,2,5,12,140715,209608,18,12876,495
4,1,3,1,10,25701,18994,0,0,636
15,7,8,3,11,104492,18626,212,15398,537
8,6,2,0,9,313413,0,6,0,485
93,24,69,11,15,620645,154216,250,15804,474
38,1,37,1,8,97667,5708,0,0,629
25,11,14,3,11,105081,24647,35,6180,516
12,8,4,0,14,318747,0,0,0,696
6,3,3,4,69,15623,26091,50,11572,471
34,9,25,8,9,6739,6739,346,4400,440
16,2,14,2,6,3408,3408,49,4882,508
10,5,5,3,11,26413,26185,44,5422,521
22,10,12,7,26,138888,91681,22,3214,453
19,11,8,8,14,128552,42101,247,8286,439
7,5,2,5,8,25789,20709,73,8249,500
17,8,9,2,15,185926,11590,92,41462,528
3,1,2,1,6,15694,15694,22,15694,591
8,4,4,3,14,77261,77261,57,49010,571
14,6,8,2,15,7820,38337,71,0,445
18,5,13,0,13,163024,0,15,2874,594
17,8,9,2,15,816522,13726,33,2388,542
6,4,2,0,5,3995,0,10,0,603
39,11,28,1,14,254845,792,11,792,667
40,9,31,13,9,196641,255714,102,16029,508
4,0,4,0,13,0,0,0,0,590
5,1,4,4,5,16360,20597,21,10580,547
13,8,5,0,5,1323824,0,27,3856,495
7,5,2,1,16,490994,127584,20,772,664
13,4,9,2,7,107546,40876,27,7408,430
23,7,16,1,11,146758,28481,192,28481,500
41,6,35,7,12,260200,177272,60,109712,425
3,1,2,0,9,1138,0,0,0,559
9,5,4,0,12,4528,0,0,0,496
14,7,7,8,12,120372,91113,206,2278,545
14,10,4,3,5,308229,7667,6,0,534
19,8,11,2,17,18307,16198,88,12070,492
28,10,18,2,20,338977,11649,30,11007,552
26,1,25,2,11,22969,20569,29,20350,533
8,4,4,2,11,27494,14110,29,9658,446
9,3,6,7,8,40054,73747,109,28351,428
29,5,24,3,13,362445,26583,54,13511,432
7,4,3,3,6,2227,2331,15,449,471
13,9,4,7,9,262962,22537,27,9684,438
6,4,2,3,16,358851,12464,38,0,552
13,4,9,1,17,19077,4265,34,373,563
2,0,2,0,12,0,0,12,1858,620
19,14,5,4,7,755359,68530,152,2438,402
9,4,5,0,8,45013,0,4,0,670
8,5,3,0,3,178851,0,4,380,539
57,11,46,5,18,332620,51441,214,400,515
7,3,4,0,2,21743,0,1,0,459
40,9,31,6,33,168964,64127,172,0,523
15,7,8,6,14,64275,24175,139,12530,485
3,1,2,1,3,4346,268,48,1772,583
16,6,10,0,8,89611,0,13,350,579
17,3,14,2,6,68369,20263,11,14777,449
15,8,7,6,6,50265,50764,72,22670,464
63,16,47,5,12,178167,28547,154,11592,433
13,9,4,9,6,66065,115573,117,14311,543
9,5,4,4,18,631764,352670,99,7210,443
15,4,11,1,17,24857,500,21,4595,587
8,3,5,0,12,85587,0,41,239,607
13,4,9,4,10,31466,31466,119,11192,426
3,1,2,1,4,12304,12304,31,12304,571
27,4,23,3,5,23270,7527,37,1306,437
7,2,5,4,13,1942,37932,82,1942,514
7,4,3,4,19,255131,141638,76,4621,570
9,6,3,5,7,99590,51501,94,548,473
24,9,15,4,8,40470,11097,138,1616,453
8,4,4,0,3,886,0,7,331,590
6,1,5,0,16,0,0,1,3376,650
15,9,6,0,18,592305,0,1,0,663
5,1,4,1,13,6724,3844,20,9500,539
15,7,8,7,12,529461,133413,175,26347,479
49,10,39,6,14,602063,51940,446,10947,441
37,16,21,1,11,2501144,99169,31,0,492
13,8,5,2,2,160505,3300,18,1819,532
23,5,18,5,14,61587,44420,102,3438,612
28,10,18,1,16,1057777,2304,30,0,536
6,3,3,1,17,2940,2940,23,2940,494
10,8,2,5,6,24313,23493,97,9508,491
15,7,8,6,9,22470,22470,317,11505,381
4,2,2,2,3,19337,2493,71,1973,460
26,5,21,1,8,779741,8856,45,0,447
14,8,6,7,8,54978,34690,212,8076,439
6,4,2,2,8,33332,1501,27,1315,445
14,8,6,9,12,97923,93367,222,16856,435
44,14,30,6,8,198230,148660,173,93839,466
10,7,3,5,15,52639,22536,21,11753,451
11,7,4,4,4,116827,4709,16,908,392
43,17,26,14,13,135435,120571,329,36218,412
18,8,10,12,11,63708,105544,380,15776,444
22,3,19,1,10,138221,600,27,8234,503
23,3,20,1,11,9789,9789,124,4862,575
29,11,18,9,26,3162032,3228668,162,1345744,422
9,6,3,0,8,537624,0,1,0,568
2,0,2,1,4,7941,7941,0,0,573
40,6,34,2,13,50712,199,52,1412,549
10,6,4,5,11,96091,95840,36,92706,472
6,3,3,1,6,8942,8608,28,8808,484
38,4,34,2,7,35341,30845,23,19328,488
61,13,48,3,8,431964,9669,32,2557,651
7,4,3,3,5,91431,46835,0,0,460
12,4,8,2,8,1983,1983,16,1680,569
18,4,14,4,6,6249,39228,253,4888,547
27,5,22,3,11,61365,23418,38,1966,532
7,5,2,0,4,10545,0,29,0,575
32,8,24,3,7,28934,15878,30,698,462
10,4,6,2,7,295689,47567,55,1895,508
57,8,49,3,9,108927,6908,103,2780,497
15,5,10,5,8,20394,68339,67,4263,504
22,12,10,6,8,105659,42196,180,12983,477
11,5,6,1,9,95444,2083,27,625,592
22,10,12,7,7,85358,33300,129,19037,586
4,1,3,0,4,1000,0,0,0,600
18,7,11,0,9,184892,0,27,1425,493
10,4,6,0,8,31161,0,91,2464,549
17,5,12,3,8,389834,15286,37,0,521
56,1,55,1,10,8933,8933,28,8933,595
32,8,24,5,7,402053,18178,152,671,492
14,9,5,8,10,127554,106970,234,70677,503
12,9,3,3,14,153755,54851,69,20524,532
6,2,4,1,3,882,882,10,2179,506
12,8,4,10,7,45142,63438,68,15326,470
12,3,9,1,6,10180,294,6,500,652
7,4,3,2,14,18234,18234,43,4068,492
12,7,5,4,9,30456,25148,41,12491,414
9,5,4,5,7,189602,243302,104,164654,447
6,4,2,0,4,38053,0,4,4040,513
28,20,8,4,7,647272,14092,33,3430,480
10,7,3,3,11,508950,18055,26,13914,432
25,1,24,1,8,4415,4415,12,4415,420
12,8,4,1,69,4375,2196,39,412,508
11,5,6,5,15,351541,351541,89,164669,480
10,8,2,0,7,90801,0,0,0,685
8,6,2,0,3,237658,0,0,0,641
21,8,13,5,8,75607,44411,52,0,481
7,2,5,1,11,91334,37279,3,37279,667
14,10,4,1,7,97686,830,3,0,625
43,16,27,0,40,635786,0,10,315,672
9,5,4,4,13,6004,6004,49,2104,476
24,10,14,5,12,235628,80382,107,5474,559
10,5,5,1,14,7925,5410,24,3407,434
12,4,8,6,8,27374,49309,336,8018,518
10,8,2,0,5,141820,0,2,0,598
16,7,9,5,8,56183,28195,216,16740,451
29,7,22,4,15,34208,93072,46,4919,494
7,3,4,2,15,104582,7337,4,0,579
10,3,7,0,7,31724,0,6,0,632
5,3,2,2,8,16381,10334,99,5682,572
9,5,4,0,5,32950,0,44,2200,676
22,9,13,1,23,274350,374,2,551,427
28,10,18,7,15,467386,161964,0,0,457
34,3,31,6,18,126326,121509,110,11012,543
10,6,4,7,8,31966,41463,52,9722,452
9,3,6,3,5,35979,13758,36,6761,487
9,5,4,2,7,45849,45849,36,1250,560
49,3,46,2,9,12929,259,106,783,540
8,5,3,3,8,18658,18658,32,13082,647
38,10,28,3,16,568974,32096,36,56,528
20,8,12,7,16,56308,56308,69,16948,453
3,1,2,1,3,122302,15766,15,0,474
7,4,3,5,13,19775,22338,27,6592,414
18,9,9,0,23,101660,0,41,0,576
15,5,10,2,20,160855,20100,12,4001,476
39,20,19,7,7,290400,34786,106,4068,433
22,13,9,1,14,512463,1074,9,1010,540
11,4,7,0,9,1067403,0,3,0,609
25,5,20,1,15,422618,31151,45,31151,544
92,10,82,5,15,45283,31504,193,10272,464
14,10,4,5,6,288573,34170,41,2705,460
3,1,2,1,8,39231,3159,10,0,632
13,8,5,0,9,4192604,0,6,1141,559
11,5,6,6,10,518834,117608,80,42577,440
13,7,6,6,10,323611,32976,81,10509,474
20,2,18,2,28,33055,31976,39,6294,611
10,3,7,1,9,32462,2024,0,0,500
19,1,18,1,11,3336,3336,31,4121,641
26,2,24,0,12,5986,0,4,5985,572
9,5,4,4,12,234364,165868,97,0,536
14,6,8,5,18,521131,18498,7,12724,557
11,4,7,2,14,104153,29971,21,0,478
18,10,8,8,7,55396,39984,400,6754,461
23,7,16,7,8,170719,170719,283,8214,483
35,20,15,0,21,913275,0,21,0,502
15,1,14,1,5,9690,8010,10,0,661
10,4,6,5,9,104602,131944,199,60148,484
11,4,7,0,6,48818,0,1,4423,614
44,11,33,9,11,57121,41211,283,6810,410
4,2,2,2,13,12398,12398,53,7597,495
11,6,5,0,6,403120,0,33,0,467
57,13,44,10,7,110013,46740,105,6465,445
17,4,13,2,9,103445,3835,9,912,574
31,6,25,7,15,60261,42834,276,15007,512
13,5,8,3,7,45801,8653,7,1765,491
10,7,3,4,9,68204,28852,64,3100,497
17,6,11,2,15,237887,6554,8,4980,474
97,16,81,5,15,159686,47725,292,4665,484
19,9,10,8,16,101383,117012,217,26504,477
13,4,9,2,9,98634,8408,16,3608,462
18,7,11,6,13,411799,27054,95,9900,500
9,3,6,3,8,63719,82953,53,50373,504
15,6,9,0,18,202043,0,22,0,592
50,4,46,3,17,19718,36595,271,4138,561
13,8,5,2,20,214676,943,109,1145,524
31,11,20,3,12,320742,21766,121,55918,432
8,5,3,4,8,272450,255454,105,0,620
8,6,2,5,6,230513,135911,145,43596,454
3,0,3,0,7,0,0,18,0,622
39,10,29,4,20,341490,79807,109,4070,507
34,5,29,4,17,196763,12908,113,17647,490
24,15,9,6,12,504561,44670,102,3543,438
14,3,11,0,7,12799,0,13,354,604
6,0,6,0,7,0,0,75,826,626
60,22,38,2,21,2874147,417666,11,18236,529
11,5,6,3,18,95284,12653,8,6985,496
52,5,47,5,11,316645,25683,85,1367,532
20,9,11,2,9,64003,2670,20,4629,541
14,8,6,6,7,91725,77502,84,1350,472
20,6,14,4,8,62531,36818,98,2066,469
15,4,11,3,19,19800,16425,72,5817,483
30,16,14,5,19,508908,54893,18,15430,421
34,6,28,4,15,586086,30656,77,13196,469
13,5,8,3,8,43989,43989,44,8160,434
7,5,2,4,10,263859,18962,85,0,502
4,0,4,0,7,0,0,7,1292,518
23,14,9,0,9,271108,0,0,427,586
22,6,16,6,14,175545,27495,20,16802,446
13,3,10,1,4,38064,22111,23,22111,552
26,9,17,9,14,480779,197321,133,4666,427
157,10,147,4,8,84259,12782,126,1533,469
66,14,52,10,9,728888,102848,175,14123,442
13,7,6,8,14,505576,723705,163,256224,446
7,3,4,1,13,6380,3735,58,3735,649
14,6,8,1,8,323751,3638,80,3638,565
41,16,25,15,14,128960,135661,338,21600,447
7,2,5,3,9,24176,31066,53,18879,525
57,21,36,5,7,81050,29712,82,6115,449
60,13,47,2,9,151858,1584,50,899,523
3,1,2,1,16,11129,11129,0,11129,601
5,2,3,2,6,13973,13895,28,281,520
23,8,15,2,20,21764,15372,37,12405,538
37,14,23,0,18,704976,0,55,1136,599
58,12,46,6,14,228094,209566,264,161077,432
5,1,4,2,6,5330,15375,36,2288,682
15,2,13,0,8,372097,0,57,9430,641
10,3,7,4,7,280401,55861,44,24088,610
17,7,10,4,14,450498,11617,51,8042,532
39,6,33,2,11,207011,16680,95,345,488
38,11,27,4,12,594214,33078,37,12962,389
10,6,4,0,6,36952,0,2,219,618
16,10,6,10,9,36538,27828,131,6749,435
19,9,10,3,6,97004,11896,14,7960,482
34,13,21,2,16,384933,644,160,4082,469
17,12,5,3,12,443062,13983,55,7374,396
5,3,2,2,4,27762,27762,27,0,459
12,6,6,0,16,69307,0,6,883,693
47,9,38,6,12,39549,28338,142,13484,455
23,10,13,4,15,736838,180284,83,1142,493
24,15,9,12,27,1118276,1287652,170,88866,465
38,12,26,8,69,113043,46565,159,3345,522
22,2,20,1,7,3742,3112,24,541,487
12,10,2,10,7,172712,191910,432,15564,496
9,6,3,5,9,628861,219640,138,320,506
17,10,7,5,15,389680,131566,69,5779,446
56,7,49,4,12,35389,29463,81,12457,498
25,4,21,3,14,49992,42547,8,1685,514
20,8,12,0,14,258452,0,34,11,572
38,11,27,7,6,90724,35591,180,11394,413
25,9,16,4,7,139000,33172,37,21032,477
8,4,4,2,16,354787,272665,69,21363,422
15,4,11,5,4,44641,40075,6,2835,449
6,1,5,1,11,5634,5634,23,0,657
30,4,26,3,8,20939,9185,22,8496,578
22,12,10,13,14,359106,1925920,272,42142,466
12,6,6,3,8,160141,39468,54,0,421
2,0,2,0,6,0,0,10,3937,530
6,3,3,0,12,52318,0,6,17484,558
7,4,3,4,42,13166,20117,68,6955,481
7,3,4,3,8,5658,20163,0,0,534
21,9,12,8,10,179414,226345,148,1468,496
79,10,69,5,26,748895,206522,103,24935,436
13,3,10,2,16,24823,6720,79,5100,523
63,8,55,4,20,276825,29386,66,3923,481
63,20,43,20,20,1077228,430235,604,56156,464
23,14,9,1,5,986126,1443,40,918,453
11,6,5,6,10,30102,30102,102,26243,446
43,31,12,7,12,1261678,20693,22,16697,539
35,6,29,3,8,27915,9185,22,8496,504
14,9,5,6,7,77248,42985,106,3198,454
9,6,3,0,13,76194,0,0,0,564
17,8,9,8,8,261421,269760,48,163716,437
37,8,29,2,15,569951,62620,176,7296,495
13,9,4,0,7,150372,0,2,0,613
16,8,8,9,14,71608,73169,238,41730,463
4,2,2,1,4,8173,392,11,3880,475
2,0,2,1,5,0,1706,29,0,597
15,6,9,10,18,853258,182344,123,15951,615
64,7,57,4,15,86988,43789,286,37130,463
3,1,2,1,19,4476,4476,6,4476,569
15,5,10,2,19,45124,27864,40,6065,485
52,19,33,2,13,511929,529,185,5049,543
10,6,4,0,22,119351,0,7,0,491
6,3,3,0,4,25672,0,39,1216,547
3,1,2,0,12,9066,0,0,0,692
11,8,3,5,11,19675,13714,47,2887,431
14,5,9,5,9,33968,39761,24,16396,421
9,3,6,4,11,16961,21587,51,9655,519
12,6,6,3,13,181739,29888,27,23983,434
20,11,9,4,11,376368,34015,88,3924,389
30,10,20,0,10,327891,0,12,790,572
8,5,3,1,22,21578,3071,27,0,529
6,3,3,2,5,3203,1499,55,1383,518
8,5,3,3,7,4923,4127,66,4053,438
22,4,18,2,10,18089,16271,17,14844,624
24,2,22,0,18,9120,0,1,7219,636
14,11,3,9,16,53093,35938,158,8953,462
33,6,27,3,16,94340,39765,131,23456,492
87,10,77,11,17,433122,131368,561,52589,437
38,4,34,0,6,116884,0,3,12200,612
166,21,145,4,19,528821,3639,46,121,472
18,7,11,0,12,161073,0,4,0,653
5,3,2,4,8,30965,30965,0,0,510
7,4,3,6,23,112919,72551,0,0,477
7,5,2,4,6,8886,7755,63,474,426
20,10,10,3,22,109379,59682,0,0,507
7,5,2,2,21,22322,21481,34,15637,546
18,9,9,0,9,818086,0,12,0,628
45,19,26,10,13,68909,39805,364,13835,404
9,4,5,0,10,215642,0,20,4882,570
15,7,8,5,9,14098,8545,209,3250,451
9,4,5,1,9,6921,2669,35,0,487
18,11,7,3,14,446169,2640,7,6895,603
21,16,5,9,19,453805,152211,137,34042,436
7,4,3,4,9,40634,52696,70,23705,519
12,4,8,4,18,664020,38335,224,12725,471
25,6,19,2,14,197008,3096,27,2171,625
119,12,107,9,18,51119,43188,182,3510,438
5,2,3,1,16,14602,7609,9,7609,457
15,7,8,0,5,26144,0,6,1601,578
7,4,3,5,7,36473,59626,236,23739,452
6,1,5,1,7,17690,17690,25,1534,666
8,6,2,0,8,195845,0,5,0,597
7,3,4,2,13,1309,1309,26,2077,562
18,10,8,0,10,210071,0,1,3067,504
5,1,4,0,4,9676,0,0,0,614
3,1,2,1,9,6179,6179,41,6179,488
18,6,12,1,13,144089,266,3,266,561
7,3,4,0,8,4232,0,15,1015,620
44,25,19,12,14,548280,164023,199,15738,368
10,7,3,1,13,16061,413,0,0,495
9,4,5,0,8,22970,0,6,148,724
40,13,27,11,11,292808,286790,347,202312,406
101,24,77,7,25,477519,129346,115,28335,494
30,2,28,1,15,5881,5881,45,5907,655
15,6,9,2,14,468451,11646,74,2282,440
21,13,8,14,21,442728,659176,304,178319,430
23,13,10,1,19,88646,1223,19,5439,451
59,7,52,5,14,132244,132244,530,80345,476
16,9,7,7,13,49080,40742,62,15582,423
3,1,2,0,17,5639,0,7,0,649
20,6,14,4,18,51219,51219,36,24066,424
11,3,8,1,7,44175,23421,12,1183,604
10,4,6,4,6,23512,15528,230,5346,535
23,6,17,1,13,59526,1890,5,1890,591
18,3,15,0,9,55826,0,2,775,629
38,7,31,1,16,118664,15184,53,18026,588
12,5,7,2,8,107667,19655,38,2067,423
13,4,9,5,8,138376,137246,52,5551,439
26,11,15,2,10,118728,45172,32,43955,512
8,2,6,1,7,44397,44397,21,0,512
13,5,8,3,7,26444,5504,19,828,416
50,13,37,5,17,1026707,84055,140,7257,457
5,2,3,0,21,24737,0,0,0,649
60,16,44,12,13,308768,198451,535,23407,418
72,9,63,2,12,155315,15780,78,13777,457
33,14,19,11,15,255176,240850,362,17008,452
17,6,11,5,7,21937,21199,58,11094,470
20,10,10,18,4,322675,917917,152,6583,409
21,5,16,2,11,73866,22396,270,22095,501
9,4,5,3,14,213146,12599,32,6191,462
25,6,19,3,8,13519,4321,60,1797,496
9,3,6,0,17,657666,0,26,55854,581
5,3,2,3,4,19036,21855,27,9691,610
13,8,5,5,14,180328,10291,97,2461,501
4,2,2,3,11,142344,142344,0,0,447
5,3,2,2,3,34767,12310,0,1377,434
12,8,4,7,8,19162,19162,260,12810,516
11,9,2,1,3,122969,698,2,0,553
9,6,3,3,11,31022,12785,2,1010,460
6,2,4,1,4,3975,3975,25,3975,545
30,14,16,8,16,75302,49509,121,8258,447
6,3,3,2,10,11061,11061,36,8597,542
4,2,2,0,2,66391,0,0,0,621
6,4,2,0,9,13276,0,11,0,628
13,6,7,2,14,504699,205750,28,8521,470
21,3,18,2,19,610,8817,22,3198,544
10,1,9,0,4,0,0,5,866,553
6,4,2,0,2,16074,0,0,0,615
13,1,12,2,8,7494,24522,18,676753,519
14,7,7,5,12,334181,210766,138,17667,447
13,5,8,3,5,40584,242,51,424,517
6,4,2,3,7,37478,12661,45,5832,490
6,4,2,0,5,279739,0,7,0,626
17,10,7,0,12,514753,0,2,0,548
17,13,4,16,9,492552,345296,287,54311,454
21,13,8,7,22,1849151,250818,124,9293,434
5,2,3,0,5,33000,0,1,3189,600
18,5,13,4,16,231336,17248,109,6074,406
114,3,111,4,6,11825,24006,49,0,452
17,7,10,3,15,131111,53622,2,29509,478
16,7,9,1,13,54352,12317,10,47657,532
12,8,4,7,7,33008,21722,134,7750,431
9,5,4,6,3,21010,25181,70,8148,445
7,5,2,4,11,34940,17571,40,0,446
6,4,2,3,4,66305,48395,30,0,444
21,13,8,7,11,2327283,2020443,75,0,495
5,3,2,2,17,40234,40234,0,0,502
199,11,188,0,13,163370,0,44,13042,628
5,3,2,0,4,22505,0,0,0,607
26,4,22,2,9,9253,36129,132,5526,600
19,9,10,3,6,90595,14284,129,1220,492
14,5,9,2,19,711877,110348,1,150,416
89,14,75,11,11,104710,92703,488,26370,417
6,2,4,1,6,282527,2890,10,0,462
208,26,182,6,15,1605015,59985,25,25629,447
64,13,51,10,19,290547,8931,187,4326,424
3,1,2,0,8,0,0,29,570,634
4,2,2,2,7,28751,25399,33,0,480
35,14,21,3,14,329497,3824,98,2700,459
23,12,11,10,15,142213,74597,109,4894,471
27,9,18,2,9,17676,4624,114,3106,452
13,6,7,0,15,43683,0,0,362,618
8,0,8,2,9,24277,33235,0,0,610
5,2,3,1,16,280475,14274,25,1072,581
49,10,39,9,19,149959,122319,488,30867,453
6,3,3,5,5,17360,33838,11,3990,520
11,4,7,4,10,29869,17108,80,3905,469
3,1,2,1,3,3258,3258,10,3780,447
7,5,2,4,4,42459,27230,31,12044,602
6,2,4,1,6,4767,3567,22,3567,621
42,7,35,6,8,314742,415281,89,147213,424
28,15,13,0,17,464777,0,1,785,603
90,20,70,8,15,328106,8922,249,26946,414
47,11,36,1,14,692463,22598,9,0,446
44,8,36,8,6,73422,35114,62,20892,522
19,5,14,1,8,32617,7597,112,7597,492
5,3,2,2,5,8806,8806,35,9430,440
25,13,12,11,27,305237,312791,252,0,436
7,5,2,0,3,30885,0,7,0,631
13,7,6,4,10,28410,17126,173,11270,484
11,5,6,2,14,25612,2842,23,2685,427
34,21,13,5,9,1532105,105075,40,45025,463
15,9,6,2,9,83528,13046,74,6944,497
7,4,3,1,3,16277,518,4,0,414
11,8,3,0,7,94873,0,4,5888,491
20,9,11,8,16,516693,514762,0,630,504
24,10,14,9,7,117533,96534,416,25848,468
10,7,3,6,14,184862,108878,105,0,493
4,2,2,2,6,7748,7748,35,6962,589
10,5,5,5,9,393255,34560,110,13835,442
25,8,17,6,7,247424,234141,129,210500,481
11,8,3,5,11,22210,30663,64,28401,502
11,7,4,2,12,300505,16665,23,3311,534
7,5,2,4,7,198621,22571,82,1832,497
11,1,10,1,11,342835,1824,0,296,629
9,5,4,2,13,6175,8662,47,151,549
10,2,8,1,5,51564,902,9,0,589
12,6,6,2,9,47085,3536,31,0,533
8,6,2,5,11,77000,77000,4,14816,496
16,3,13,0,7,34143,0,35,750,587
11,6,5,4,12,493136,18073,30,5570,453
3,1,2,0,6,3505,0,4,364,626
19,9,10,2,15,182304,4052,59,2232,471
17,3,14,2,14,145833,5286,15,0,570
44,6,38,2,28,161363,99916,112,0,481
4,2,2,1,6,3090,2597,7,2597,602
14,5,9,4,8,103931,37467,49,13253,506
12,3,9,0,7,170666,0,11,0,508
3,1,2,1,15,14907,14906,25,581,563
15,7,8,2,11,975120,21203,48,14813,572
14,8,6,5,9,399326,88982,144,12626,477
137,36,101,2,14,436950,11263,95,11378,510
39,17,22,1,13,81746,503,123,503,492
29,10,19,2,26,295026,2422,17,350,535
21,5,16,2,7,492440,11676,126,12,472
12,9,3,2,8,311674,351,7,325,530
31,9,22,3,19,313084,93248,22,92850,492
17,8,9,7,14,85913,85913,95,13684,438
15,5,10,3,14,347139,38431,208,22858,546
22,5,17,4,5,16806,13466,73,13439,438
9,7,2,1,9,38303,900,22,0,454
30,11,19,9,11,35176,11479,130,3547,406
28,8,20,4,10,266398,24806,439,21132,477
17,8,9,8,10,606150,111053,110,45557,434
9,3,6,1,17,255063,255063,14,255063,545
20,15,5,14,3,33470,33469,179,2896,419
16,13,3,3,5,40752,33595,70,918,462
13,10,3,0,8,117169,0,0,0,657
13,11,2,0,16,432639,0,54,0,492
20,3,17,3,8,5984,2138,356,4444,510
6,1,5,1,12,330311,3709,5,0,652
40,15,25,4,14,147100,81109,59,27520,484
31,6,25,4,6,26684,20917,81,11615,479
6,2,4,2,7,4062,586,217,3076,554
14,6,8,2,14,344183,17178,15,12428,514
13,8,5,9,8,42052,49732,43,15221,397
31,10,21,2,13,179880,877,16,4528,489
20,3,17,0,12,51483,0,19,8041,545
30,21,9,20,52,402128,306387,301,33294,371
53,17,36,5,12,276767,52672,10,32971,521
7,5,2,6,10,57949,90055,76,11243,515
14,7,7,3,7,53112,30660,108,16776,525
5,2,3,2,7,10073,10073,23,6848,498
142,7,135,2,12,45257,12494,347,3173,523
40,5,35,3,8,259057,54138,110,19170,509
13,9,4,5,25,45764,31989,92,16375,449
17,11,6,5,11,445382,20202,53,13151,432
11,4,7,4,9,36120,28974,87,0,474
21,13,8,4,19,524149,103853,60,802,464
26,13,13,9,20,615165,335660,291,87567,529
9,3,6,5,8,27154,31372,172,23850,571
11,6,5,7,7,18846,29746,121,6300,491
21,7,14,6,7,23449,23449,379,9234,492
11,8,3,4,18,195212,12506,39,3257,476
8,5,3,4,9,16946,1835,25,1249,497
30,5,25,0,8,255093,0,4,0,619
13,2,11,1,9,65687,7440,64,7440,511
21,18,3,6,8,456979,48832,21,14464,469
18,9,9,8,9,19966,19966,436,6120,465
22,5,17,6,22,2000,295357,3,898,424
33,10,23,9,12,623756,120916,206,27920,442
10,5,5,1,2,26273,1940,6,2000,557
6,1,5,1,19,109666,109666,21,109666,563
18,13,5,1,3,191853,1201,25,324,495
24,12,12,2,7,340065,1338,83,2987,462
15,12,3,0,18,887801,0,11,0,674
8,3,5,3,7,21924,25329,38,1399,497
14,10,4,7,13,218330,28062,178,5317,422
11,7,4,1,4,77788,3000,16,3000,438
4,2,2,2,17,36815,36815,32,29906,535
13,8,5,7,8,338962,20616,394,5278,522
10,4,6,7,9,21400,24725,105,3111,605
11,5,6,3,9,433008,23615,102,15400,464
22,8,14,5,9,170046,92919,120,2,444
8,6,2,0,12,411582,0,12,825,587
11,7,4,0,7,159073,0,54,2912,669
6,3,3,1,9,4609,4609,18,4609,578
3,1,2,1,7,3517,1527,0,0,494
15,3,12,3,14,40695,29738,19,23046,517
26,12,14,13,18,1241195,1350322,305,164307,481
9,7,2,6,14,682407,64558,89,24011,466
49,18,31,7,10,241292,45064,324,2876,414
26,3,23,2,10,126058,12521,0,0,617
30,5,25,6,8,94875,139622,55,41829,547
50,8,42,4,14,79849,21961,244,21323,503
19,9,10,0,16,618284,0,5,14973,674
6,3,3,1,7,891,597,15,597,527
27,7,20,5,5,9970,9590,87,3476,462
8,3,5,1,3,31668,19214,17,19214,483
7,4,3,4,6,47903,46599,34,3144,437
38,23,15,1,17,1117736,267,41,1601,603
8,6,2,0,8,339070,0,9,0,697
3,0,3,1,7,0,11160,9,0,607
13,5,8,6,13,13503,14664,343,3358,496
20,7,13,3,18,235532,6156,56,4882,488
9,7,2,7,11,139533,121526,130,12568,414
9,6,3,6,11,41085,42045,76,19484,455
11,5,6,4,15,14029,12034,44,6626,446
7,5,2,1,4,163057,18914,23,18914,622
22,9,13,8,12,137374,58182,84,81737,450
13,9,4,5,19,522758,32932,65,9967,418
5,1,4,2,12,4921,10483,0,0,617
33,12,21,6,14,338975,75886,197,5126,415
15,7,8,6,14,63524,56954,47,33801,412
23,11,12,0,5,149596,0,0,0,614
14,11,3,0,7,264248,0,1,0,659
8,5,3,2,12,70623,63381,36,840,502
20,5,15,5,5,17895,21333,161,2947,471
6,3,3,0,6,504,0,15,0,536
35,8,27,1,19,381608,14122,4,10234,550
33,22,11,3,13,245137,27684,221,12442,571
5,3,2,3,3,24911,10294,48,6856,432
5,1,4,0,11,0,0,25,5552,648
28,12,16,4,7,28488,6426,313,4365,587
13,7,6,0,9,24067,0,0,0,587
17,12,5,4,5,69443,14631,18,6432,417
7,5,2,3,8,31834,10733,80,1955,449
14,10,4,10,8,67922,53730,133,17873,390
15,8,7,4,11,178311,40882,161,6292,503
9,2,7,0,3,61585,0,1,2378,607
10,3,7,5,10,27139,27139,224,10530,532
19,5,14,1,14,63973,13252,36,13252,599
39,6,33,3,16,730667,20033,29,6211,514
21,6,15,0,16,8613,0,133,2091,661
17,6,11,7,13,47396,140790,394,7246,485
40,6,34,3,12,71295,7596,108,2084,531
11,7,4,6,9,37784,29436,324,21362,479
7,4,3,5,9,62198,62198,324,26731,511
9,4,5,2,9,16390,9501,81,6123,521
6,2,4,2,4,31172,23369,11,0,524
9,7,2,0,4,31871,0,0,0,650
11,8,3,2,11,446195,11735,22,11337,525
23,11,12,13,9,937302,877858,265,68200,379
12,7,5,7,7,135531,176742,104,12975,535
8,5,3,0,5,33506,0,79,1557,560
12,5,7,1,14,186119,2716,13,1647,650
7,5,2,4,7,10416,8931,59,4048,438
14,8,6,0,12,705015,0,6,2998,551
17,9,8,0,9,212432,0,0,0,611
3,1,2,0,3,52477,0,3,2491,632
31,14,17,2,14,107678,451,23,672,541
18,8,10,8,6,145716,179984,151,60202,426
11,4,7,0,13,405373,0,0,1000,524
10,2,8,2,9,16797,10450,45,8185,496
36,8,28,2,22,92304,1468,46,7640,481
12,3,9,1,19,16412,2850,25,2176,548
15,7,8,10,5,118397,296960,209,60594,374
9,3,6,3,8,5459,5183,58,3500,558
19,10,9,0,10,324468,0,9,0,533
9,5,4,3,13,17944,16856,62,0,501
13,8,5,5,5,39052,26250,198,15833,447
3,1,2,2,8,8272,19769,0,0,546
37,6,31,3,15,61889,25028,268,18094,487
7,3,4,3,5,3752,4808,27,2696,514
3,1,2,0,6,0,0,31,0,491
11,4,7,3,10,9371,8901,34,2028,640
7,5,2,5,6,4082,7784,38,887,635
10,1,9,1,6,7067,7067,28,246,514
13,8,5,7,10,40267,35493,73,27946,427
148,19,129,1,10,480753,3988,46,1108,469
6,3,3,2,13,119021,96662,31,60541,556
14,5,9,0,12,72380,0,7,0,602
11,6,5,3,9,16017,11454,76,14065,442
27,12,15,6,34,98468,19111,63,31541,387
24,11,13,5,13,231555,79158,125,12668,456
13,10,3,1,14,373168,6430,17,0,517
7,4,3,1,13,20473,621,24,1470,500
12,9,3,10,6,37497,40567,239,12472,527
6,2,4,1,4,29350,1787,10,0,482
5,3,2,1,6,206138,211,5,910,580
24,6,18,2,11,347928,10052,55,0,555
8,3,5,0,17,362485,0,12,0,669
38,2,36,0,12,19040,0,1,7320,598
19,8,11,8,7,76613,69246,157,6450,389
29,10,19,0,12,257715,0,10,0,643
19,2,17,2,7,177425,47019,41,1250,553
3,1,2,1,14,21031,10723,8,0,514
12,7,5,0,44,575329,0,1,0,536
8,2,6,1,14,3632,3632,34,7263,573
7,5,2,3,8,381768,54818,5,37798,488
21,11,10,1,14,508286,5677,26,0,501
8,4,4,4,14,31627,65113,65,33486,451
12,6,6,6,6,162619,26714,51,731,448
8,5,3,2,9,22792,18566,67,0,474
26,19,7,1,5,1008406,900,0,0,458
29,5,24,2,12,7964,4964,33,4605,435
12,10,2,1,9,262132,1,10,0,415
5,3,2,0,8,327293,0,3,0,623
5,2,3,1,7,7739,4949,22,0,615
27,13,14,0,14,917271,0,25,0,481
6,3,3,2,10,14196,8259,19,728,454
6,3,3,0,6,11971,0,3,0,667
6,4,2,5,9,22938,31382,142,9665,483
46,4,42,3,5,10564,6974,13,3107,472
11,4,7,3,10,139136,91964,80,1283,499
12,3,9,0,12,230966,0,44,2789,655
27,9,18,3,17,702787,39452,25,21880,455
53,6,47,3,16,419011,48808,102,24883,575
9,7,2,2,11,253485,18124,27,17634,465
24,9,15,4,29,311754,59822,120,5904,492
10,6,4,0,11,250762,0,26,31701,523
5,3,2,3,9,8929,8928,221,7272,395
56,7,49,8,11,204302,156894,200,39959,429
13,11,2,2,15,39352,12847,31,10750,544
12,8,4,1,3,927624,600,2,0,470
9,6,3,5,4,49957,17732,53,4421,460
9,6,3,5,8,43442,31676,3,13184,487
8,5,3,1,14,474799,18630,16,20640,480
13,6,7,0,7,110083,0,25,1226,510
5,2,3,4,10,10287,19808,41,9110,484
10,5,5,0,11,111185,0,0,0,614
19,7,12,5,8,43660,29681,61,2193,457
3,1,2,0,9,0,0,0,0,659
18,12,6,0,14,528097,0,0,2190,533
27,20,7,1,8,399222,680,52,21029,446
14,7,7,5,18,267547,60681,64,49188,430
15,6,9,8,10,123518,112026,78,49670,447
6,4,2,1,27,414,414,11,0,562
7,5,2,4,14,679838,679838,115,59055,512
42,6,36,3,19,425499,51014,271,24787,516
5,2,3,2,5,9000,9000,20,0,664
14,9,5,3,15,215133,21697,73,9657,504
18,12,6,9,8,497152,146866,162,20113,457
21,5,16,3,6,17838,6409,38,1569,483
8,6,2,0,6,7085,0,5,0,660
51,3,48,3,16,248600,41012,39,745,512
12,6,6,6,4,31668,33483,59,10691,491
7,5,2,2,7,171087,28738,18,0,440
30,6,24,3,8,36851,2086,40,4006,412
10,8,2,7,5,36397,62500,35,9064,498
9,4,5,1,15,139001,41648,40,0,617
8,5,3,3,16,66511,70304,67,0,542
29,19,10,13,14,285629,197425,199,51291,414
34,12,22,9,19,89518,84187,81,10089,416
6,3,3,3,11,18069,18069,57,6258,498
8,1,7,2,12,198785,18578,48,0,621
11,8,3,5,19,72370,72370,184,115828,468
13,8,5,5,8,27964,25181,64,13303,428
5,3,2,2,14,15988,1547,42,14791,472
7,5,2,4,7,58076,52414,0,0,477
25,9,16,4,7,120735,41237,120,22855,454
4,2,2,2,11,18105,18105,33,12200,540
19,11,8,6,13,1238921,777340,126,83531,396
12,6,6,7,29,38052,46865,0,0,418
41,15,26,5,24,1410102,20896,28,4222,408
18,8,10,4,15,691081,27230,65,30294,402
5,2,3,2,14,210452,210452,41,7190,603
12,7,5,2,9,269184,16658,7,8880,414
15,11,4,9,13,387836,155830,87,29022,489
8,6,2,0,20,19731,0,0,0,706
17,9,8,2,10,1336188,4429,36,0,414
6,3,3,2,8,18328,11885,74,6341,550
12,9,3,3,16,228711,9656,59,0,623
4,2,2,2,8,20317,20317,127,12500,464
9,3,6,1,9,10016,37879,19,37879,624
14,1,13,3,7,17292,36377,43,17292,566
11,5,6,4,12,232726,161401,6,28673,666
36,9,27,1,3,124858,11917,10,2674,495
11,6,5,1,7,438023,874,3,874,543
11,5,6,3,12,5114,5114,43,667,517
5,3,2,2,3,130652,5319,4,0,514
17,4,13,4,9,42763,42763,21,20533,474
20,5,15,3,14,17063,8191,93,3936,673
17,10,7,3,14,100843,27060,61,11659,499
17,9,8,10,8,1073977,1184617,192,59942,445
7,4,3,4,5,564622,227357,50,0,523
16,5,11,0,11,652254,0,18,0,575
14,4,10,2,12,40573,9195,50,5425,494
28,7,21,0,6,232747,0,0,4655,659
16,10,6,4,5,379194,7696,109,9261,427
16,3,13,0,16,51075,0,4,1028,658
14,8,6,7,13,48235,35210,68,7240,397
5,2,3,2,4,17923,6800,26,5400,586
30,13,17,3,14,332790,26713,93,21813,435
12,4,8,0,10,37803,0,1,1058,612
13,4,9,1,8,43443,2153,18,2153,466
12,7,5,5,9,67464,37987,216,16638,475
37,12,25,7,17,146200,84682,47,452,501
5,2,3,3,14,23403,25841,55,2438,520
13,6,7,2,8,63506,16160,129,2254,511
21,11,10,9,8,231007,121324,67,3426,439
18,13,5,5,15,700775,417169,25,145576,462
22,14,8,10,12,385130,129383,225,0,415
10,5,5,1,4,151864,92072,23,0,548
15,9,6,3,10,38783,39132,75,50,525
17,6,11,1,12,42367,6177,104,9244,529
4,2,2,0,5,1583,0,0,0,652
8,6,2,2,3,41538,1259,52,600,516
12,8,4,8,12,304228,296205,24,9438,506
5,2,3,2,6,39831,6550,28,2476,471
14,12,2,6,13,346625,27418,33,1130,497
12,9,3,1,12,241920,8646,14,8646,586
34,10,24,5,7,41392,24381,350,11087,475
71,13,58,10,14,507508,204343,256,37475,433
14,9,5,1,11,487671,2686,5,2583,443
17,10,7,4,11,35416,9069,73,4453,477
30,13,17,12,8,37674,27303,122,7829,476
4,1,3,0,15,0,0,9,653,663
8,2,6,2,3,5642,5642,0,0,536
18,9,9,8,7,180194,254039,140,96015,487
6,4,2,2,14,5713,5457,27,3376,672
17,9,8,5,22,3989315,86999,72,0,521
21,10,11,7,15,229027,223684,61,50128,456
5,3,2,3,8,34271,24056,68,19361,528
58,26,32,0,27,8171620,0,3,103,687
6,1,5,1,11,23050,23050,24,0,523
29,8,21,2,8,94771,420,228,2816,541
9,5,4,1,6,20216,581,43,1355,469
6,2,4,1,14,255329,3278,17,3278,499
5,3,2,0,12,120725,0,0,1250,599
12,6,6,2,7,286239,42119,49,13633,553
97,25,72,16,21,2085023,1693085,240,118396,425
21,4,17,0,16,106761,0,6,404,732
14,6,8,5,10,254198,30713,38,12710,445
26,10,16,5,13,97349,12644,285,3178,455
15,4,11,2,16,507801,301292,80,267031,543
40,18,22,2,8,897797,8910,13,8834,498
5,2,3,1,12,500,500,26,500,606
11,6,5,0,5,42013,0,3,157,577
12,6,6,6,7,12541,12541,63,7780,477
7,4,3,3,13,372306,55563,16,33231,454
30,13,17,1,21,161626,11822,2,11822,690
10,6,4,2,17,111170,9126,96,21943,506
7,4,3,3,16,9900,9900,74,3300,651
23,9,14,7,16,148231,106967,81,48100,459
3,1,2,1,8,5681,5681,0,0,560
16,5,11,3,22,61152,77396,66,5138,527
18,11,7,0,12,142694,0,0,0,536
4,1,3,1,7,445,445,26,721,622
8,4,4,3,12,6533,16173,27,0,506
18,11,7,6,17,584111,26682,55,14898,464
12,6,6,0,6,76914,0,0,0,580
11,5,6,1,4,12120,2124,3,2804,530
10,5,5,1,8,212211,1433,84,3349,455
8,6,2,6,20,39481,39771,81,15873,432
9,5,4,4,6,52176,16065,55,8032,513
16,12,4,9,36,67573,36288,43,8584,396
4,1,3,0,8,0,0,41,0,675
20,5,15,3,10,58886,15458,66,5684,565
28,3,25,0,13,39486,0,2,397,658
19,13,6,12,10,96208,66035,433,10905,447
30,7,23,6,20,561052,70732,120,23575,511
7,2,5,2,3,31476,8116,12,3597,477
28,12,16,5,8,238181,27363,121,771,508
25,4,21,2,12,78874,14643,63,12225,451
11,9,2,7,4,89693,64760,6,5622,425
4,1,3,1,9,1009,1008,13,1008,527
5,3,2,0,3,23222,0,3,0,510
78,9,69,10,13,71448,91442,220,10366,410
8,4,4,0,5,91197,0,0,0,667
19,11,8,5,6,1467074,61740,67,6140,490
14,9,5,2,15,358610,15474,0,0,545
27,11,16,3,8,45490,8021,23,3977,465
39,14,25,11,17,122871,97217,186,25058,462
17,9,8,1,13,1266439,6177,0,0,532
22,9,13,8,9,20047,20383,213,6126,413
5,2,3,2,3,3115,3115,18,2443,481
65,16,49,17,18,700166,271506,511,47348,429
32,17,15,0,8,227924,0,74,353,640
9,5,4,3,16,46236,42965,41,28415,486
39,25,14,3,20,1208570,5342,0,0,500
23,5,18,2,6,12398,364,23,2651,436
19,10,9,1,6,32668,754,3,0,613
34,6,28,0,9,32996,0,2,287,557
45,9,36,6,19,1022847,308511,0,0,557
6,2,4,0,11,0,0,0,2620,724
47,16,31,10,13,292381,42135,140,12305,427
11,7,4,0,12,618267,0,3,698,694
16,6,10,6,8,845330,1819652,110,0,461
4,1,3,2,8,164016,170249,33,0,534
16,6,10,7,6,43146,70795,185,9429,512
39,6,33,3,20,1327876,529915,15,206003,498
22,10,12,3,18,100554,4900,46,3560,579
22,11,11,5,18,1390433,86306,79,0,453
23,7,16,4,12,374778,39265,119,23953,468
33,12,21,11,7,137490,129309,447,17890,451
41,9,32,6,8,157432,12723,51,4230,489
32,18,14,2,12,435305,12672,9,102785,444
38,8,30,3,7,172054,16301,81,5909,451
18,7,11,0,8,69011,0,4,1126,569
9,5,4,4,10,34374,34200,248,28828,453
18,8,10,4,16,365020,67260,30,14799,462
5,3,2,2,12,20997,7225,190,5376,501
10,2,8,2,14,3237,9407,36,6170,462
27,10,17,12,25,363591,424793,214,116747,422
27,13,14,17,7,951762,668180,232,0,430
9,3,6,3,6,61409,36681,6,194,451
13,7,6,3,2,58094,19963,66,2213,446
9,6,3,7,7,45244,44756,103,17363,443
8,5,3,4,12,48616,19512,23,16244,428
14,9,5,4,12,104404,11203,119,4555,523
4,2,2,1,13,510139,16304,24,16304,578
17,7,10,0,17,543189,0,13,0,610
21,8,13,0,11,191037,0,2,0,620
21,9,12,2,11,272404,11411,24,3710,462
27,11,16,9,14,134206,153763,29,3601,426
13,5,8,5,7,31518,27338,69,8941,474
10,3,7,2,10,228735,4127,39,630,645
38,6,32,2,12,398218,17513,33,0,495
11,6,5,2,14,59127,11651,21,27313,576
4,2,2,3,19,12544,34324,0,0,581
35,9,26,8,10,27829,85980,111,9118,457
15,6,9,7,10,22749,29244,76,9718,444
14,4,10,4,11,105907,105907,66,95140,486
37,7,30,5,8,57982,42893,107,15366,458
21,10,11,5,6,379991,46688,28,0,464
10,8,2,3,35,135261,100086,77,166,488
16,5,11,1,9,7434,448,30,4690,570
18,5,13,1,18,280027,25986,18,775,590
13,10,3,10,6,43761,33793,154,5806,490
23,11,12,1,16,158114,208,5,8106,523
8,5,3,4,16,334872,28487,57,20066,475
41,5,36,0,18,304453,0,7,9074,563
6,2,4,1,8,995,995,5,995,541
26,9,17,3,12,358484,16240,113,18854,471
4,1,3,0,9,0,0,3,1832,600
8,5,3,7,7,37358,50099,5,5742,403
13,8,5,7,9,34804,30453,298,14100,449
55,15,40,10,12,102897,71125,167,27278,438
23,6,17,10,18,103336,145510,100,27904,457
14,7,7,0,25,364531,0,0,26905,617
11,7,4,3,5,71992,44356,0,0,494
33,9,24,0,10,90940,0,2,570,563
7,4,3,2,7,109317,1517,8,418,593
5,2,3,1,8,177387,8580,8,1316,485
3,1,2,0,13,0,0,0,0,780
24,7,17,3,18,428345,10433,163,8334,483
3,1,2,0,17,1588,0,0,580,654
9,6,3,0,20,337079,0,1,1296,630
18,6,12,6,12,38698,42404,119,17094,483
7,2,5,2,14,278857,52984,52,0,632
22,9,13,4,12,547407,21439,34,3994,418
7,5,2,1,6,17164,9816,96,9816,610
25,6,19,6,20,240622,29297,79,13346,482
30,15,15,5,13,147813,51780,80,7961,458
22,6,16,7,13,1495332,1495031,135,7829,503
8,5,3,3,8,12496,20510,16,4855,462
4,2,2,3,7,10667,20217,0,0,576
5,3,2,0,14,358629,0,27,16802,439
16,5,11,3,11,26335,36101,57,17696,453
6,3,3,3,7,13930,18899,58,6313,513
6,3,3,3,5,8520,8520,42,3328,555
13,9,4,10,9,390227,94942,173,8936,454
48,11,37,4,15,116357,40855,286,23508,453
18,7,11,5,7,110349,83069,115,64346,479
31,5,26,5,18,32549,47434,21,14885,452
29,5,24,1,14,62833,1259,51,3378,481
4,1,3,0,18,1420,0,0,1650,649
30,13,17,1,17,2392811,14574,0,2769,571
8,3,5,3,7,5294,6750,49,3838,547
24,14,10,5,12,313161,97615,141,986,481
7,4,3,1,9,4238,1752,24,5840,512
9,0,9,0,14,0,0,0,2572,715
14,8,6,8,7,23012,32144,113,3577548,447
9,5,4,5,16,170446,170446,65,105330,461
18,3,15,2,17,16199,16199,32,5763,473
17,4,13,0,12,176905,0,14,0,699
6,4,2,2,16,55599,3399,11,2221,595
22,2,20,0,12,6250,0,61,3016,627
8,5,3,5,8,175178,84311,85,3051,462
21,6,15,5,25,454144,279699,25,1032,515
6,4,2,2,9,1072238,153748,35,117679,463
17,4,13,4,18,19350,19350,88,7379,447
32,8,24,7,12,377525,439790,440,247202,433
10,6,4,3,38,141202,45102,0,0,459
9,2,7,2,6,11147,11147,32,2572,472
21,9,12,0,6,164929,0,0,0,671
12,7,5,8,14,36840,60174,141,9475,434
13,4,9,2,9,24472,1139,17,161,584
49,8,41,4,12,68756,52394,81,3103,433
6,2,4,3,8,62290,74182,55,45425,473
7,5,2,4,7,12412,25979,57,13567,465
8,5,3,3,12,825020,55441,38,0,455
12,6,6,6,7,37577,37577,333,16256,379
22,5,17,0,23,589613,0,12,458,541
40,18,22,10,14,210318,47593,62,20712,428
6,4,2,0,7,0,0,17,1766,529
11,5,6,0,16,270706,0,21,4375,537
8,5,3,2,19,198583,85551,13,36605,513
223,12,211,5,40,229463,83860,227,54243,431
8,3,5,3,12,18740,18740,58,9709,630
14,3,11,3,11,553488,57971,1,93,580
13,9,4,8,10,122780,95520,120,723,428
5,2,3,1,13,30517,4382,96,10382,528
5,3,2,4,3,27421,33664,48,0,453
15,6,9,7,11,863634,67785,145,17727,547
5,3,2,3,6,18912,12513,69,3881,510
9,5,4,0,9,53118,0,0,0,672
11,7,4,6,13,189427,208029,117,1130,580
14,5,9,2,14,130952,98409,36,2649,482
14,12,2,12,14,60524,59538,104,11917,393
18,8,10,2,16,314477,11667,30,2271,469
13,3,10,3,6,19815,18816,40,7777,600
5,3,2,3,17,248218,41435,54,690,491
13,6,7,2,13,57562,15898,132,11676,629
11,5,6,0,7,2614,0,44,601,602
3,1,2,0,3,2771,0,0,0,553
5,3,2,1,9,318956,20319,33,0,633
11,9,2,8,5,83679,72270,145,8701,416
13,10,3,7,7,542701,39847,325,13469,371
7,5,2,5,12,371789,64967,0,0,475
18,12,6,2,17,802944,1410,77,764,523
17,9,8,1,10,265491,1126,0,0,471
5,3,2,2,15,812071,114051,124,8984,459
10,8,2,1,9,326708,739,51,3680,620
18,7,11,2,12,352903,4120,32,640,444
18,7,11,6,15,63239,31603,53,4700,459
8,3,5,0,11,139540,0,14,27446,615
22,6,16,6,14,286450,286450,124,191826,490
9,2,7,5,8,19903,67458,0,0,632
23,7,16,7,8,64797,34955,107,15020,442
30,16,14,8,12,1018249,163403,219,3385,480
21,5,16,0,12,299839,0,4,0,674
9,7,2,1,14,33209,5185,11,179,461
8,4,4,4,13,56193,59994,3,4405,481
5,2,3,1,7,116444,1700,23,2900,521
9,0,9,1,10,694,694,1,16099,617
4,2,2,3,6,8876,20970,56,482,449
10,5,5,2,30,310077,16041,33,9542,475
13,10,3,9,6,104598,17834,65,5012,442
14,7,7,0,19,248034,0,0,0,497
16,3,13,1,8,13037,13037,10,0,438
16,3,13,3,12,14133,4466,142,1701,546
14,9,5,9,13,47290,46465,167,5061,442
10,2,8,2,10,27670,27670,17,2500,473
10,4,6,4,8,20461,31751,243,13015,567
453,12,441,1,21,103871,13587,67,1093,623
6,4,2,4,9,24389,24389,311,19849,500
15,7,8,0,17,549022,0,0,2724,600
16,6,10,3,8,20146,3845,141,2401,494
25,5,20,6,13,193917,220505,73,63611,487
74,8,66,7,9,347342,265702,82,0,486
8,6,2,1,8,603150,41,2,0,539
22,6,16,9,19,203255,208482,151,98369,551
6,4,2,1,9,248134,31341,132,7936,497
61,10,51,3,13,76062,28658,279,11551,433
70,8,62,6,14,33674,37749,40,5995,500
14,8,6,6,12,309010,68798,107,10973,432
11,5,6,3,8,139781,28656,0,0,454
5,3,2,4,6,9244,9244,56,3291,381
9,5,4,3,22,584270,315013,44,115511,561
25,7,18,0,7,10779,0,17,124,587
15,8,7,4,14,37119,25497,34,22756,439
13,7,6,9,9,46007,51919,435,9823,487
29,4,25,2,7,1960,373,51,742,498
8,6,2,5,12,375340,12884,56,7342,427
14,8,6,5,11,472516,40486,121,7792,447
21,13,8,2,17,290849,25111,39,784,620
20,10,10,1,6,168826,397,121,1485,478
28,11,17,1,5,293579,600,123,1400,644
9,7,2,5,9,24147,19998,178,7736,410
63,15,48,8,17,422781,226760,96,74789,438
8,4,4,3,12,18730,8020,39,1240,475
10,4,6,4,8,106552,116866,62,19891,485
15,11,4,7,34,30787,27838,72,836788,428
14,2,12,2,4,3546,3546,127,2211,626
10,2,8,2,12,4093,4093,38,3238,564
5,3,2,3,6,12016,8428,0,0,451
32,7,25,5,11,294533,49708,31,22520,443
4,2,2,2,7,26117,14736,52,0,507
11,7,4,8,5,41156,42698,44,4188,377
35,6,29,1,10,15541,194,58,2180,563
7,3,4,4,25,578426,67472,32,9553,480
16,5,11,3,12,35341,2292,147,3449,518
8,4,4,1,11,67063,17488,96,17488,651
12,7,5,7,10,114988,48542,45,10522,457
38,14,24,6,38,89521,139626,106,4655,540
19,5,14,4,8,23454,14109,42,4211,525
9,7,2,7,10,26449,26091,37,15684,427
5,3,2,3,16,20931,26069,61,13912,570
16,9,7,10,10,448215,345434,113,1601,451
47,10,37,6,17,349678,33386,68,13211,525
9,7,2,5,11,363621,19345,327,10579,474
4,1,3,2,16,182661,311775,39,182661,602
12,5,7,3,11,292547,76343,43,72669,427
12,5,7,7,9,36575,50118,88,4459,478
5,2,3,2,28,157712,345026,0,0,693
13,3,10,4,6,21241,20637,134,10407,506
25,13,12,0,11,314837,0,8,1062,667
7,3,4,3,10,2741,2741,36,2101,442
34,7,27,4,8,97688,55243,64,15888,489
24,11,13,6,17,408834,383010,121,124220,495
30,7,23,1,8,294385,4441,6,4441,476
21,13,8,9,8,98434,20131,75,6471,423
10,1,9,0,12,5239,0,2,660,655
12,6,6,5,15,77465,108257,69,0,459
26,8,18,2,23,346061,22242,31,15271,512
14,2,12,2,8,8939,8939,97,3416,459
8,6,2,5,14,13099,15587,111,2990,478
21,9,12,8,20,330110,100788,337,5708,503
11,8,3,5,12,386144,37083,55,10221,408
10,1,9,2,16,12374,24435,38,33535,608
24,7,17,2,8,165233,112769,87,1243,496
9,7,2,7,6,69653,36609,85,11487,594
9,2,7,2,14,362182,25179,59,1854,626
15,5,10,4,11,94332,93302,95,5205,463
4,2,2,3,5,18830,18830,13,14576,514
9,3,6,2,12,69297,93520,59,63178,611
29,9,20,8,18,53512,41039,177,13177,484
24,6,18,4,5,24693,12521,259,4681,373
14,8,6,6,18,439160,26299,123,8373,445
13,9,4,0,11,205628,0,0,0,659
9,2,7,0,8,8208,0,0,0,686
60,8,52,3,20,167349,125042,37,65008,475
28,15,13,0,18,2241636,0,7,1240,637
3,1,2,1,6,1164,1164,13,1164,628
20,10,10,0,12,1164734,0,47,0,514
19,3,16,3,9,163649,130816,44,16150,538
6,4,2,0,7,24647,0,0,0,630
17,8,9,2,16,409891,11135,3,1206,586
16,8,8,0,5,133393,0,28,1475,521
5,2,3,0,13,28117,0,10,0,694
10,6,4,1,11,252048,7505,57,2,459
5,1,4,0,69,0,0,29,0,680
22,3,19,2,7,7334,7334,58,2703,530
13,5,8,4,12,120390,120390,86,0,458
13,7,6,5,8,8517,6245,90,1810,391
16,6,10,8,6,32204,42386,113,9751,433
20,8,12,6,8,77710,29132,354,13490,445
15,6,9,1,4,138582,208,6,4211,439
19,5,14,4,15,29607,27816,55,12245,544
9,3,6,0,7,198122,0,0,0,680
5,2,3,1,9,18047,345,13,0,495
8,3,5,1,7,19593,5085,26,5085,505
13,4,9,1,11,13945,5017,3,5017,652
27,18,9,6,8,428162,23729,222,5231,469
15,9,6,3,11,415705,32323,27,0,501
14,6,8,5,7,278191,274084,73,108031,490
17,9,8,1,11,248417,9,8,0,600
36,7,29,5,8,10458,6369,38,2122,508
14,6,8,0,27,258649,0,0,0,732
18,3,15,5,13,32698,50673,107,11000,537
33,10,23,7,10,76869,39629,75,13639,543
11,3,8,0,17,112666,0,10,22360,565
23,6,17,3,14,684134,68604,33,3260,465
14,9,5,9,7,44146,53421,101,24979,454
8,5,3,6,25,93365,123917,89,63800,483
3,1,2,2,8,9215,9215,18,7745,496
13,3,10,0,15,69032,0,1,414,704
19,5,14,1,13,33197,4002,33,4002,613
10,4,6,0,4,391246,0,12,8633,417
23,7,16,3,10,221604,13395,63,4784,428
36,17,19,2,21,780263,197,5,196,569
11,5,6,0,8,672127,0,0,0,675
11,9,2,6,7,570152,42653,85,3209,527
25,8,17,3,13,228756,26671,49,10397,450
16,9,7,3,10,261186,56478,0,0,549
12,9,3,8,14,416052,66168,312,5414,522
30,12,18,9,14,92896,103091,161,26182,413
35,12,23,5,11,67106,39870,346,22644,455
34,4,30,3,9,36298,2739,77,0,549
26,13,13,1,25,557211,971,2,971,491
14,7,7,7,13,9093,48801,31,3212,452
22,13,9,0,7,301241,0,0,0,523
43,11,32,3,8,31853,2230,330,3006,511
41,6,35,3,8,35531,4079,181,6342,494
10,5,5,2,11,289407,1255,35,956,471
102,12,90,6,17,288303,150061,435,8291,453
11,3,8,1,19,16058,1127,14,9332,499
8,4,4,4,13,449691,35922,46,1901,567
14,5,9,4,8,223635,223635,42,0,443
14,7,7,7,6,24299,37454,26,9360,441
7,3,4,1,13,367150,6785,19,1491,640
37,25,12,12,10,386038,114277,250,44127,433
25,2,23,2,15,95327,95327,107,125369,515
8,6,2,0,20,552849,0,0,2875,610
10,8,2,4,7,35408,22848,55,0,524
5,1,4,0,2,12957,0,0,0,639
6,1,5,0,4,0,0,9,0,572
30,4,26,5,12,81201,84888,97,2953,432
13,4,9,2,4,12640,10140,9,5636,447
6,2,4,1,4,11091,10,2,2915,550
13,6,7,6,10,15787,15172,113,3080,459
9,3,6,2,13,298,964,0,0,621
19,9,10,3,5,134525,2766,17,593,565
5,3,2,3,9,237103,237103,19,167626,558
27,3,24,3,11,10882,10882,57,8758,511
9,7,2,0,16,624736,0,17,28646,677
11,6,5,8,12,316284,45470,3,13122,447
29,12,17,0,8,72006,0,357,1970,436
8,6,2,0,28,296346,0,1,1218,632
73,12,61,9,50,157422,44771,271,8659,466
15,8,7,1,13,33395,2480,49,36973,389
24,17,7,2,13,939646,114634,24,25156,517
9,6,3,2,8,122767,106598,0,0,493
6,4,2,3,7,17366,17366,61,284,459
17,3,14,1,16,7678,6271,51,6272,559
5,3,2,3,9,9498,9498,50,3182,486
18,8,10,6,6,68519,52851,59,4644,396
11,6,5,2,15,280490,7286,26,3467,443
12,6,6,5,12,93111,42533,137,7852,452
25,15,10,0,17,2174398,0,25,9351,449
22,5,17,3,18,298674,39733,91,29198,412
19,14,5,3,17,455824,9484,9,6232,418
29,9,20,0,15,26330,0,36,2788,609
12,7,5,8,21,769737,132609,3,898,437
102,7,95,0,14,184026,0,1,4826,694
14,3,11,1,4,26665,396,35,8285,529
3,0,3,2,6,0,28848,0,0,619
23,6,17,6,9,84882,84560,43,9303,540
12,8,4,7,14,63459,194362,141,131761,450
15,9,6,1,18,250153,3300,26,3300,646
16,11,5,0,12,687800,0,8,0,580
4,2,2,2,9,6722,17153,22,5616,532
9,7,2,1,8,48488,5045,0,0,463
4,2,2,3,13,31805,31805,64,10245,520
11,7,4,4,10,106292,25584,84,14108,600
25,11,14,2,9,154680,6374,13,4848,482
31,5,26,3,10,96798,42237,267,20836,505
12,9,3,10,6,94379,100644,0,0,441
21,9,12,5,12,146939,7877,54,3336,427
27,9,18,10,16,126389,299978,338,58221,480
48,9,39,0,7,366517,0,40,8277,524
11,4,7,3,8,27374,27039,4,483,513
15,9,6,0,12,96143,0,3,0,672
39,11,28,4,21,207601,15592,316,8247,393
10,7,3,1,2,111130,2678,3,0,405
18,10,8,0,9,322960,0,4,2330,596
30,6,24,1,10,67900,5582,16,2423,451
46,5,41,2,16,107655,36071,41,34591,485
8,4,4,0,20,59544,0,0,1819,604
6,2,4,1,9,12454,12453,113,12453,641
11,6,5,1,9,51652,1062,4,0,563
9,4,5,2,8,26327,1890,4,1754,452
77,20,57,14,18,294984,72865,107,20051,453
50,11,39,5,11,254084,264834,333,153495,455
13,6,7,0,10,52113,0,4,1048,618
24,2,22,2,5,21567,14446,29,7224,523
14,7,7,0,10,74688,0,15,233,513
10,6,4,3,18,219433,6586,10,1445,546
12,9,3,0,9,432666,0,11,0,589
50,10,40,3,6,155396,24269,26,4140,467
12,5,7,2,7,30567,478,21,465,566
49,15,34,9,13,233076,53477,211,30323,383
5,2,3,2,7,68637,22223,30,0,489
8,3,5,1,16,4754,3948,0,1072,657
34,19,15,0,25,11249483,0,11,0,619
14,3,11,0,11,38857,0,0,1,601
13,2,11,2,22,106899,20792,50,10340,512
28,9,19,3,15,58425,5381,16,4970,508
26,10,16,1,6,76719,2103,67,2103,642
9,4,5,5,8,47216,39774,93,11308,484
6,2,4,1,15,2968,2968,5,20680,667
6,4,2,4,8,27798,12169,44,8429,483
30,16,14,0,8,482726,0,6,494,598
14,8,6,5,8,112241,86694,156,7256,478
8,5,3,5,8,27898,27898,380,9303,436
5,2,3,0,2,30125,0,0,0,656
8,3,5,5,12,38994,53743,96,1560,517
6,3,3,2,13,11294,9854,43,300,565
11,5,6,0,16,27191,0,16,0,638
17,3,14,0,5,37863,0,18,25,618
21,10,11,0,25,319019,0,10,0,606
21,15,6,0,13,953991,0,2,5015,594
59,15,44,9,15,419746,46189,123,25502,414
11,9,2,0,10,413819,0,3,0,597
15,9,6,8,7,125959,121419,182,0,465
6,4,2,4,8,10321,19428,6,3403,494
6,3,3,3,11,22878,16388,53,8841,475
14,6,8,4,13,264638,78940,57,26079,444
20,5,15,1,12,39898,901,290,4465,459
7,5,2,4,10,44477,44477,100,0,478
13,6,7,0,12,513634,0,1,390,622
15,3,12,1,16,148893,35626,30,35626,573
9,4,5,2,12,47241,37760,98,37759,515
26,7,19,2,20,13133,2805,57,142500,610
7,2,5,2,17,58669,34518,11,1422,500
18,3,15,0,14,5133,0,0,0,657
8,3,5,3,7,14308,5825,37,0,502
4,2,2,1,9,25753,25753,96,25753,607
6,3,3,3,8,176889,81305,71,31655,490
43,12,31,8,9,167668,224008,169,1945,498
12,7,5,7,13,55176,75242,76,23901,411
16,11,5,1,37,560687,19640,7,0,574
13,8,5,7,8,20320,14569,47,4293,428
6,4,2,4,13,69292,68882,82,20674,475
13,6,7,4,12,294442,15252,71,4563,425
3,1,2,1,8,6845,6845,19,0,500
193,5,188,0,6,10356,0,6,0,494
52,12,40,9,12,113921,153666,258,97960,417
18,12,6,0,18,303304,0,20,781,487
5,3,2,0,5,5307,0,3,0,572
3,1,2,1,7,0,6339,19,6361,648
20,7,13,6,11,45983,18302,110,11175,429
11,5,6,1,13,14974,14974,68,14974,494
38,10,28,10,16,62944,49279,166,6584,460
28,13,15,4,17,305022,233632,31,16692,476
12,2,10,0,16,1275409,0,4,0,602
57,7,50,8,16,90881,76122,67,27574,399
96,51,45,30,11,4095016,186879,180,57809,420
6,2,4,3,7,28918,28918,0,0,473
7,5,2,6,8,208474,208474,0,0,535
4,2,2,0,4,14580,0,0,0,663
24,3,21,3,8,12442,12442,249,16187,507
14,9,5,5,14,60503,27799,78,13510,544
14,4,10,1,13,13081,5830,28,2792,478
26,5,21,6,14,49317,50865,189,26347,422
32,15,17,1,22,799813,6469,64,2416,634
15,11,4,11,3,67845,71203,148,8352,426
19,7,12,6,4,61526,38316,0,0,434
3,1,2,1,3,5679,5403,13,0,510
9,4,5,6,12,64986,89618,94,34052,535
13,8,5,1,16,89099,4967,0,0,543
30,16,14,0,6,131638,0,2,175,651
17,8,9,3,14,271546,5398,3,966,468
6,3,3,2,12,6512,21400,29,0,502
13,9,4,0,10,182273,0,11,370,551
11,5,6,5,16,583293,93573,65,87924,491
14,6,8,4,25,13765,27255,39,10908,506
15,4,11,0,10,306962,0,16,0,536
15,7,8,5,12,138929,59477,50,10745,466
19,14,5,0,23,156743,0,5,201,683
15,7,8,2,8,30975,11721,93,14839,466
4,0,4,1,8,0,4406,8,0,615
4,2,2,3,5,14462,16259,38,8333,480
18,8,10,1,11,406644,10269,0,0,442
10,4,6,5,7,30967,26234,0,0,498
18,9,9,6,8,132242,26664,55,4410,446
21,13,8,0,13,387181,0,11,1930,567
11,8,3,5,11,53921,14978,26,1540,440
13,4,9,0,11,120580,0,34,2148,677
19,8,11,8,9,62096,55702,84,5820,437
10,8,2,6,11,299659,30052,46,10903,425
29,13,16,3,7,595063,15728,90,1991,442
14,9,5,10,10,268144,221442,140,21828,452
14,9,5,0,7,335920,0,3,0,621
9,4,5,2,9,11896,8047,194,7912,482
7,3,4,1,9,7541,18463,38,0,643
10,8,2,4,10,104341,30949,19,25266,441
51,23,28,8,11,428942,56242,304,42450,447
20,9,11,0,17,162110,0,1,0,632
6,1,5,0,4,0,0,3,876,641
31,4,27,1,14,316096,10420,14,0,638
75,15,60,18,16,367676,367575,351,23026,456
3,1,2,0,7,285080,0,2,3165,677
9,4,5,2,13,63685,41881,36,36273,498
17,6,11,8,18,127752,212929,133,1851,507
10,6,4,8,7,71385,83161,123,5418,430
3,0,3,0,6,0,0,0,0,644
22,5,17,3,11,284560,13597,79,11079,541
12,7,5,1,11,248519,1530,22,0,529
45,8,37,0,14,135514,0,43,472,591
28,11,17,9,9,60331,59693,184,11387,531
24,3,21,4,15,30570,30570,87,18945,512
36,14,22,2,14,181041,3053,120,8570,419
48,7,41,2,11,175368,776,68,12717,608
46,6,40,1,9,49818,1024,22,3500,552
5,2,3,0,7,273169,0,18,0,593
20,5,15,2,11,11461,10958,207,10928,605
15,5,10,4,16,68771,19756,66,6497,485
22,17,5,7,26,216645,17236,19,3289,553
13,9,4,0,14,817906,0,10,203,593
9,6,3,8,11,56039,50057,60,11115,443
13,4,9,2,9,25382,8570,53,0,497
5,2,3,3,8,29390,60354,0,0,504
14,8,6,2,15,721331,3341,1,2898,492
17,8,9,9,5,56903,52925,63,33737,457
3,1,2,1,5,6190,6190,5,6190,549
11,4,7,4,7,28205,14569,46,8870,454
14,6,8,8,8,153172,167679,46,124957,439
14,12,2,7,8,49783,12612,79,4082,469
20,9,11,6,15,177683,162245,22,11466,443
18,9,9,0,13,157096,0,0,0,661
28,18,10,18,12,245075,229512,234,16502,423
10,5,5,1,11,15854,1866,4,0,599
61,12,49,1,12,108837,504,51,1084,610
11,8,3,3,15,370252,16323,7,2605,532
20,10,10,1,13,74388,22476,16,22476,486
13,3,10,5,12,42264,127932,110,16231,425
39,18,21,18,7,140306,79070,710,9744,377
34,7,27,6,8,47285,12518,144,5776,446
16,4,12,1,7,15254,404,42,9363,464
86,21,65,0,15,175777,0,80,3431,542
7,5,2,2,13,37578,37578,48,23192,600
8,1,7,0,13,0,0,0,15288,667
12,8,4,1,13,249523,820,48,182,497
20,9,11,1,14,275503,53,60,35,580
2,0,2,0,7,0,0,0,0,614
7,5,2,0,9,80386,0,10,0,636
26,11,15,1,69,26783,19169,43,19169,452
43,14,29,9,17,92092,72558,225,13175,421
9,5,4,6,18,15127,14658,42,3902,515
10,6,4,6,12,187209,195861,134,65251,486
9,5,4,4,8,15724,15258,76,10234,541
9,7,2,7,14,216389,82314,36,23811,498
7,4,3,3,6,117192,106078,24,6032,491
18,10,8,0,9,314938,0,0,0,563
6,4,2,3,16,16260,15603,37,900,470
23,6,17,1,9,126807,5534,12,9327,488
5,3,2,2,10,683974,137317,20,135651,577
20,12,8,5,19,343066,54042,164,2587,414
9,4,5,1,13,390571,3294,18,4681,635
28,12,16,7,15,284660,61414,40,39625,415
16,5,11,5,9,338672,25689,67,6240,455
21,7,14,1,13,434546,959,87,12330,427
18,7,11,7,8,23337,16497,116,3875,452
23,9,14,6,11,210581,49683,338,16840,490
9,7,2,0,7,90869,0,1,0,621
5,1,4,0,4,285193,0,6,0,547
23,6,17,0,7,256863,0,26,992,569
9,4,5,0,6,480346,0,1,0,701
14,7,7,2,9,63093,15460,66,14336,414
6,2,4,3,9,95091,104282,71,48039,454
7,4,3,3,10,23152,13418,28,1717,531
7,2,5,1,25,1339,1339,3,67838,543
10,8,2,4,12,29598,25535,53,4300,439
22,14,8,4,20,547115,93635,30,22176,496
9,3,6,2,10,395775,68413,62,66802,448
8,3,5,2,11,21084,17146,56,15197,517
9,6,3,1,20,40802,9828,30,9828,549
17,8,9,4,8,42971,43255,12,12494,454
18,4,14,7,14,18075,86027,145,15293,391
25,10,15,4,14,74504,7471,4,3410,467
16,6,10,4,9,739858,86852,150,5490,420
14,9,5,3,11,236127,7172,22,264,425
9,2,7,6,12,35458,67977,66,5685,484
25,9,16,1,12,350566,922,81,2762,455
35,4,31,1,8,27631,3791,21,3791,570
8,6,2,4,15,55956,45215,48,0,446
72,5,67,2,13,8062,3470,65,2735,486
9,4,5,4,6,12050,18554,68,11295,428
16,11,5,9,10,570302,387242,137,93440,410
4,2,2,1,8,107692,1607,8,0,729
3,1,2,2,2,6175,11976,19,10749,469
33,15,18,3,17,557409,7959,15,3292,492
9,3,6,0,18,25426,0,40,5340,539
9,7,2,4,10,156878,13171,17,0,466
27,5,22,1,7,260937,827,66,4722,557
19,8,11,6,15,661972,85862,90,7768,504
8,3,5,0,9,19084,0,9,0,578
21,17,4,1,7,24284,115,17,1863,499
8,5,3,0,11,91141,0,61,16827,475
12,7,5,1,4,38908,462,1,462,476
37,16,21,3,7,181760,7393,19,6236,520
6,1,5,0,3,1035,0,1,445,598
69,23,46,0,11,320231,0,5,780,551
9,6,3,5,17,52645,52645,116,21822,479
5,3,2,3,6,32627,32627,37,560,519
9,4,5,0,6,28253,0,0,0,644
19,7,12,9,17,58112,147769,0,0,521
8,6,2,4,8,492728,36626,64,984,456
4,1,3,1,13,11780,11780,22,11780,545
7,4,3,4,15,40889,39880,103,26704,494
14,8,6,0,8,259334,0,2,90,575
4,0,4,1,7,0,10009,0,0,623
15,4,11,3,7,48445,25436,24,12654,460
13,4,9,4,16,7801,18617,121,0,482
6,3,3,1,8,549,549,25,2552,538
18,8,10,5,14,312504,50215,53,12706,511
5,3,2,0,4,21498,0,2,2745,412
9,2,7,1,13,571881,1803,16,5847,555
21,3,18,4,12,98261,135404,50,74286,466
9,4,5,3,11,624850,76258,33,7845,559
19,3,16,1,18,78302,18302,12,18302,568
19,17,2,13,17,129145,129222,229,18084,421
34,15,19,1,8,670074,997,11,0,600
10,5,5,3,7,15820,14729,28,2306,430
4,2,2,1,15,0,1793,42,0,566
20,9,11,9,10,83368,83573,67,8663,491
19,7,12,4,10,79854,4944,182,2134,404
22,4,18,2,9,17801,11890,83,0,496
10,6,4,0,4,29441,0,18,269,649
18,4,14,1,13,10803,10803,24,10803,656
21,11,10,7,14,232041,162889,66,113862,430
10,4,6,5,7,63888,72299,0,0,478
13,6,7,4,9,78767,58670,330,66617,480
4,2,2,2,8,198438,196124,0,0,508
5,1,4,0,11,0,0,0,0,722
10,3,7,3,15,85182,16043,13,10952,466
30,10,20,4,19,196315,42728,87,18434,493
17,12,5,5,12,730083,31381,37,1061,436
40,10,30,4,26,396843,29655,70,969,530
16,5,11,4,13,96494,103655,266,7997,578
20,10,10,0,11,208852,0,0,0,595
5,2,3,2,8,16614,16614,52,0,540
20,8,12,5,4,39159,18916,67,6198,540
9,6,3,1,2,65908,1460,84,1549,497
14,9,5,8,8,28083,34854,43,5535,417
4,1,3,0,9,0,0,0,0,755
25,10,15,7,8,355408,60370,141,19491,514
9,5,4,5,10,264453,95564,44,72507,442
14,8,6,12,6,694109,462868,129,69872,412
14,9,5,9,18,811338,875290,103,600523,426
8,4,4,2,13,484101,136215,9,127367,448
22,8,14,0,8,29196,0,127,6492,583
23,10,13,3,13,58585,756,184,6000,616
62,5,57,3,14,32839,29909,5,16394,532
49,4,45,3,7,9691,5843,40,4000,547
15,8,7,5,3,380051,19014,50,1655,418
12,5,7,0,15,916458,0,15,6569,517
10,6,4,7,6,15509,20476,282,7129,458
27,9,18,7,27,430666,79292,98,20021,433
101,10,91,2,22,257166,106422,34,302019,593
9,7,2,1,8,279033,922,17,922,433
43,21,22,9,12,427540,125182,118,24139,423
10,6,4,4,22,302035,56876,81,36838,578
3,1,2,1,19,14768,14339,18,4955,643
25,16,9,13,14,176838,114053,245,16217,497
51,15,36,0,69,549958,0,10,1105,631
5,0,5,0,15,0,0,1,1250,671
4,2,2,3,12,248693,39870,32,0,535
55,21,34,10,28,214426,114296,222,16694,466
11,7,4,7,14,298914,298914,54,228973,475
6,2,4,0,4,138613,0,1,25,687
15,7,8,4,6,19947,4772,3,1918,464
10,3,7,2,16,2957,2011,3,1494,587
25,7,18,6,12,114278,103817,59,46522,442
27,8,19,2,15,201133,202606,28,201133,655
11,3,8,2,13,187350,147654,47,0,633
11,5,6,0,17,21556,0,2,1002,644
22,15,7,12,13,184876,177006,217,23642,414
14,4,10,4,7,25377,18279,53,4015,503
10,5,5,4,11,168486,132493,67,3974,458
22,12,10,9,17,473994,46990,169,7783,477
13,5,8,6,8,157659,141865,103,22081,438
21,11,10,0,12,347844,0,35,0,544
8,5,3,4,17,6055,6055,65,2699,515
19,6,13,1,18,205371,34134,96,52684,516
30,7,23,6,11,83156,56686,50,206958,513
6,3,3,5,10,129418,141575,40,64050,466
15,10,5,8,8,323954,9553,82,3043,435
14,2,12,1,17,19400,19399,30,19399,643
11,4,7,0,10,82202,0,204,1273,607
20,9,11,8,11,43454,199883,193,1815,612
17,8,9,2,11,116284,1299,27,176,495
44,8,36,6,8,48074,42246,69,11409,401
23,3,20,5,13,127247,316662,104,12262,520
9,5,4,3,8,35505,3567,57,1474,440
25,7,18,0,12,58222,0,28,46290,494
9,2,7,1,9,6155,6155,41,1132,546
8,3,5,3,4,6982,8049,60,3576,538
9,3,6,3,14,16583,16002,63,3420,483
8,5,3,3,20,248802,216373,28,6431,452
27,12,15,8,18,145170,116459,93,67036,507
6,4,2,0,7,19107,0,0,0,664
14,5,9,4,6,37704,16665,253,7035,503
33,10,23,3,16,435172,187763,42,18773,553
2,0,2,1,7,0,76352,17,0,605
32,4,28,1,8,77533,993,15,14302,482
9,3,6,5,7,198414,198414,89,0,485
18,14,4,1,6,116499,4396,18,0,503
14,6,8,0,8,100625,0,93,11345,569
13,5,8,0,8,90949,0,18,215,590
9,6,3,4,12,213526,8852,15,2274,465
19,11,8,2,9,208253,359,182,1452,552
3,1,2,1,11,28122,28122,14,28122,494
57,22,35,15,15,942112,160747,375,31040,447
10,2,8,2,14,2845,2845,28,4190,387
8,3,5,3,7,11532,11532,121,5307,417
122,5,117,3,13,68027,21386,99,12436,525
30,17,13,19,21,1289862,1419255,403,258389,509
12,7,5,4,8,624533,32127,160,17477,497
26,8,18,5,5,56580,16336,73,10850,490
8,4,4,2,14,281786,114735,52,0,530
22,7,15,10,10,179122,59235,78,2317,432
21,5,16,2,16,95043,7515,33,6540,581
12,4,8,4,16,328826,9361,68,3142,563
8,6,2,4,7,47156,13971,196,10180,518
9,6,3,0,12,360143,0,4,0,707
3,1,2,0,15,162933,0,0,0,621
53,4,49,2,17,77933,60220,44,50917,523
27,10,17,7,9,249024,212022,46,83589,491
27,13,14,0,7,184139,0,14,441,603
19,3,16,0,11,31931,0,1,2984,613
20,5,15,4,15,71702,28850,53,3715,384
12,3,9,3,11,305104,24457,49,4865,453
8,3,5,5,10,25790,65366,92,8325,465
6,3,3,2,11,19445,19445,45,14480,550
10,8,2,5,4,32417,16854,124,6460,465
17,15,2,7,4,137375,10909,20,461,464
10,6,4,5,14,200078,122798,84,28363,436
38,11,27,2,8,620527,4924,26,6780,440
5,2,3,2,7,3928,3928,52,1964,583
10,7,3,8,7,36981,54739,106,5796,462
10,7,3,5,3,39622,4654,12,1057,464
22,10,12,0,9,404785,0,1,0,653
9,4,5,2,15,27634,22334,69,0,514
7,4,3,2,14,6430,2650,8,561,517
12,7,5,1,16,499335,4576,5,0,628
11,1,10,0,8,0,0,9,4177,620
42,5,37,2,6,21350,14313,39,1134,488
27,8,19,9,13,76409,88806,79,18811,529
14,8,6,0,25,2237400,0,0,0,630
9,2,7,2,7,15226,13735,46,3025,498
6,3,3,2,22,39468,39468,0,0,546
13,3,10,1,13,32819,25768,25,112,565
30,11,19,6,15,74469,39365,372,45546,484
14,8,6,6,10,47689,41410,108,15285,493
20,11,9,1,15,1177429,3842,0,0,622
5,3,2,1,16,314744,5719,38,14687,440
30,10,20,0,6,214381,0,9,0,561
4,1,3,0,15,0,0,0,0,729
13,6,7,2,12,272001,16986,33,10366,379
11,8,3,6,8,334386,25140,102,16110,444
11,9,2,7,8,205801,167797,86,143537,413
6,4,2,0,3,25838,0,4,160,455
25,5,20,4,7,23779,16246,47,5622,446
17,4,13,3,4,17422,30812,28,17413,416
8,6,2,2,18,274316,29122,28,0,464
7,5,2,1,19,59461,39993,14,39993,444
11,3,8,0,11,20610,0,0,0,556
9,6,3,4,22,314370,72287,77,0,555
23,5,18,3,9,40793,40793,333,21886,551
22,5,17,6,14,31381,36720,244,15808,456
42,9,33,0,10,118312,0,0,4884,583
21,11,10,4,6,442141,38853,84,2573,457
4,2,2,1,8,193043,1300,0,0,575
13,7,6,8,7,116173,116172,141,6903,545
8,6,2,5,5,20051,17618,0,0,449
8,3,5,2,4,1403,1403,12,883,497
9,7,2,7,12,249635,207970,24,21270,502
38,20,18,10,13,668969,231519,177,12602,422
9,6,3,7,8,44895,66719,59,9977,439
17,6,11,8,13,41238,40225,243,14000,503
14,10,4,8,7,494604,28438,81,11562,340
8,2,6,2,10,16094,9552,30,8017,641
27,12,15,2,20,75917,5160,51,1900,492
6,1,5,3,4,5636,12686,42,0,497
8,6,2,5,14,354432,27766,115,11328,454
38,13,25,2,7,94586,1250,111,6160,454
2,0,2,2,13,0,4092,0,0,521
13,8,5,1,17,730121,409036,64,1919,496
37,8,29,3,9,123123,3235,48,5918,604
6,3,3,1,7,19662,663,18,663,559
59,9,50,4,30,263470,23488,133,30259,420
3,1,2,2,8,9820,22202,41,0,510
14,1,13,0,5,0,0,4,449,594
13,8,5,3,9,343326,6233,10,2810,484
5,1,4,1,11,5912,5912,0,0,652
17,10,7,3,14,362314,64168,104,35824,512
11,9,2,9,8,49408,33502,152,1745,498
6,2,4,0,9,13792,0,1,0,597
9,6,3,3,5,5837,4089,55,0,506
5,2,3,0,17,74431,0,0,0,684
17,10,7,11,13,276241,275944,210,20901,508
21,5,16,0,15,381940,0,21,1729,609
21,9,12,0,10,621046,0,6,255,658
15,13,2,6,38,75717,15131,79,2480,551
8,5,3,3,7,68167,31234,45,2805,476
3,0,3,0,11,0,0,0,25,524
9,7,2,0,5,155986,0,0,0,684
15,8,7,7,8,342314,40642,162,13369,415
16,6,10,6,9,61016,16040,175,5089,513
26,5,21,7,19,99805,110821,82,0,531
14,11,3,9,8,489409,17685,119,10708,453
39,12,27,11,9,104918,88533,221,12035,411
32,7,25,4,15,39682,31786,7,9727,448
6,3,3,2,14,15916,15916,34,10,524
8,3,5,0,4,82554,0,12,0,524
7,4,3,3,3,156981,9511,9,0,489
10,5,5,1,8,90169,8205,23,8205,463
5,2,3,0,4,3703,0,11,594,582
8,4,4,1,14,45423,4239,0,0,525
10,5,5,6,4,35252,47628,94,10882,381
62,13,49,0,9,340487,0,15,416,642
7,3,4,0,8,6666,0,3,0,656
30,8,22,0,16,413146,0,1,514,690
131,43,88,6,11,2446358,37193,13,13814,470
24,6,18,4,11,52876,43477,40,29912,451
23,8,15,6,11,337036,24890,19,13675,397
18,8,10,2,16,266504,22048,52,465445,466
15,6,9,5,10,47433,23412,130,9735,419
12,5,7,0,17,40648,0,1,810,756
5,2,3,2,11,10046,10046,3,1222,477
9,0,9,1,5,0,10150,41,0,595
7,5,2,5,14,323535,32122,0,0,443
11,8,3,9,8,268312,281237,58,4695,423
12,4,8,4,8,38316,37162,18,14777,532
25,6,19,3,69,329968,38291,45,4257,409
9,7,2,1,4,251793,2015,1,2015,563
17,3,14,0,6,32050,0,5,1412,603
19,12,7,10,8,445456,145458,111,44905,429
7,1,6,0,7,420,0,51,824,740
11,5,6,1,8,157763,1498,0,0,620
18,12,6,5,16,669195,15384,35,229,486
18,4,14,3,15,502655,157569,74,75828,501
7,4,3,5,8,903593,914778,98,19213,466
14,9,5,0,8,302472,0,0,272,599
32,5,27,1,8,380744,3536,137,1343,616
51,15,36,4,14,23262672,127029,63,89063,460
12,10,2,1,8,429966,34676,17,2482,533
10,8,2,3,12,14089,5326,29,0,517
12,6,6,4,9,71475,49137,68,0,512
30,12,18,5,9,108603,43572,67,0,513
13,9,4,0,4,157765,0,0,0,656
5,0,5,2,7,0,30205,65,0,592
25,8,17,1,7,45596,16,33,16,545
12,8,4,3,10,773755,264137,27,219543,519
20,12,8,0,15,2381728,0,5,1009,677
20,9,11,2,16,1967311,2451,14,8119,427
19,3,16,0,9,42357,0,1,12671,580
14,5,9,2,14,696531,44392,40,4099,465
10,2,8,2,23,7862,7862,4,3520,635
7,2,5,1,12,283838,3388,5,3388,548
28,16,12,2,12,1634082,40430,160,712,469
24,7,17,0,14,208911,0,5,0,703
18,11,7,10,16,58494,57762,254,11184,422
11,6,5,0,5,1050843,0,10,4544,676
33,12,21,17,15,632546,640440,363,116319,432
4,2,2,3,7,2347,12264,48,1179,535
11,5,6,2,6,93273,1529,74,2088,543
3,1,2,0,16,32494,0,0,0,626
10,3,7,2,18,29054,17012,36,13465,468
14,8,6,4,17,44734,34560,72,11570,548
8,4,4,0,26,60,0,6,0,531
29,8,21,1,12,44758,11236,46,11736,483
8,3,5,3,11,1843,1843,43,4083,541
18,9,9,0,14,82594,0,1,0,604
14,6,8,6,9,300897,33765,65,3920,460
10,5,5,0,12,17459,0,8,0,604
27,8,19,11,27,52908,68233,223,9969,424
38,15,23,9,9,69064,12824,113,4180,406
12,7,5,1,13,328561,4315,122,3258,458
59,6,53,0,18,30546,0,51,3329,658
37,5,32,5,10,302674,296408,201,164871,502
7,5,2,2,25,158673,1271,15,0,620
59,6,53,0,11,39057,0,0,840,582
5,3,2,1,9,24731,6127,7,3022,383
15,6,9,3,11,51721,1627,7,0,477
8,6,2,0,11,49146,0,3,0,558
10,7,3,1,6,140072,2748,47,828,508
11,8,3,0,5,31333,0,0,0,610
17,5,12,2,5,246057,5110,29,4436,630
9,7,2,4,14,192467,34407,31,9023,470
13,6,7,6,9,20512,15563,37,10461,449
32,11,21,4,13,195345,13913,179,9258,518
7,5,2,4,8,21871,21871,86,1210,466
8,5,3,0,9,2667,0,63,0,548
7,4,3,1,10,12163,12143,14,0,683
27,18,9,7,21,1209411,101490,53,8778,434
7,4,3,4,6,12951,12951,28,5042,462
7,2,5,2,4,12867,12867,18,10323,496
19,6,13,10,6,232775,316769,160,142563,402
24,13,11,0,9,181421,0,3,1885,568
5,3,2,3,11,474157,13584,31,2490,461
11,6,5,7,10,70116,70116,76,33955,518
35,8,27,4,13,81474,34254,0,0,443
11,9,2,4,8,166048,162837,89,85330,504
18,10,8,1,23,249024,5935,58,4732,561
26,3,23,2,8,119103,15150,95,5041,526
6,1,5,1,8,4314,4314,15,4314,595
31,11,20,11,7,187971,166612,203,16550,453
10,2,8,3,12,10524,10524,80,4856,509
9,5,4,2,10,17856,20868,88,363,563
